Team_1,Team_2,Team_1_goals,Team_2_goals,Total_goals,ALFIE_rating,Total_games
AFC Oldsmiths,Old Salopians II,1,2,3,4.0,1
AFC Representative Team,Arthurian League Representative Team,15,13,28,3.5,6
Actonians Association,Old Etonians,1,0,1,3.0,1
Actonians Association VII,Old Haberdashers,4,3,7,4.0,1
Actonians Association VIII,Old Haberdashers,1,11,12,0.0,1
Albanian FC,Old Aldenhamians,1,0,1,3.0,1
Albanian FC,Old Aldenhamians II,2,5,7,2.0,1
Albanian FC,Old Brentwoods III,0,6,6,0.0,1
Albanian FC,Old Carthusians II,0,5,5,0.0,1
Albanian FC,Old Chigwellians II,4,3,7,4.0,1
Albanian FC,Old Chigwellians Vets,3,7,10,3.3333333333333335,3
Albanian FC,Old Cholmeleians II,17,7,24,2.75,4
Albanian FC,Old Columbans,7,4,11,3.0,1
Albanian FC,Old Foresters,1,3,4,3.0,1
Albanian FC,Old Foresters II,6,1,7,0.0,1
Albanian FC,Old Salopians,2,1,3,4.0,1
Albanian V,Old Haberdashers,0,4,4,1.0,1
Albanian Vets,Old Foresters Vets,2,6,8,2.0,1
Aldenham School 1st XI,Old Aldenhamians,14,6,20,2.5,4
Aldenham School 2nd XI,Old Aldenhamians II,11,1,12,1.5,2
Alexandra Park FC,Old Alleynians AFC,0,7,7,0.0,1
Alexandra Park FC,Old Bradfieldians,0,1,1,3.0,1
Alexandra Park FC,Old Carthusians,2,4,6,3.0,1
Alexandra Park FC,Old Salopians II,3,2,5,4.0,1
Alleyn Old Boys,Kings College Wimbledon II,5,4,9,5.0,1
Alleyn Old Boys,Lancing Old Boys,4,0,4,1.0,1
Alleyn Old Boys,Old Aldenhamians II,6,2,8,2.0,1
Alleyn Old Boys,Old Brentwoods II,3,1,4,3.0,1
Alleyn Old Boys,Old Carthusians,0,1,1,3.0,1
Alleyn Old Boys,Old Carthusians III,2,1,3,4.0,1
Alleyn Old Boys,Old Chigwellians Vets,0,1,1,3.0,1
Alleyn Old Boys,Old Cholmeleians III,1,2,3,4.0,1
Alleyn Old Boys,Old Etonians,6,4,10,2.0,2
Alleyn Old Boys,Old King's Scholars,5,0,5,0.0,1
Alleyn Old Boys,Old Rugbeians,3,1,4,3.0,1
Alleyn Old Boys,Old Salopians,3,1,4,3.0,1
Alleyn Old Boys III,KCS Old Boys II,3,2,5,4.0,1
Altis,Old Chigwellians,4,1,5,2.0,1
Altis,Old Foresters,2,2,4,5.0,1
Ampleforth College 1st XI,Old Amplefordians,5,8,13,3.0,3
Arthurian League Representative Team,AFC Representative Team,13,15,28,3.5,6
Arthurian League Representative Team,Forest School 1st XI,3,2,5,4.0,1
Arthurian League Representative Team,Herts Senior County League,9,7,16,3.3333333333333335,3
Arthurian League Representative Team,Lloyds of London Representative Team,14,4,18,2.75,4
Arthurian League Representative Team,Oxford University Football Club,2,3,5,4.0,1
Arthurian League Representative Team,Royal Navy Development XI,8,4,12,3.3333333333333335,3
Arthurian League Representative Team,SAL Representative Team,7,2,9,3.0,3
Arthurian League Representative Team,Southern Amateur League Rep XI,6,7,13,3.0,4
Atletico Trotters Vets,Old Chigwellians Vets Blues,2,5,7,2.0,1
BB Eagles,Kings College Wimbledon II,0,2,2,2.0,1
Bancroft's School 1st XI,Old Bancroftians AFC,1,12,13,1.3333333333333333,3
Bank of England,Old Ardinians,4,2,6,3.0,1
Bank of England,Old Brentwoods IV,1,1,2,4.0,1
Bank of England,Old Carthusians,0,3,3,2.0,1
Bank of England,Old Etonians,0,2,2,2.0,1
Bank of England,Old Haberdashers,1,0,1,3.0,1
Bealonians,Lancing Old Boys,0,6,6,0.0,1
Bealonians,Old Aldenhamians II,6,2,8,2.0,1
Bealonians,Old Bancroftians AFC,0,5,5,0.0,1
Bealonians,Old Brentwoods,8,1,9,2.6666666666666665,3
Bealonians,Old Brentwoods II,1,5,6,2.0,1
Bealonians,Old Carthusians III,1,3,4,3.0,1
Bealonians,Old Cholmeleians,1,1,2,4.0,1
Bealonians,Old Columbans,5,7,12,4.5,2
Bealonians,Old Etonians,4,4,8,3.0,2
Bealonians,Old Etonians II,0,5,5,2.0,2
Bealonians,Old Foresters,2,2,4,3.5,2
Bealonians,Old Foresters III,5,3,8,4.0,1
Bealonians,Old King's Scholars,2,1,3,4.0,1
Bealonians,Old Merchant Taylors',8,0,8,0.0,1
Bealonians II,Old Brentwoods II,2,4,6,3.0,1
Bealonians VII,Old Brentwoods IV,2,1,3,4.0,1
Bealonians VII,Old Merchant Taylors II,4,5,9,5.0,1
Bealonians VIII,Old Merchant Taylors II,3,9,12,0.0,1
Beder FC,Old Alleynians AFC,10,10,20,7.0,1
Blackheath Wanderers (Youth) First Team,Old Citizens,3,2,5,4.0,1
Bradfield College,Old Bradfieldians,4,10,14,3.25,4
Brent,Old Reptonians,0,5,5,0.0,1
Brentwood School 1st XI,Old Brentwoods,17,32,49,3.1333333333333333,15
Brentwood School 2nd XI,Old Brentwoods II,42,41,83,2.066666666666667,15
Brentwood School 3rd XI,Old Brentwoods III,32,42,74,2.8666666666666667,15
Brentwood School 4th XI,Old Brentwoods IV,15,15,30,2.625,8
Brentwood School 4th XI,Old Brentwoods Vets,0,0,0,4.0,2
Brentwood School 5th XI,Old Brentwoods Vets,16,5,21,3.25,4
Bromleians,Old Carthusians,0,7,7,0.0,1
Broomfield FC,Old Brentwoods III,5,5,10,6.0,1
Broomfield FC,Old Foresters,1,6,7,0.0,1
Broomfield FC,Old Foresters II,7,7,14,6.0,1
Broomfield FC,Old Salopians,4,2,6,3.0,1
Brymans Park FC,Old Brentwoods III,2,3,5,4.0,1
Cambridge Heath,Old Foresters,1,2,3,4.0,1
Canning Town Vets,Old Chigwellians Vets Blues,5,3,8,4.0,1
Carshalton,Old Carthusians III,3,2,5,4.0,1
Carshalton,Old Westminsters,0,2,2,2.0,1
Charterhouse School 1st XI,Old Carthusians,5,38,43,1.4285714285714286,7
Charterhouse School 1st XI,Old Carthusians III,1,3,4,3.0,1
Charterhouse School 2nd XI,Old Carthusians II,8,10,18,4.0,7
Charterhouse School 3rd XI,Old Carthusians III,9,20,29,2.4,5
Chelmsford City Reserves,Old Foresters,2,1,3,4.0,1
Cheltenham College 1st XI,Old Cheltonians,3,4,7,4.0,1
Chigwell School 1st XI,Old Chigwellians,0,3,3,3.0,2
Chigwell School 2nd XI,Old Chigwellians II,0,0,0,4.0,2
Chigwell School 3rd XI,Old Chigwellians III,3,3,6,4.5,2
Chingford Athletic,Old Foresters,5,8,13,2.0,2
Citigroup,Old Reptonians,1,3,4,3.0,1
City of London,Kings College Wimbledon II,6,3,9,3.0,1
City of London,Old Cholmeleians,0,6,6,0.0,1
Civil Service,Old Carthusians,2,1,3,4.0,1
Civil Service,Old Foresters,3,1,4,3.0,1
Civil Service II,Kings College Wimbledon II,8,1,9,0.0,1
Civil Service II,Old Chigwellians II,4,1,5,2.0,1
Civil Service III,Old Carthusians III,0,1,1,3.0,1
Civil Service III,Old Westminsters II,7,0,7,0.0,1
Clapham Old Xaverians,Old Carthusians,1,9,10,1.0,2
Clapham Old Xaverians,Old Epsomians,1,0,1,3.0,1
Clapham Rovers,Old Carthusians,0,3,3,2.0,1
Clissold Park Rangers,Old Alleynians AFC,2,2,4,5.0,1
Clissold Park Rangers,Old Rugbeians,1,2,3,4.0,1
Corinthian-Casuals,Lancing Old Boys,6,8,14,3.75,4
Crouch End Vampires,Old Brentwoods,1,4,5,2.0,1
Croxley Green Vets,Old Chigwellians Vets Blues,0,3,3,2.0,1
Donnington Wanderers,Old Epsomians,4,4,8,6.0,1
Dorkinians,KCS Old Boys,1,0,1,3.0,1
Dorkinians,Old Carthusians,9,8,17,4.0,3
Dulwich College 1st XI,Old Alleynians,1,5,6,2.0,1
Dulwich College 1st XI,Old Alleynians AFC,10,17,27,3.4,5
Dulwich College 2nd XI,Old Alleynians AFC II,0,5,5,2.6666666666666665,3
Dulwich College 2nd XI,Old Alleynians II,0,0,0,4.0,1
Dulwich College 3rd XI,Old Alleynians AFC III,0,5,5,0.0,1
Dulwich College 3rd XI,Old Alleynians III,0,0,0,4.0,1
Earls Colne,Old Foresters,5,3,8,4.0,1
Earlsfield FC,Old Cholmeleians,1,5,6,2.0,1
Earlsfield United,Old Epsomians,9,2,11,0.0,1
East Barnet Old Grammarians,Old Brentwoods II,1,5,6,2.0,1
East Barnet Old Grammarians,Old Chigwellians,0,8,8,0.0,1
East Barnet Old Grammarians,Old Chigwellians II,1,3,4,3.0,1
East Barnet Old Grammarians,Old Harrovians II,0,3,3,2.0,1
East Barnet Old Grammarians,Old Merchant Taylors,1,1,2,4.0,1
East Barnet Old Grammarians,Old Merchant Taylors II,1,1,2,4.0,1
East Barnet Old Grammarians III,Old Chigwellians II,1,4,5,2.0,1
East Barnet Old Grammarians IV,Old Haberdashers,3,6,9,3.0,1
Economicals,KCS Old Boys,3,8,11,2.5,2
Economicals,Lancing Old Boys,2,1,3,4.0,1
Economicals,Old Carthusians,0,3,3,2.0,1
Economicals,Old Carthusians II,2,2,4,5.0,1
Economicals,Old Carthusians III,1,2,3,4.0,1
Economicals,Old Salopians II,1,2,3,4.0,1
Economicals III,Old Epsomians,2,1,3,4.0,1
Egbertian FC,Old Aldenhamians,4,7,11,3.0,1
Egbertian FC,Old Bancroftians AFC,2,3,5,4.0,1
Egbertian FC,Old Cholmeleians II,4,1,5,2.0,1
Egbertian FC,Old Westminsters II,0,1,1,3.0,1
Enfield Old Grammarians,Old Aldenhamians II,7,0,7,0.0,1
Enfield Old Grammarians,Old Brentwoods,2,4,6,3.0,1
Enfield Old Grammarians,Old Carthusians,1,4,5,2.0,1
Enfield Old Grammarians,Old Carthusians II,2,6,8,2.0,1
Enfield Old Grammarians,Old Carthusians III,1,5,6,2.0,1
Enfield Old Grammarians,Old Etonians II,5,9,14,3.0,2
Enfield Old Grammarians,Old Foresters,1,2,3,4.0,1
Enfield Old Grammarians,Old Foresters Vets,1,8,9,0.0,1
Enfield Old Grammarians III,Old Merchant Taylors,5,0,5,0.0,1
Enfield Old Grammarians Vets,Old Brentwoods Vets,0,1,1,3.0,1
Epsom College 1st XI,Old Epsomians,11,14,25,4.0,6
Epsom College 2nd XI,Old Epsomians II,0,0,0,4.0,1
Eton College 1st XI,Old Etonians,20,26,46,3.857142857142857,14
Eton College 2nd XI,Old Etonians II,17,9,26,3.2,10
Eton College 3rd XI,Old Etonians Vets,5,3,8,4.0,1
FC Brotherhood,Old Cholmeleians,1,1,2,4.0,1
Forest Green,Old Westminsters,4,7,11,3.0,1
Forest School 1st XI,Arthurian League Representative Team,2,3,5,4.0,1
Forest School 1st XI,Old Foresters,3,18,21,2.5,6
Forest School 1st XI,Old Foresters II,12,6,18,3.3333333333333335,3
Forest School 2nd XI,Old Foresters II,2,2,4,4.333333333333333,3
Forest School 3rd XI,Old Foresters III,1,5,6,2.0,1
Fulham Compton Old Boys,Old Alleynians,2,3,5,4.0,1
Fulham Compton Old Boys,Old Carthusians II,1,0,1,3.0,1
Fulham Compton Old Boys,Old Carthusians III,2,4,6,3.0,1
Fulham Compton Old Boys,Old Cholmeleians,3,0,3,2.0,1
Fulham Compton Old Boys,Old Eastbournians,3,4,7,4.0,1
Fulham Compton Old Boys,Old Malvernians,5,0,5,0.0,1
Fulham Compton Old Boys II,Old Cholmeleians II,4,1,5,2.0,1
Galleywood Reserves,Old Chigwellians II,2,1,3,4.0,1
Gas Recreation FC,Old Foresters,3,1,4,3.0,1
Globe Rangers,Old Aldenhamians,5,5,10,3.0,2
Globe Rangers,Old Brentwoods,2,5,7,2.0,1
Globe Rangers,Old Cholmeleians,0,1,1,3.0,1
Globe Rangers,Old Foresters,3,13,16,0.0,2
Globe Rangers,Old Reptonians,1,3,4,3.0,1
Globe Rangers Vets 2nd,Old Chigwellians Vets,3,7,10,2.0,1
Glyn Old Boys,KCS Old Boys,8,6,14,4.5,2
Glyn Old Boys,Old Ardinians,4,2,6,3.0,1
Glyn Old Boys,Old Chigwellians,3,2,5,4.0,1
Glyn Old Boys,Old Etonians II,1,0,1,3.0,1
Glyn Old Boys,Old Sennockians,2,0,2,2.0,1
Glynn Old Boys II,Old Carthusians II,4,1,5,2.0,1
Glynn Old Boys II,Old Etonians II,0,1,1,3.0,1
Haberdashers Aske School 1st XI,Old Haberdashers,20,12,32,2.7142857142857144,7
Haileybury College,Old Haileyburians,6,7,13,3.5,2
Hale End Athletic,Old Brentwoods II,3,4,7,4.0,1
Hale End Athletic,Old Brentwoods III,7,2,9,0.0,1
Hale End Athletic,Old Carthusians II,5,0,5,0.0,1
Hale End Athletic,Old Carthusians III,2,2,4,5.0,1
Hale End Athletic,Old Chigwellians,3,1,4,3.0,1
Hale End Athletic,Old Chigwellians Vets,2,4,6,3.0,1
Hale End Athletic,Old Cholmeleians,2,8,10,3.0,3
Hale End Athletic,Old Foresters II,2,3,5,4.0,1
Hale End Athletic,Old Millfieldians,2,1,3,4.0,1
Hale End Athletic,Old Reptonians,1,0,1,3.0,1
Hale End Athletic,Old Westminsters II,7,1,8,0.0,1
Halstead Town Vets,Old Chigwellians Vets Blues,2,3,5,4.0,1
Hampstead Heathens,Old Aldenhamians,1,2,3,4.0,1
Harold Wood FC,Old Brentwoods,1,7,8,0.0,1
Harrow School 1st XI,Old Harrovians,8,15,23,3.625,8
Harrow School 2nd XI,Old Harrovians II,8,13,21,3.888888888888889,9
Harrow School 3rd XI,Old Harrovians III,8,9,17,4.285714285714286,7
Heathrow Seniors,Old Aldenhamians,3,2,5,4.0,1
Heathrow Seniors,Old Carthusians III,0,5,5,0.0,1
Hedinghams United,Old Foresters,1,6,7,0.0,1
Herts Senior County League,Arthurian League Representative Team,7,9,16,3.3333333333333335,3
Highgate School 1st XI,Old Cholmeleians,6,7,13,3.2857142857142856,7
Highgate School 2nd XI,Old Cholmeleians II,1,2,3,4.0,5
Highgate School 3rd XI,Old Cholmeleians III,3,1,4,3.0,2
Honourable Artillery Company,KCS Old Boys,4,1,5,2.0,1
Honourable Artillery Company,Old Carthusians,1,0,1,3.0,1
Honourable Artillery Company,Old Carthusians II,6,0,6,0.0,1
Honourable Artillery Company,Old Etonians,4,1,5,2.0,1
Hornsey and Highgate FC,Old Cholmeleians III,2,4,6,3.0,1
Hullbridge Sports Saturday Reserves,Old Foresters,2,1,3,4.0,1
IB Albion,KCS Old Boys,5,3,8,4.0,1
IB Albion,Old Malvernians,8,1,9,0.0,1
IB Albion,Old Reptonians,1,2,3,4.0,1
Ibis Eagles,Old Carthusians,0,3,3,2.0,1
Ibis Eagles,Old Salopians,1,2,3,4.0,1
Icarus,Old Ardinians,2,0,2,2.0,1
Icarus,Old Cholmeleians II,2,1,3,4.0,1
Icarus,Old Foresters,1,3,4,3.0,1
Inter London,Old Haberdashers,4,9,13,1.0,1
Jersey Royals,Old Rugbeians,0,4,4,1.0,1
John Fisher Old Boys,Old Carthusians III,1,4,5,2.0,1
KCS Old Boys,Dorkinians,0,1,1,3.0,1
KCS Old Boys,Economicals,8,3,11,2.5,2
KCS Old Boys,Glyn Old Boys,6,8,14,4.5,2
KCS Old Boys,Honourable Artillery Company,1,4,5,2.0,1
KCS Old Boys,IB Albion,3,5,8,4.0,1
KCS Old Boys,KCS Old Boys Vets,0,0,0,4.0,1
KCS Old Boys,KCS Wimbledon 1st XI,5,1,6,2.0,1
KCS Old Boys,"King's College School, Wimbledon 1st XI",15,14,29,1.8333333333333333,6
KCS Old Boys,Kings College Wimbledon II,5,5,10,5.0,2
KCS Old Boys,Kings College Wimbledon III,0,0,0,4.0,1
KCS Old Boys,Lancing Old Boys,18,17,35,3.1,10
KCS Old Boys,Montpellier Villa FC,1,1,2,4.0,1
KCS Old Boys,Old Actonians Association FC,3,4,7,4.0,1
KCS Old Boys,Old Aldenhamians,16,1,17,1.3333333333333333,3
KCS Old Boys,Old Alleynians,20,36,56,2.6,10
KCS Old Boys,Old Alleynians AFC,9,2,11,1.5,2
KCS Old Boys,Old Amplefordians,7,1,8,0.0,1
KCS Old Boys,Old Blues,4,0,4,1.0,1
KCS Old Boys,Old Bradfieldians,61,31,92,2.75,16
KCS Old Boys,Old Brentwoods,42,24,66,2.933333333333333,15
KCS Old Boys,Old Bromleians,2,1,3,4.0,1
KCS Old Boys,Old Carthusians,23,57,80,2.8095238095238093,21
KCS Old Boys,Old Chigwellians,24,18,42,3.1666666666666665,12
KCS Old Boys,Old Cholmeleians,25,14,39,3.272727272727273,11
KCS Old Boys,Old Eastbournians,7,1,8,0.0,1
KCS Old Boys,Old Etonians,44,56,100,2.96,25
KCS Old Boys,Old Foresters,43,51,94,3.4761904761904763,21
KCS Old Boys,Old Haileyburians,12,3,15,1.0,2
KCS Old Boys,Old Harrovians,29,21,50,2.933333333333333,15
KCS Old Boys,Old Johnians,2,2,4,5.0,1
KCS Old Boys,Old Josephians,16,0,16,1.0,1
KCS Old Boys,Old Kimboltonians,14,5,19,1.5,2
KCS Old Boys,Old King's Scholars,21,1,22,0.3333333333333333,3
KCS Old Boys,Old Malvernians,5,0,5,0.0,1
KCS Old Boys,Old Marlburians,11,6,17,3.3333333333333335,6
KCS Old Boys,Old Parmiterians,3,1,4,3.0,1
KCS Old Boys,Old Radleians,6,5,11,3.6666666666666665,3
KCS Old Boys,Old Reptonians,30,39,69,2.6,15
KCS Old Boys,Old Rugbeians,2,1,3,4.0,1
KCS Old Boys,Old Salopians,31,29,60,2.857142857142857,14
KCS Old Boys,Old Shirburnians,4,2,6,3.0,1
KCS Old Boys,Old Tiffinians,9,1,10,0.0,1
KCS Old Boys,Old Tonbridgians,47,39,86,3.0454545454545454,22
KCS Old Boys,Old Westminsters,5,1,6,2.5,2
KCS Old Boys,Old Wykehamists,38,27,65,2.5,14
KCS Old Boys,Phoenix Old Boys,4,5,9,5.0,1
KCS Old Boys,Queen Mary College Old Boys,3,3,6,5.0,1
KCS Old Boys,UCL Academicals,5,1,6,2.0,1
KCS Old Boys,West Fulham,4,2,6,3.0,1
KCS Old Boys II,Alleyn Old Boys III,2,3,5,4.0,1
KCS Old Boys II,Lancing Old Boys II,4,2,6,3.0,1
KCS Old Boys II,Old Alleynians III,4,6,10,4.0,2
KCS Old Boys II,Old Amplefordians,4,1,5,2.0,1
KCS Old Boys II,Old Brentwoods II,5,10,15,2.3333333333333335,3
KCS Old Boys II,Old Brentwoods IV,4,5,9,5.0,1
KCS Old Boys II,Old Carthusians II,4,9,13,3.0,2
KCS Old Boys II,Old Epsomians,1,5,6,3.0,2
KCS Old Boys II,Old Haberdashers,4,6,10,3.0,2
KCS Old Boys II,Old Harrovians II,4,1,5,3.0,2
KCS Old Boys II,Old Harrovians III,3,2,5,4.0,1
KCS Old Boys II,Old Johnians II,7,1,8,0.0,1
KCS Old Boys II,Old King's Scholars,2,3,5,4.0,1
KCS Old Boys II,Old Merchant Taylors,1,3,4,3.5,2
KCS Old Boys II,Old Sennockians,2,3,5,3.0,2
KCS Old Boys II,Old Shirburnians,19,9,28,3.5,4
KCS Old Boys II,Old Tenisonians II,2,0,2,2.0,1
KCS Old Boys II,Old Tonbridgians II,4,1,5,2.0,1
KCS Old Boys II,Old Westminsters II,2,4,6,3.0,1
KCS Old Boys Vets,KCS Old Boys,0,0,0,4.0,1
KCS Old Boys Vets,Old Brentwoods Vets,1,4,5,3.0,2
KCS Old Boys Vets,Old Carthusians Vets,10,6,16,4.0,2
KCS Old Boys Vets,Old Cholmeleians Vets,6,1,7,0.0,1
KCS Old Boys Vets,Old Etonians Vets,4,1,5,3.3333333333333335,3
KCS Old Boys Vets,Old Foresters Vets,4,1,5,2.0,1
KCS Old Boys Vets,Old Harrovians Vets,14,2,16,0.0,2
KCS Old Boys Vets,Old Malvernians Vets,2,1,3,4.0,1
KCS Old Boys Vets,Old Reptonians Vets,2,2,4,5.0,1
KCS Old Boys Vets,Old Salopians Vets,4,2,6,3.0,1
KCS Old Boys Vets,Old Wellingtonians Vets,4,4,8,3.0,2
KCS Old Boys Vets,Old Westminsters Vets,2,5,7,2.0,1
KCS Old Boys Vets,Old Wykehamists Vets,8,7,15,3.0,2
KCS Wimbledon 1st XI,KCS Old Boys,1,5,6,2.0,1
KCS Wimbledon 2nd XI,Kings College Wimbledon II,1,6,7,0.0,1
Kimbolton School 1st XI,Old Kimboltonians,3,10,13,2.75,4
"King's College School, Wimbledon 1st XI",KCS Old Boys,14,15,29,1.8333333333333333,6
"King's College School, Wimbledon 2nd XI",Kings College Wimbledon II,6,8,14,2.8,5
Kings College Wimbledon II,Alleyn Old Boys,4,5,9,5.0,1
Kings College Wimbledon II,BB Eagles,2,0,2,2.0,1
Kings College Wimbledon II,City of London,3,6,9,3.0,1
Kings College Wimbledon II,Civil Service II,1,8,9,0.0,1
Kings College Wimbledon II,KCS Old Boys,5,5,10,5.0,2
Kings College Wimbledon II,KCS Wimbledon 2nd XI,6,1,7,0.0,1
Kings College Wimbledon II,"King's College School, Wimbledon 2nd XI",8,6,14,2.8,5
Kings College Wimbledon II,Kings College Wimbledon III,0,0,0,4.0,1
Kings College Wimbledon II,Lancing Old Boys II,18,8,26,2.375,8
Kings College Wimbledon II,Old Albanians,3,7,10,3.0,2
Kings College Wimbledon II,Old Albanians SA,4,2,6,3.0,1
Kings College Wimbledon II,Old Aldenhamians,6,2,8,2.0,1
Kings College Wimbledon II,Old Aldenhamians II,8,14,22,3.2,5
Kings College Wimbledon II,Old Alleynians AFC,4,12,16,2.6666666666666665,3
Kings College Wimbledon II,Old Alleynians II,4,4,8,3.0,2
Kings College Wimbledon II,Old Alleynians III,10,8,18,2.25,4
Kings College Wimbledon II,Old Ardinians,5,12,17,3.0,3
Kings College Wimbledon II,Old Berkhamstedians,16,18,34,3.142857142857143,7
Kings College Wimbledon II,Old Brentwoods II,30,34,64,2.9166666666666665,12
Kings College Wimbledon II,Old Carthusians II,16,21,37,3.125,8
Kings College Wimbledon II,Old Carthusians III,13,12,25,3.142857142857143,7
Kings College Wimbledon II,Old Chigwellians II,8,5,13,3.4,5
Kings College Wimbledon II,Old Cholmeleians II,12,6,18,3.3333333333333335,3
Kings College Wimbledon II,Old Cholmeleians III,6,6,12,3.5,2
Kings College Wimbledon II,Old Citizens,6,19,25,2.0,6
Kings College Wimbledon II,Old Columbans,6,11,17,3.0,2
Kings College Wimbledon II,Old Dorkinians,2,0,2,2.0,1
Kings College Wimbledon II,Old Eastbournians,3,2,5,4.0,2
Kings College Wimbledon II,Old Epsomians,25,28,53,3.4615384615384617,13
Kings College Wimbledon II,Old Etonians II,21,22,43,2.5454545454545454,11
Kings College Wimbledon II,Old Foresters II,25,34,59,3.1818181818181817,11
Kings College Wimbledon II,Old Haberdashers,11,3,14,1.5,2
Kings College Wimbledon II,Old Haileyburians,4,3,7,4.0,1
Kings College Wimbledon II,Old Harrovians II,25,27,52,3.6923076923076925,13
Kings College Wimbledon II,Old Johnians,2,6,8,3.3333333333333335,3
Kings College Wimbledon II,Old Johnians FC,1,3,4,3.5,2
Kings College Wimbledon II,Old Kimboltonians,7,11,18,2.75,4
Kings College Wimbledon II,Old Lyonians,9,3,12,0.0,1
Kings College Wimbledon II,Old Malvernians II,6,8,14,2.3333333333333335,3
Kings College Wimbledon II,Old Marlburians,8,6,14,1.0,2
Kings College Wimbledon II,Old Meadonians,1,6,7,0.0,1
Kings College Wimbledon II,Old Merchant Taylors,10,9,19,2.6,5
Kings College Wimbledon II,Old Millfieldians,2,9,11,2.6666666666666665,3
Kings College Wimbledon II,Old Minchendenians,7,9,16,4.5,2
Kings College Wimbledon II,Old Parkonians,1,3,4,3.0,1
Kings College Wimbledon II,Old Pauline,3,0,3,2.0,1
Kings College Wimbledon II,Old Radleians,2,3,5,4.0,2
Kings College Wimbledon II,Old Salesians,1,2,3,4.0,1
Kings College Wimbledon II,Old Salopians II,9,12,21,3.25,4
Kings College Wimbledon II,Old Sennockians,4,5,9,3.0,4
Kings College Wimbledon II,Old Shirburnians,4,6,10,3.3333333333333335,3
Kings College Wimbledon II,Old Stoics,2,1,3,4.0,1
Kings College Wimbledon II,Old Suttonians SV,8,6,14,3.5,4
Kings College Wimbledon II,Old Tenisonians II,0,7,7,0.0,1
Kings College Wimbledon II,Old Thorntonians IV,5,1,6,2.0,1
Kings College Wimbledon II,Old Tonbridgians II,9,13,22,2.4285714285714284,7
Kings College Wimbledon II,Old Wellingtonians,1,1,2,3.0,2
Kings College Wimbledon II,Old Westminsters,15,19,34,2.857142857142857,7
Kings College Wimbledon II,Old Wykehamists II,16,6,22,2.75,4
Kings College Wimbledon II,Rapid Chingford,1,5,6,2.0,1
Kings College Wimbledon II,Worcester College Old Boys,3,1,4,3.0,1
Kings College Wimbledon III,KCS Old Boys,0,0,0,4.0,1
Kings College Wimbledon III,Kings College Wimbledon II,0,0,0,4.0,1
Kings College Wimbledon III,Old Alleynians AFC,7,6,13,3.0,2
Kings College Wimbledon III,Old Alleynians AFC II,2,5,7,3.5,2
Kings College Wimbledon III,Old Amplefordians,10,10,20,3.8,5
Kings College Wimbledon III,Old Bancroftians AFC,7,2,9,2.5,2
Kings College Wimbledon III,Old Columbans,1,3,4,3.0,1
Kings College Wimbledon III,Old Epsomians II,2,0,2,3.0,2
Kings College Wimbledon III,Old Foresters III,2,4,6,3.5,2
Kings College Wimbledon III,Old Harrovians III,8,12,20,2.0,4
Kings College Wimbledon III,Old Johnians FC,1,7,8,1.5,2
Kings College Wimbledon III,Old King's Scholars,4,7,11,3.5,2
Kings College Wimbledon III,Old Malvernians II,7,4,11,3.5,2
Kings College Wimbledon III,Old Millhillians,3,3,6,5.0,1
Kings College Wimbledon III,Old Rugbeians,6,7,13,3.0,3
Kings College Wimbledon III,Old Shirburnians,2,11,13,1.0,2
Kings College Wimbledon III,Old Stoics,1,2,3,4.0,1
Kings College Wimbledon III,Old Westminsters II,6,9,15,3.0,4
Kings College Wimbledon III,Old Wykehamists II,7,10,17,3.3333333333333335,3
Kings Old Boys,Old Brentwoods II,2,0,2,2.0,1
Kings Old Boys,Old Rugbeians,0,1,1,3.0,1
Kingston Grammar School 1st XI,Old Kingstonians,4,6,10,4.0,2
Kingston Grammar School 1st XI,Old Kingstonians KGS,6,6,12,3.5,2
LM United,Old Alleynians AFC,0,5,5,0.0,1
Lancing College 1st XI,Lancing Old Boys,15,42,57,2.1,10
Lancing College 2nd XI,Lancing Old Boys II,7,20,27,2.5714285714285716,7
Lancing Old Boys,Alleyn Old Boys,0,4,4,1.0,1
Lancing Old Boys,Bealonians,6,0,6,0.0,1
Lancing Old Boys,Corinthian-Casuals,8,6,14,3.75,4
Lancing Old Boys,Economicals,1,2,3,4.0,1
Lancing Old Boys,KCS Old Boys,17,18,35,3.1,10
Lancing Old Boys,Lancing College 1st XI,42,15,57,2.1,10
Lancing Old Boys,Lancing Old Boys II,0,0,0,4.0,1
Lancing Old Boys,Old Albanians,6,6,12,0.0,2
Lancing Old Boys,Old Aldenhamians,24,11,35,2.4285714285714284,7
Lancing Old Boys,Old Alleynians AFC,4,9,13,3.0,3
Lancing Old Boys,Old Alleynians II,7,21,28,1.75,4
Lancing Old Boys,Old Amplefordians,12,1,13,1.0,1
Lancing Old Boys,Old Ardinians,2,10,12,2.5,2
Lancing Old Boys,Old Berkhamstedians,31,34,65,3.3076923076923075,13
Lancing Old Boys,Old Blues,1,1,2,4.0,1
Lancing Old Boys,Old Brentwoods,30,36,66,2.1666666666666665,12
Lancing Old Boys,Old Brentwoods II,0,5,5,2.0,2
Lancing Old Boys,Old Carthusians,10,37,47,2.857142857142857,14
Lancing Old Boys,Old Chigwellians,18,18,36,3.2142857142857144,14
Lancing Old Boys,Old Chigwellians II,13,2,15,1.0,2
Lancing Old Boys,Old Cholmeleians,22,23,45,3.2,15
Lancing Old Boys,Old Cholmeleians II,2,16,18,0.3333333333333333,3
Lancing Old Boys,Old Dorkinians,3,2,5,4.0,1
Lancing Old Boys,Old Etonians,21,19,40,3.3846153846153846,13
Lancing Old Boys,Old Etonians II,5,11,16,3.0,3
Lancing Old Boys,Old Foresters,21,52,73,2.75,20
Lancing Old Boys,Old Hamptonians,2,5,7,2.0,1
Lancing Old Boys,Old Harrovians,44,24,68,2.357142857142857,14
Lancing Old Boys,Old Johnians,3,5,8,3.3333333333333335,3
Lancing Old Boys,Old Kimboltonians,5,11,16,2.0,4
Lancing Old Boys,Old King's Scholars,11,1,12,2.0,2
Lancing Old Boys,Old Kingstonians KGS,5,1,6,3.0,2
Lancing Old Boys,Old Malvernians,23,11,34,3.125,8
Lancing Old Boys,Old Marlburians,29,40,69,2.857142857142857,14
Lancing Old Boys,Old Merchant Taylors,5,3,8,1.0,2
Lancing Old Boys,Old Radleians,12,5,17,3.0,4
Lancing Old Boys,Old Reptonians,17,12,29,2.2857142857142856,7
Lancing Old Boys,Old Rugbeians,6,10,16,3.4,5
Lancing Old Boys,Old Salopians,47,50,97,2.8947368421052633,19
Lancing Old Boys,Old Sedcopians,1,4,5,2.0,1
Lancing Old Boys,Old Sennockians,6,1,7,0.0,1
Lancing Old Boys,Old Tonbridgians,25,26,51,3.0,10
Lancing Old Boys,Old Westminsters,16,32,48,3.25,8
Lancing Old Boys,Old Woodhouseians,0,5,5,0.0,1
Lancing Old Boys,Old Wykehamists,17,12,29,2.3333333333333335,6
Lancing Old Boys,Richmond & Kew SAL,3,4,7,3.0,2
Lancing Old Boys,Sinjun Grammarians,2,3,5,4.0,1
Lancing Old Boys,Worcester College Old Boys,2,4,6,3.0,1
Lancing Old Boys II,KCS Old Boys II,2,4,6,3.0,1
Lancing Old Boys II,Kings College Wimbledon II,8,18,26,2.375,8
Lancing Old Boys II,Lancing College 2nd XI,20,7,27,2.5714285714285716,7
Lancing Old Boys II,Lancing Old Boys,0,0,0,4.0,1
Lancing Old Boys II,Old Albanians SA,0,2,2,2.0,1
Lancing Old Boys II,Old Aldenhamians II,4,4,8,4.0,2
Lancing Old Boys II,Old Alleynians AFC,3,26,29,0.5,4
Lancing Old Boys II,Old Alleynians AFC II,3,1,4,3.0,1
Lancing Old Boys II,Old Alleynians AFC III,2,3,5,4.0,1
Lancing Old Boys II,Old Ardinians,4,13,17,2.3333333333333335,3
Lancing Old Boys II,Old Berkhamstedians,7,3,10,3.0,4
Lancing Old Boys II,Old Blues,1,3,4,3.0,1
Lancing Old Boys II,Old Brentwoods III,0,2,2,2.0,1
Lancing Old Boys II,Old Brentwoods IV,7,5,12,4.0,2
Lancing Old Boys II,Old Carthusians II,11,26,37,3.076923076923077,13
Lancing Old Boys II,Old Carthusians III,25,35,60,2.625,16
Lancing Old Boys II,Old Cheltonians,1,3,4,2.5,2
Lancing Old Boys II,Old Chigwellians II,19,16,35,3.5,12
Lancing Old Boys II,Old Cholmeleians II,11,24,35,3.0,7
Lancing Old Boys II,Old Citizens,2,5,7,3.5,2
Lancing Old Boys II,Old Columbans,1,6,7,2.5,2
Lancing Old Boys II,Old Eastbournians,2,3,5,4.0,2
Lancing Old Boys II,Old Epsomians,5,6,11,4.5,2
Lancing Old Boys II,Old Etonians II,14,17,31,2.8,10
Lancing Old Boys II,Old Foresters II,18,10,28,2.6,10
Lancing Old Boys II,Old Haberdashers,14,7,21,2.8333333333333335,6
Lancing Old Boys II,Old Haileyburians,0,0,0,4.0,1
Lancing Old Boys II,Old Harrovians II,15,11,26,3.6666666666666665,6
Lancing Old Boys II,Old Harrovians III,7,11,18,3.6,5
Lancing Old Boys II,Old Johnians FC,2,8,10,2.6666666666666665,3
Lancing Old Boys II,Old King's Scholars,12,8,20,3.0,5
Lancing Old Boys II,Old Kingstonians,5,15,20,3.0,2
Lancing Old Boys II,Old Marlburians,3,7,10,3.3333333333333335,3
Lancing Old Boys II,Old Merchant Taylors,4,4,8,4.0,2
Lancing Old Boys II,Old Merchant Taylors II,0,7,7,0.0,1
Lancing Old Boys II,Old Millfieldians,9,8,17,4.333333333333333,3
Lancing Old Boys II,Old Oundelians,7,11,18,4.0,3
Lancing Old Boys II,Old Radleians,0,10,10,0.5,2
Lancing Old Boys II,Old Reptonians,1,4,5,3.0,2
Lancing Old Boys II,Old Salopians II,11,7,18,3.1666666666666665,6
Lancing Old Boys II,Old Sennockians,5,1,6,2.6666666666666665,3
Lancing Old Boys II,Old Shirburnians,3,10,13,2.0,2
Lancing Old Boys II,Old Stoics,5,11,16,3.0,4
Lancing Old Boys II,Old Suttonians SV,2,6,8,3.0,2
Lancing Old Boys II,Old Tonbridgians II,7,8,15,0.0,2
Lancing Old Boys II,Old Wellingburians,3,2,5,4.0,1
Lancing Old Boys II,Old Wellingtonians,17,38,55,2.8181818181818183,11
Lancing Old Boys II,Old Westminsters,21,26,47,2.125,8
Lancing Old Boys II,Old Westminsters II,3,9,12,2.0,2
Lancing Old Boys II,Old Wilsonians V,0,1,1,3.0,1
Lancing Old Boys II,Old Wykehamists II,7,2,9,2.0,2
Lancing Old Boys Vets,Old Bradfieldians Vets,8,1,9,1.5,2
Lancing Old Boys Vets,Old Brentwoods Vets,4,5,9,3.6666666666666665,3
Lancing Old Boys Vets,Old Carthusians Vets,5,2,7,3.0,2
Lancing Old Boys Vets,Old Chigwellians Vets,0,0,0,4.0,1
Lancing Old Boys Vets,Old Cholmeleians Vets,4,4,8,5.0,2
Lancing Old Boys Vets,Old Etonians Vets,4,13,17,2.3333333333333335,3
Lancing Old Boys Vets,Old Foresters Vets,5,9,14,3.6666666666666665,3
Lancing Old Boys Vets,Old Harrovians Vets,5,5,10,4.0,2
Lancing Old Boys Vets,Old Malvernians Vets,6,5,11,3.5,2
Lancing Old Boys Vets,Old Reptonians Vets,8,2,10,0.0,1
Lancing Old Boys Vets,Old Salopians Vets,0,6,6,0.0,1
Lancing Old Boys Vets,Old Tonbridgians Vets,14,3,17,1.6666666666666667,3
Lancing Old Boys Vets,Old Wellingtonians Vets,2,2,4,4.0,2
Lancing Old Boys Vets,Old Westminsters Vets,15,13,28,4.0,2
Lancing Old Boys Vets,Old Wykehamists Vets,4,4,8,4.5,2
Latymer Old Boys,Old Aldenhamians II,3,2,5,4.0,1
Latymer Old Boys,Old Etonians,1,4,5,2.0,1
Latymer Old Boys,Old Foresters,1,4,5,2.0,1
Latymer Old Boys,Old Malvernians,8,2,10,0.0,1
Latymer Old Boys,Old Salopians II,4,1,5,2.0,1
Lea Valley,Old Aldenhamians,4,1,5,2.0,1
Lea Valley,Old Etonians,1,5,6,2.0,1
Leyton County Old Boys,Old Bancroftians AFC,1,3,4,3.0,1
Leyton County Old Boys,Old Cholmeleians,1,2,3,4.0,1
Little Heath,Old Bancroftians,2,3,5,4.0,1
Lloyds of London Representative Team,Arthurian League Representative Team,4,14,18,2.75,4
London Lawyers,Old Cholmeleians,2,4,6,3.0,1
London Lions Vets,Old Chigwellians Vets,4,2,6,3.0,1
London Welsh F.C.,Old Aldenhamians,3,0,3,2.0,1
London Welsh F.C.,Old Carthusians III,0,6,6,0.0,1
London Welsh F.C.,Old Chigwellians,3,4,7,4.0,1
London Welsh F.C.,Old Johnians FC,4,5,9,5.0,1
London Welsh F.C.,Old Malvernians,3,1,4,3.0,1
London Welsh F.C.,Old Millfieldians,2,1,3,4.0,1
London Welsh F.C.,Old Wykehamists,1,3,4,3.0,1
Malvern College 1st XI,Old Malvernians,6,10,16,3.6666666666666665,6
Malvern College 2nd XI,Old Malvernians II,3,3,6,3.5,2
Marlborough College 1st XI,Old Marlburians,9,27,36,2.4,5
Mayfield,Old Brentwoods,7,9,16,3.5,2
Mayfield,Old Eastbournians,2,1,3,4.0,1
Merchant Taylors School 1st XI,Old Merchant Taylors,2,0,2,2.0,1
Merchant Taylors School 1st XI,Old Merchant Taylors',5,0,5,0.0,1
Merchant Taylors School 2nd XI,Old Merchant Taylors II,0,5,5,0.0,1
Merton,Old Carthusians,1,4,5,2.0,1
Merton,Old Carthusians II,4,1,5,2.0,1
Merton,Old Carthusians III,2,4,6,3.0,1
Merton,Old Chigwellians,1,3,4,3.0,1
Mickleham Old Boxhillians FC,Old Malvernians,4,4,8,6.0,1
Mill Hill Village,Old Cholmeleians II,2,4,6,3.0,1
Mill Hill Village,Old Columbans,3,4,7,4.0,1
Mill Hill Village,Old Foresters II,0,3,3,2.0,1
Mill Hill Village,Old Reptonians,4,1,5,2.0,1
Millfield School 1st XI,Old Millfieldians,1,6,7,2.5,2
Montpellier Villa FC,KCS Old Boys,1,1,2,4.0,1
NUFC Oilers,Old Carthusians II,6,4,10,4.0,2
NUFC Oilers,Old Foresters,4,1,5,2.0,2
NUFC Oilers,Old Reptonians,2,3,5,4.0,1
NUFC Oilers,Old Salopians,3,0,3,2.5,2
National Westminster Bank,Old Sennockians,0,3,3,2.0,1
New College Old Boys,Old Chigwellians,3,3,6,5.0,1
New College Old Boys,Old Westminsters,4,9,13,2.5,2
New College Old Boys,Old Wykehamists,1,8,9,0.0,1
New Magdalen,Old Cholmeleians,1,0,1,3.0,1
New-Magdalen AFC,Old Aldenhamians,1,0,1,3.0,1
Norsemen,Old Foresters,2,13,15,0.0,2
Northchurch Baptist Church FC,Old Berkhamstedians,2,4,6,3.0,1
Nottsborough FC,Old Aldenhamians,3,2,5,4.0,1
Nottsborough FC,Old Carthusians,12,17,29,3.5714285714285716,7
Nottsborough FC,Old Carthusians III,4,3,7,2.5,2
Nottsborough FC III,Old Carthusians III,1,1,2,4.0,1
Oakhill Tigers,Old Aldenhamians II,7,0,7,0.0,1
Oakhill Tigers,Old Cholmeleians,3,4,7,4.0,1
Oakhill Tigers,Old Cholmeleians III,8,1,9,0.0,1
Old Actonians Association FC,KCS Old Boys,4,3,7,4.0,1
Old Actonians Association FC,Old Carthusians,0,2,2,2.0,1
Old Actonians Association FC,Old Carthusians III,2,7,9,2.5,2
Old Albanians,Kings College Wimbledon II,7,3,10,3.0,2
Old Albanians,Lancing Old Boys,6,6,12,0.0,2
Old Albanians,Old Aldenhamians,5,10,15,2.6666666666666665,3
Old Albanians,Old Alleynians II,1,3,4,3.0,1
Old Albanians,Old Alleynians III,9,14,23,1.75,4
Old Albanians,Old Ardinians,6,12,18,3.5,4
Old Albanians,Old Berkhamstedians,3,5,8,4.0,2
Old Albanians,Old Berkhamstedians II,0,0,0,4.0,1
Old Albanians,Old Brentwoods II,8,2,10,2.0,2
Old Albanians,Old Brentwoods III,3,2,5,4.0,1
Old Albanians,Old Carthusians II,15,8,23,3.5,4
Old Albanians,Old Chigwellians II,15,6,21,3.0,3
Old Albanians,Old Cholmeleians II,3,10,13,2.0,2
Old Albanians,Old Epsomians,9,6,15,3.6666666666666665,3
Old Albanians,Old Etonians II,6,8,14,4.5,2
Old Albanians,Old Harrovians II,3,2,5,4.0,1
Old Albanians,Old Kimboltonians,5,11,16,3.0,2
Old Albanians,Old Merchant Taylors,8,6,14,2.0,2
Old Albanians,Old Sennockians,0,4,4,1.0,1
Old Albanians,Old Shirburnians,4,5,9,3.0,2
Old Albanians,Old Tonbridgians II,9,3,12,2.5,2
Old Albanians SA,Kings College Wimbledon II,2,4,6,3.0,1
Old Albanians SA,Lancing Old Boys II,2,0,2,2.0,1
Old Albanians SA,Old Aldenhamians,4,4,8,5.0,2
Old Albanians SA,Old Alleynians AFC II,6,1,7,0.0,1
Old Albanians SA,Old Ardinians,2,7,9,0.0,1
Old Albanians SA,Old Bancroftians,4,3,7,2.5,2
Old Albanians SA,Old Brentwoods II,4,2,6,3.5,2
Old Albanians SA,Old Brentwoods III,23,17,40,2.4285714285714284,7
Old Albanians SA,Old Brentwoods IV,19,0,19,1.0,1
Old Albanians SA,Old Chigwellians III,13,7,20,3.6,5
Old Albanians SA,Old Cholmeleians II,23,17,40,3.875,8
Old Albanians SA,Old Columbans,5,16,21,2.3333333333333335,3
Old Albanians SA,Old Epsomians,2,5,7,2.0,1
Old Albanians SA,Old Epsomians II,2,6,8,2.0,1
Old Albanians SA,Old Foresters III,6,5,11,3.0,3
Old Albanians SA,Old Haberdashers,12,6,18,3.0,4
Old Albanians SA,Old Harrovians III,14,6,20,2.6666666666666665,3
Old Albanians SA,Old Johnians,4,4,8,6.0,1
Old Albanians SA,Old Johnians FC,5,5,10,6.0,1
Old Albanians SA,Old Kimboltonians,6,14,20,2.0,3
Old Albanians SA,Old King's Scholars,7,2,9,3.0,3
Old Albanians SA,Old Kingstonians,3,0,3,2.0,1
Old Albanians SA,Old Merchant Taylors II,12,8,20,3.75,4
Old Albanians SA,Old Merchant Taylors' II,10,0,10,0.5,2
Old Albanians SA,Old Rugbeians,2,3,5,4.0,1
Old Albanians SA,Old Shirburnians,6,6,12,3.6666666666666665,3
Old Albanians SA,Old Stoics,11,4,15,2.5,4
Old Albanians SA,Old Wellingtonians,15,6,21,2.6666666666666665,3
Old Albanians SA,Old Westminsters II,4,4,8,5.0,2
Old Albanians SA,Old Wykehamists II,1,6,7,0.0,1
Old Albanians SA,St Albans School 1st XI,4,3,7,4.0,1
Old Aldenhamians,Albanian FC,0,1,1,3.0,1
Old Aldenhamians,Aldenham School 1st XI,6,14,20,2.5,4
Old Aldenhamians,Egbertian FC,7,4,11,3.0,1
Old Aldenhamians,Globe Rangers,5,5,10,3.0,2
Old Aldenhamians,Hampstead Heathens,2,1,3,4.0,1
Old Aldenhamians,Heathrow Seniors,2,3,5,4.0,1
Old Aldenhamians,KCS Old Boys,1,16,17,1.3333333333333333,3
Old Aldenhamians,Kings College Wimbledon II,2,6,8,2.0,1
Old Aldenhamians,Lancing Old Boys,11,24,35,2.4285714285714284,7
Old Aldenhamians,Lea Valley,1,4,5,2.0,1
Old Aldenhamians,London Welsh F.C.,0,3,3,2.0,1
Old Aldenhamians,New-Magdalen AFC,0,1,1,3.0,1
Old Aldenhamians,Nottsborough FC,2,3,5,4.0,1
Old Aldenhamians,Old Albanians,10,5,15,2.6666666666666665,3
Old Aldenhamians,Old Albanians SA,4,4,8,5.0,2
Old Aldenhamians,Old Alleynians AFC,1,8,9,1.5,2
Old Aldenhamians,Old Alleynians II,16,31,47,3.111111111111111,9
Old Aldenhamians,Old Ardinians,4,10,14,2.5,2
Old Aldenhamians,Old Berkhamstedians,21,41,62,2.4,10
Old Aldenhamians,Old Bradfieldians,23,36,59,2.6666666666666665,12
Old Aldenhamians,Old Brentwoods,4,31,35,0.5,4
Old Aldenhamians,Old Brentwoods II,2,2,4,5.0,1
Old Aldenhamians,Old Carthusians II,11,10,21,2.8,5
Old Aldenhamians,Old Chigwellians,3,13,16,2.2,5
Old Aldenhamians,Old Chigwellians II,18,15,33,3.2222222222222223,9
Old Aldenhamians,Old Cholmeleians,7,29,36,2.4285714285714284,7
Old Aldenhamians,Old Cholmeleians II,9,11,20,3.2,5
Old Aldenhamians,Old Columbans,4,4,8,6.0,1
Old Aldenhamians,Old Edmontonians,4,2,6,3.0,1
Old Aldenhamians,Old Epsomians,1,2,3,4.0,1
Old Aldenhamians,Old Etonians II,11,36,47,2.6363636363636362,11
Old Aldenhamians,Old Foresters,1,9,10,1.5,2
Old Aldenhamians,Old Foresters II,5,5,10,5.0,2
Old Aldenhamians,Old Haileyburians,33,14,47,2.5555555555555554,9
Old Aldenhamians,Old Hamptonians,2,1,3,4.0,1
Old Aldenhamians,Old Harrovians,5,22,27,1.8333333333333333,6
Old Aldenhamians,Old Harrovians II,15,17,32,3.857142857142857,7
Old Aldenhamians,Old Johnians,2,12,14,2.25,4
Old Aldenhamians,Old Kimboltonians,17,28,45,3.375,8
Old Aldenhamians,Old King's Scholars,18,3,21,2.0,5
Old Aldenhamians,Old Kingstonians,5,1,6,2.0,1
Old Aldenhamians,Old Magdalenians,4,1,5,2.0,1
Old Aldenhamians,Old Malvernians,30,38,68,3.0,15
Old Aldenhamians,Old Marlburians,8,14,22,3.25,4
Old Aldenhamians,Old Merchant Taylors,15,15,30,2.1666666666666665,6
Old Aldenhamians,Old Merchant Taylors',6,3,9,2.5,2
Old Aldenhamians,Old Millfieldians,8,10,18,1.0,3
Old Aldenhamians,Old Millhillians,4,3,7,4.0,1
Old Aldenhamians,Old Owens,1,4,5,2.0,1
Old Aldenhamians,Old Pegasonians F.C.,6,3,9,3.5,2
Old Aldenhamians,Old Radleians,36,37,73,2.5,16
Old Aldenhamians,Old Reptonians,23,52,75,1.9285714285714286,14
Old Aldenhamians,Old Rugbeians,7,12,19,2.3333333333333335,3
Old Aldenhamians,Old Salopians,2,9,11,1.5,2
Old Aldenhamians,Old Sedcopians,2,1,3,4.0,1
Old Aldenhamians,Old Sennockians,20,17,37,3.0,7
Old Aldenhamians,Old St Marys,2,0,2,2.0,1
Old Aldenhamians,Old Strand Academicals,9,8,17,3.6666666666666665,3
Old Aldenhamians,Old Tonbridgians,6,13,19,1.75,4
Old Aldenhamians,Old Tonbridgians II,9,2,11,2.0,2
Old Aldenhamians,Old Wellingtonians,14,10,24,3.0,6
Old Aldenhamians,Old Westminsters,8,23,31,2.5714285714285716,7
Old Aldenhamians,Old Wykehamists,22,24,46,3.0,10
Old Aldenhamians,Queen Mary College Old Boys,2,5,7,2.0,1
Old Aldenhamians,Reigatians II,2,3,5,4.0,1
Old Aldenhamians,Southgate County,7,0,7,1.0,2
Old Aldenhamians,University of Hertfordshire,7,1,8,0.0,1
Old Aldenhamians,Wandsworth Borough,0,4,4,1.0,1
Old Aldenhamians,Winchmore Hill,0,3,3,2.0,1
Old Aldenhamians,Worcester College Old Boys,0,2,2,2.0,1
Old Aldenhamians II,Albanian FC,5,2,7,2.0,1
Old Aldenhamians II,Aldenham School 2nd XI,1,11,12,1.5,2
Old Aldenhamians II,Alleyn Old Boys,2,6,8,2.0,1
Old Aldenhamians II,Bealonians,2,6,8,2.0,1
Old Aldenhamians II,Enfield Old Grammarians,0,7,7,0.0,1
Old Aldenhamians II,Kings College Wimbledon II,14,8,22,3.2,5
Old Aldenhamians II,Lancing Old Boys II,4,4,8,4.0,2
Old Aldenhamians II,Latymer Old Boys,2,3,5,4.0,1
Old Aldenhamians II,Oakhill Tigers,0,7,7,0.0,1
Old Aldenhamians II,Old Alleynians AFC,6,8,14,3.5,4
Old Aldenhamians II,Old Berkhamstedians,0,6,6,1.5,2
Old Aldenhamians II,Old Brentwoods II,5,6,11,3.3333333333333335,3
Old Aldenhamians II,Old Carthusians II,3,11,14,2.5,2
Old Aldenhamians II,Old Carthusians III,4,10,14,3.25,4
Old Aldenhamians II,Old Challoners,2,0,2,2.0,1
Old Aldenhamians II,Old Chigwellians II,7,13,20,2.6666666666666665,6
Old Aldenhamians II,Old Chigwellians III,1,5,6,1.5,2
Old Aldenhamians II,Old Cholmeleians II,6,11,17,2.6666666666666665,3
Old Aldenhamians II,Old Cholmeleians III,3,0,3,2.5,2
Old Aldenhamians II,Old Citizens,8,14,22,3.6,5
Old Aldenhamians II,Old Crosbeians,3,0,3,2.0,1
Old Aldenhamians II,Old Eastbournians,10,11,21,3.75,4
Old Aldenhamians II,Old Epsomians,20,24,44,3.375,8
Old Aldenhamians II,Old Etonians II,4,4,8,4.0,2
Old Aldenhamians II,Old Foresters II,6,3,9,3.6666666666666665,3
Old Aldenhamians II,Old Haberdashers,9,12,21,3.5,4
Old Aldenhamians II,Old Harrovians II,12,13,25,1.6666666666666667,6
Old Aldenhamians II,Old Johnians FC,0,9,9,0.0,1
Old Aldenhamians II,Old Malvernians II,2,1,3,4.0,1
Old Aldenhamians II,Old Manorians,3,2,5,4.0,1
Old Aldenhamians II,Old Marlburians,8,20,28,2.5,4
Old Aldenhamians II,Old Merchant Taylors,3,11,14,2.0,3
Old Aldenhamians II,Old Millfieldians,1,15,16,1.5,2
Old Aldenhamians II,Old Millhillians,6,2,8,2.5,2
Old Aldenhamians II,Old Minchendenians,1,6,7,0.0,1
Old Aldenhamians II,Old Parmiterians,8,9,17,2.5,2
Old Aldenhamians II,Old Rugbeians,2,7,9,2.5,2
Old Aldenhamians II,Old Salopians II,12,21,33,2.888888888888889,9
Old Aldenhamians II,Old Sennockians,6,8,14,3.25,4
Old Aldenhamians II,Old Stoics,4,4,8,4.333333333333333,3
Old Aldenhamians II,Old Thorntonians,0,5,5,0.0,1
Old Aldenhamians II,Old Tiffinians,7,3,10,2.0,1
Old Aldenhamians II,Old Tonbridgians II,5,22,27,1.5,4
Old Aldenhamians II,Old Vaughanians,3,0,3,2.0,1
Old Aldenhamians II,Old Wellingburians,4,4,8,6.0,1
Old Aldenhamians II,Old Wellingtonians,10,19,29,2.0,4
Old Aldenhamians II,Old Wykehamists II,12,11,23,3.25,4
Old Aldenhamians II,Southgate Olympic,1,2,3,4.0,1
Old Aldenhamians II,Wake Green Amateur,1,5,6,2.0,1
Old Aldenhamians Vets,Old Berkhamstedians Vets,2,4,6,3.0,1
Old Aldenhamians Vets,Old Bradfieldians Vets,1,8,9,0.0,1
Old Aldenhamians Vets,Old Brentwoods Vets,0,6,6,0.0,1
Old Aldenhamians Vets,Old Etonians Vets,0,5,5,0.0,1
Old Aldenhamians Vets,Old Foresters Vets,12,15,27,0.6666666666666666,3
Old Aldenhamians Vets,Old Salopians Vets,4,7,11,3.5,2
Old Aldenhamians Vets,Old Wellingtonians Vets,4,6,10,4.0,2
Old Alleynians,Dulwich College 1st XI,5,1,6,2.0,1
Old Alleynians,Fulham Compton Old Boys,3,2,5,4.0,1
Old Alleynians,KCS Old Boys,36,20,56,2.6,10
Old Alleynians,Old Berkhamstedians,5,2,7,2.0,1
Old Alleynians,Old Bradfieldians,36,25,61,3.111111111111111,9
Old Alleynians,Old Brentwoods,23,16,39,2.888888888888889,9
Old Alleynians,Old Carthusians,23,10,33,2.5714285714285716,7
Old Alleynians,Old Chigwellians,9,8,17,4.0,3
Old Alleynians,Old Cholmeleians,22,5,27,1.8,5
Old Alleynians,Old Columbans,4,1,5,2.0,1
Old Alleynians,Old Etonians,22,19,41,3.3,10
Old Alleynians,Old Foresters,18,18,36,2.857142857142857,7
Old Alleynians,Old Hamptonians,1,7,8,2.0,2
Old Alleynians,Old Harrovians,24,5,29,2.0,4
Old Alleynians,Old Johnians,7,0,7,0.0,1
Old Alleynians,Old Kimboltonians,0,3,3,2.0,1
Old Alleynians,Old Meadonians,3,2,5,4.0,1
Old Alleynians,Old Reptonians,21,19,40,3.375,8
Old Alleynians,Old Rugbeians,8,1,9,0.0,1
Old Alleynians,Old Suttonians,3,4,7,4.0,1
Old Alleynians,Old Tonbridgians,33,14,47,2.5555555555555554,9
Old Alleynians,Old Wykehamists,24,11,35,2.5,6
Old Alleynians,Reigatians,5,1,6,2.0,1
Old Alleynians,South Bank Cuaco,2,2,4,5.0,1
Old Alleynians,Yorxeter FC,2,1,3,4.0,1
Old Alleynians AFC,Alexandra Park FC,7,0,7,0.0,1
Old Alleynians AFC,Beder FC,10,10,20,7.0,1
Old Alleynians AFC,Clissold Park Rangers,2,2,4,5.0,1
Old Alleynians AFC,Dulwich College 1st XI,17,10,27,3.4,5
Old Alleynians AFC,KCS Old Boys,2,9,11,1.5,2
Old Alleynians AFC,Kings College Wimbledon II,12,4,16,2.6666666666666665,3
Old Alleynians AFC,Kings College Wimbledon III,6,7,13,3.0,2
Old Alleynians AFC,LM United,5,0,5,0.0,1
Old Alleynians AFC,Lancing Old Boys,9,4,13,3.0,3
Old Alleynians AFC,Lancing Old Boys II,26,3,29,0.5,4
Old Alleynians AFC,Old Aldenhamians,8,1,9,1.5,2
Old Alleynians AFC,Old Aldenhamians II,8,6,14,3.5,4
Old Alleynians AFC,Old Amplefordians,5,4,9,5.0,1
Old Alleynians AFC,Old Bancroftians AFC,4,1,5,2.0,1
Old Alleynians AFC,Old Berkhamstedians,5,3,8,3.0,2
Old Alleynians AFC,Old Bradfieldians,6,3,9,3.5,2
Old Alleynians AFC,Old Brentwoods,0,4,4,1.0,1
Old Alleynians AFC,Old Brentwoods II,4,2,6,3.0,1
Old Alleynians AFC,Old Brentwoods IV,4,1,5,2.0,1
Old Alleynians AFC,Old Carthusians,4,13,17,2.5,4
Old Alleynians AFC,Old Carthusians II,3,2,5,4.0,2
Old Alleynians AFC,Old Carthusians III,9,3,12,2.3333333333333335,3
Old Alleynians AFC,Old Chigwellians,15,7,22,2.6666666666666665,3
Old Alleynians AFC,Old Chigwellians II,4,4,8,2.5,2
Old Alleynians AFC,Old Chigwellians III,3,1,4,3.0,2
Old Alleynians AFC,Old Cholmeleians,6,4,10,3.0,2
Old Alleynians AFC,Old Cholmeleians III,17,2,19,0.0,2
Old Alleynians AFC,Old Citizens,10,6,16,1.6666666666666667,3
Old Alleynians AFC,Old Eastbournians,7,4,11,4.0,2
Old Alleynians AFC,Old Epsomians,7,3,10,3.0,2
Old Alleynians AFC,Old Etonians,6,4,10,4.0,3
Old Alleynians AFC,Old Etonians II,7,1,8,2.0,2
Old Alleynians AFC,Old Foresters,3,5,8,3.5,2
Old Alleynians AFC,Old Foresters II,6,4,10,4.0,3
Old Alleynians AFC,Old Foresters III,17,2,19,1.3333333333333333,3
Old Alleynians AFC,Old Hamptonians,1,2,3,4.0,1
Old Alleynians AFC,Old Harrovians,26,15,41,3.2857142857142856,7
Old Alleynians AFC,Old Harrovians II,16,12,28,3.1666666666666665,6
Old Alleynians AFC,Old Kimboltonians,5,4,9,4.5,2
Old Alleynians AFC,Old Malvernians,15,7,22,3.2,5
Old Alleynians AFC,Old Marlburians,13,6,19,3.25,4
Old Alleynians AFC,Old Merchant Taylors,9,5,14,3.0,3
Old Alleynians AFC,Old Merchant Taylors II,7,1,8,0.0,1
Old Alleynians AFC,Old Millfieldians,3,3,6,3.5,2
Old Alleynians AFC,Old Millhillians,22,14,36,3.6666666666666665,6
Old Alleynians AFC,Old Oundelians,9,5,14,3.3333333333333335,3
Old Alleynians AFC,Old Radleians,11,8,19,3.75,4
Old Alleynians AFC,Old Reptonians,16,7,23,1.0,3
Old Alleynians AFC,Old Rugbeians,2,1,3,4.0,1
Old Alleynians AFC,Old Salopians,5,3,8,2.75,4
Old Alleynians AFC,Old Salopians II,11,4,15,2.0,2
Old Alleynians AFC,Old Sennockians,10,0,10,1.3333333333333333,3
Old Alleynians AFC,Old Stoics,17,4,21,1.3333333333333333,3
Old Alleynians AFC,Old Strand Academicals,3,0,3,2.0,1
Old Alleynians AFC,Old Tonbridgians,9,6,15,3.5,4
Old Alleynians AFC,Old Tonbridgians II,13,9,22,3.0,6
Old Alleynians AFC,Old Westminsters,4,3,7,4.0,2
Old Alleynians AFC,Old Westminsters II,20,8,28,3.0,5
Old Alleynians AFC,Old Wykehamists II,7,3,10,2.0,2
Old Alleynians AFC,Parklife FC,2,2,4,5.0,1
Old Alleynians AFC,Weirside Rangers,3,2,5,4.0,1
Old Alleynians AFC,West Wickham,0,0,0,4.0,1
Old Alleynians AFC II,Dulwich College 2nd XI,5,0,5,2.6666666666666665,3
Old Alleynians AFC II,Kings College Wimbledon III,5,2,7,3.5,2
Old Alleynians AFC II,Lancing Old Boys II,1,3,4,3.0,1
Old Alleynians AFC II,Old Albanians SA,1,6,7,0.0,1
Old Alleynians AFC II,Old Amplefordians,21,17,38,4.8,5
Old Alleynians AFC II,Old Bancroftians AFC,8,12,20,3.0,6
Old Alleynians AFC II,Old Brentwoods II,9,9,18,3.0,5
Old Alleynians AFC II,Old Brentwoods III,4,2,6,3.5,2
Old Alleynians AFC II,Old Carthusians II,3,2,5,4.0,2
Old Alleynians AFC II,Old Chigwellians II,1,1,2,4.0,1
Old Alleynians AFC II,Old Columbans,2,4,6,3.5,2
Old Alleynians AFC II,Old Eastbournians,8,1,9,1.5,2
Old Alleynians AFC II,Old Epsomians II,2,1,3,4.0,1
Old Alleynians AFC II,Old Foresters III,6,0,6,0.0,1
Old Alleynians AFC II,Old Haberdashers,17,4,21,0.0,2
Old Alleynians AFC II,Old Harrovians II,1,2,3,4.0,1
Old Alleynians AFC II,Old Harrovians III,16,19,35,2.1666666666666665,6
Old Alleynians AFC II,Old Johnians FC,13,16,29,4.166666666666667,6
Old Alleynians AFC II,Old Kimboltonians,6,4,10,4.0,2
Old Alleynians AFC II,Old King's Scholars,4,3,7,4.0,2
Old Alleynians AFC II,Old Malvernians II,9,6,15,1.0,2
Old Alleynians AFC II,Old Merchant Taylors II,9,2,11,2.3333333333333335,3
Old Alleynians AFC II,Old Rugbeians,9,14,23,2.4,5
Old Alleynians AFC II,Old Salopians II,8,3,11,0.0,1
Old Alleynians AFC II,Old Shirburnians,18,3,21,1.3333333333333333,3
Old Alleynians AFC II,Old Stoics,26,21,47,3.75,8
Old Alleynians AFC II,Old Suttonians SV,15,13,28,3.6,5
Old Alleynians AFC II,Old Tonbridgians II,3,4,7,4.0,2
Old Alleynians AFC II,Old Westminsters II,9,5,14,3.0,2
Old Alleynians AFC II,Old Wykehamists II,7,5,12,1.0,2
Old Alleynians AFC III,Dulwich College 3rd XI,5,0,5,0.0,1
Old Alleynians AFC III,Lancing Old Boys II,3,2,5,4.0,1
Old Alleynians AFC III,Old Amplefordians,8,5,13,2.0,3
Old Alleynians AFC III,Old Berkhamstedians II,12,5,17,2.0,2
Old Alleynians AFC III,Old Cholmeleians II,3,2,5,4.0,1
Old Alleynians AFC III,Old Eastbournians,13,7,20,3.3333333333333335,3
Old Alleynians AFC III,Old Gregorians,10,3,13,1.0,1
Old Alleynians AFC III,Old Harrovians III,10,6,16,3.5,2
Old Alleynians AFC III,Old Kimboltonians,4,4,8,6.0,1
Old Alleynians AFC III,Old King's Scholars,7,3,10,3.0,2
Old Alleynians AFC III,Old Kingstonians KGS,10,3,13,2.0,2
Old Alleynians AFC III,Old Stoics,3,3,6,2.5,2
Old Alleynians AFC III,Old Wellingtonians,3,4,7,4.0,1
Old Alleynians AFC III,Old Westminsters II,7,4,11,3.5,2
Old Alleynians AFC III,Old Wykehamists II,6,2,8,2.0,2
Old Alleynians II,Dulwich College 2nd XI,0,0,0,4.0,1
Old Alleynians II,Kings College Wimbledon II,4,4,8,3.0,2
Old Alleynians II,Lancing Old Boys,21,7,28,1.75,4
Old Alleynians II,Old Albanians,3,1,4,3.0,1
Old Alleynians II,Old Aldenhamians,31,16,47,3.111111111111111,9
Old Alleynians II,Old Ardinians,6,6,12,3.6666666666666665,3
Old Alleynians II,Old Berkhamstedians,11,5,16,3.2,5
Old Alleynians II,Old Berkhamstedians II,0,0,0,4.0,1
Old Alleynians II,Old Brentwoods II,18,2,20,1.0,4
Old Alleynians II,Old Brentwoods III,2,1,3,4.0,1
Old Alleynians II,Old Carthusians II,7,5,12,4.0,3
Old Alleynians II,Old Carthusians III,3,3,6,5.0,1
Old Alleynians II,Old Chigwellians II,21,13,34,2.6666666666666665,6
Old Alleynians II,Old Cholmeleians II,12,13,25,3.0,6
Old Alleynians II,Old Epsomians,10,6,16,2.6666666666666665,3
Old Alleynians II,Old Etonians II,14,28,42,2.5555555555555554,9
Old Alleynians II,Old Foresters II,3,2,5,4.0,1
Old Alleynians II,Old Harrovians II,12,4,16,1.25,4
Old Alleynians II,Old Johnians,6,9,15,4.0,3
Old Alleynians II,Old Kimboltonians,19,12,31,2.1666666666666665,6
Old Alleynians II,Old Malvernians,4,6,10,4.0,2
Old Alleynians II,Old Merchant Taylors,2,2,4,5.0,1
Old Alleynians II,Old Merchant Taylors',19,2,21,0.5,2
Old Alleynians II,Old Radleians,9,6,15,3.75,4
Old Alleynians II,Old Sennockians,14,7,21,2.75,4
Old Alleynians II,Old Shirburnians,5,1,6,2.0,1
Old Alleynians II,Old Suttonians II,2,1,3,4.0,1
Old Alleynians II,Old Suttonians SV,6,0,6,0.0,1
Old Alleynians II,Old Tenisonians II,2,1,3,4.0,1
Old Alleynians II,Old Tonbridgians II,11,0,11,1.5,2
Old Alleynians II,Old Westminsters,4,0,4,1.0,1
Old Alleynians II,Old Woodhouseians II,0,1,1,3.0,1
Old Alleynians II,St. James' Old Boys,4,1,5,2.0,1
Old Alleynians III,Dulwich College 3rd XI,0,0,0,4.0,1
Old Alleynians III,KCS Old Boys II,6,4,10,4.0,2
Old Alleynians III,Kings College Wimbledon II,8,10,18,2.25,4
Old Alleynians III,Old Albanians,14,9,23,1.75,4
Old Alleynians III,Old Ardinians,1,11,12,0.0,2
Old Alleynians III,Old Berkhamstedians II,0,3,3,2.0,1
Old Alleynians III,Old Brentwoods II,23,19,42,2.1666666666666665,6
Old Alleynians III,Old Brentwoods III,3,9,12,2.5,2
Old Alleynians III,Old Carthusians II,16,17,33,2.0,6
Old Alleynians III,Old Chigwellians II,1,2,3,4.0,1
Old Alleynians III,Old Cholmeleians II,6,9,15,3.3333333333333335,3
Old Alleynians III,Old Epsomians,16,12,28,3.0,7
Old Alleynians III,Old Etonians II,0,9,9,0.0,1
Old Alleynians III,Old Haberdashers,4,3,7,3.5,2
Old Alleynians III,Old Harrovians II,5,4,9,4.333333333333333,3
Old Alleynians III,Old Kimboltonians,2,5,7,3.5,2
Old Alleynians III,Old Merchant Taylors,5,12,17,2.75,4
Old Alleynians III,Old Minchendenians IV,3,0,3,2.0,1
Old Alleynians III,Old Parmiterians IV,0,0,0,4.0,1
Old Alleynians III,Old Sennockians,8,6,14,3.25,4
Old Alleynians III,Old Shirburnians,11,8,19,2.75,4
Old Alleynians III,Old Tenisonians IV,9,1,10,0.0,1
Old Alleynians III,Old Tonbridgians II,16,10,26,3.25,4
Old Alleynians III,Old Westminsters II,3,3,6,5.0,1
Old Alleynians III,Old Wilsonians IV,2,1,3,4.0,1
Old Alleynians III,West Wickham III,0,0,0,4.0,1
Old Aloysians,Old Bradfieldians,3,0,3,2.0,1
Old Aloysians,Old Brentwoods,3,2,5,4.0,1
Old Aloysians,Old Brentwoods II,2,3,5,4.0,1
Old Aloysians,Old Carthusians,3,11,14,2.0,2
Old Aloysians,Old Chigwellians III,9,3,12,2.0,2
Old Aloysians,Old Chigwellians Vets,1,2,3,4.0,1
Old Aloysians,Old Rugbeians,1,2,3,4.0,1
Old Amplefordians,Ampleforth College 1st XI,8,5,13,3.0,3
Old Amplefordians,KCS Old Boys,1,7,8,0.0,1
Old Amplefordians,KCS Old Boys II,1,4,5,2.0,1
Old Amplefordians,Kings College Wimbledon III,10,10,20,3.8,5
Old Amplefordians,Lancing Old Boys,1,12,13,1.0,1
Old Amplefordians,Old Alleynians AFC,4,5,9,5.0,1
Old Amplefordians,Old Alleynians AFC II,17,21,38,4.8,5
Old Amplefordians,Old Alleynians AFC III,5,8,13,2.0,3
Old Amplefordians,Old Ardinians,3,8,11,2.0,2
Old Amplefordians,Old Ardinians II,10,9,19,3.5,4
Old Amplefordians,Old Bancroftians AFC,5,5,10,5.0,2
Old Amplefordians,Old Berkhamstedians,8,15,23,3.0,3
Old Amplefordians,Old Berkhamstedians II,19,32,51,3.5,12
Old Amplefordians,Old Brentwoods III,17,40,57,2.1,10
Old Amplefordians,Old Brentwoods IV,9,14,23,1.75,4
Old Amplefordians,Old Canfordians,0,3,3,2.0,1
Old Amplefordians,Old Chigwellians III,15,11,26,2.6666666666666665,6
Old Amplefordians,Old Cholmeleians II,0,2,2,2.0,1
Old Amplefordians,Old Cholmeleians III,5,12,17,2.25,4
Old Amplefordians,Old Cholmeleians IV,4,1,5,3.0,2
Old Amplefordians,Old Eastbournians,18,24,42,3.75,8
Old Amplefordians,Old Epsomians,5,7,12,4.0,2
Old Amplefordians,Old Epsomians II,5,0,5,2.0,2
Old Amplefordians,Old Foresters III,14,3,17,2.3333333333333335,3
Old Amplefordians,Old Haberdashers,10,19,29,2.4,5
Old Amplefordians,Old Harrovians III,28,18,46,2.3636363636363638,11
Old Amplefordians,Old Harrovians IV,3,1,4,3.0,1
Old Amplefordians,Old Johnians FC,3,11,14,1.0,2
Old Amplefordians,Old Johnians II,4,3,7,4.0,1
Old Amplefordians,Old Kimboltonians,3,12,15,1.0,2
Old Amplefordians,Old King's Scholars,25,29,54,3.8,10
Old Amplefordians,Old Kingstonians,14,7,21,3.4,5
Old Amplefordians,Old Kingstonians KGS,12,19,31,3.0,5
Old Amplefordians,Old Malvernians II,14,4,18,2.5,4
Old Amplefordians,Old Merchant Taylors,0,3,3,2.0,1
Old Amplefordians,Old Millfieldians,1,15,16,0.0,2
Old Amplefordians,Old Millhillians,9,9,18,4.0,2
Old Amplefordians,Old Oundelians,1,13,14,1.0,2
Old Amplefordians,Old Radleians,4,5,9,5.0,1
Old Amplefordians,Old Reptonians,0,4,4,1.0,1
Old Amplefordians,Old Rugbeians,7,8,15,4.0,4
Old Amplefordians,Old Salopians,1,2,3,4.0,1
Old Amplefordians,Old Salopians II,14,5,19,1.6666666666666667,3
Old Amplefordians,Old Sennockians,7,21,28,2.0,5
Old Amplefordians,Old Shirburnians,4,11,15,3.0,4
Old Amplefordians,Old Stoics,25,19,44,3.0,7
Old Amplefordians,Old Suttonians SV,8,8,16,2.5,2
Old Amplefordians,Old Tonbridgians II,11,11,22,3.1666666666666665,6
Old Amplefordians,Old Wellingtonians,12,13,25,2.25,4
Old Amplefordians,Old Westminsters II,46,48,94,2.857142857142857,21
Old Amplefordians,Old Wykehamists II,24,18,42,3.7777777777777777,9
Old Ardinians,Bank of England,2,4,6,3.0,1
Old Ardinians,Glyn Old Boys,2,4,6,3.0,1
Old Ardinians,Icarus,0,2,2,2.0,1
Old Ardinians,Kings College Wimbledon II,12,5,17,3.0,3
Old Ardinians,Lancing Old Boys,10,2,12,2.5,2
Old Ardinians,Lancing Old Boys II,13,4,17,2.3333333333333335,3
Old Ardinians,Old Albanians,12,6,18,3.5,4
Old Ardinians,Old Albanians SA,7,2,9,0.0,1
Old Ardinians,Old Aldenhamians,10,4,14,2.5,2
Old Ardinians,Old Alleynians II,6,6,12,3.6666666666666665,3
Old Ardinians,Old Alleynians III,11,1,12,0.0,2
Old Ardinians,Old Amplefordians,8,3,11,2.0,2
Old Ardinians,Old Ardinians II,0,0,0,4.0,1
Old Ardinians,Old Berkhamstedians,10,9,19,5.5,2
Old Ardinians,Old Berkhamstedians II,3,0,3,2.0,1
Old Ardinians,Old Blues,0,2,2,2.0,1
Old Ardinians,Old Bradfieldians,3,5,8,4.0,1
Old Ardinians,Old Brentwoods,1,2,3,4.0,1
Old Ardinians,Old Brentwoods II,9,2,11,2.0,2
Old Ardinians,Old Carthusians,3,3,6,5.0,1
Old Ardinians,Old Carthusians II,11,2,13,1.0,2
Old Ardinians,Old Chigwellians,3,1,4,3.0,1
Old Ardinians,Old Chigwellians II,10,3,13,1.5,2
Old Ardinians,Old Cholmeleians II,5,4,9,2.3333333333333335,3
Old Ardinians,Old Eastbournians,7,0,7,0.0,1
Old Ardinians,Old Epsomians,10,7,17,4.25,4
Old Ardinians,Old Etonians,1,5,6,2.0,1
Old Ardinians,Old Etonians II,10,4,14,3.25,4
Old Ardinians,Old Foresters,2,4,6,3.0,1
Old Ardinians,Old Foresters II,2,7,9,0.0,1
Old Ardinians,Old Haberdashers,10,2,12,0.0,1
Old Ardinians,Old Harrovians,8,6,14,2.5,2
Old Ardinians,Old Harrovians III,12,1,13,0.0,2
Old Ardinians,Old Kimboltonians,16,9,25,3.6,5
Old Ardinians,Old King's Scholars,10,1,11,1.0,2
Old Ardinians,Old Kingstonians,4,0,4,1.0,1
Old Ardinians,Old Kingstonians KGS,5,2,7,3.3333333333333335,3
Old Ardinians,Old Marlburians,3,6,9,3.0,2
Old Ardinians,Old Merchant Taylors,4,2,6,4.0,2
Old Ardinians,Old Merchant Taylors II,4,2,6,3.0,1
Old Ardinians,Old Merchant Taylors',5,0,5,0.0,1
Old Ardinians,Old Parmiterians,0,3,3,2.0,1
Old Ardinians,Old Radleians,4,5,9,5.0,1
Old Ardinians,Old Rugbeians,9,5,14,3.5,2
Old Ardinians,Old Salopians,12,3,15,2.0,3
Old Ardinians,Old Salopians II,4,0,4,2.5,2
Old Ardinians,Old Sennockians,1,5,6,2.0,1
Old Ardinians,Old Shirburnians,3,5,8,2.6666666666666665,3
Old Ardinians,Old Stoics,10,5,15,2.0,4
Old Ardinians,Old Suttonians SV,0,3,3,2.0,1
Old Ardinians,Old Tonbridgians,2,3,5,4.0,1
Old Ardinians,Old Tonbridgians II,10,1,11,1.0,2
Old Ardinians,Old Wellingtonians,8,3,11,1.3333333333333333,3
Old Ardinians,Old Westminsters,2,1,3,4.0,1
Old Ardinians,Old Westminsters II,4,6,10,2.6666666666666665,3
Old Ardinians,Old Wykehamists,3,0,3,2.0,1
Old Ardinians,Old Wykehamists II,5,5,10,4.0,2
Old Ardinians,Weirside Rangers,3,2,5,4.0,1
Old Ardinians II,Old Amplefordians,9,10,19,3.5,4
Old Ardinians II,Old Ardinians,0,0,0,4.0,1
Old Ardinians II,Old Berkhamstedians II,5,20,25,2.0,4
Old Ardinians II,Old Brentwoods III,0,9,9,0.0,1
Old Ardinians II,Old Eastbournians,5,6,11,2.5,2
Old Ardinians II,Old Haberdashers,3,6,9,3.0,1
Old Ardinians II,Old Harrovians III,4,5,9,3.5,2
Old Ardinians II,Old King's Scholars,8,7,15,5.0,2
Old Ardinians II,Old Kingstonians,5,4,9,4.5,2
Old Ardinians II,Old Salopians II,6,1,7,2.0,2
Old Ardinians II,Old Stoics,5,1,6,2.0,1
Old Ardinians II,Old Wellingtonians,5,14,19,1.5,2
Old Ardinians II,Old Westminsters II,6,5,11,4.5,2
Old Ardinians II,Old Wykehamists II,6,6,12,2.0,2
Old Bancroftians,Little Heath,3,2,5,4.0,1
Old Bancroftians,Old Albanians SA,3,4,7,2.5,2
Old Bancroftians,Old Brentwoods IV,8,1,9,0.0,1
Old Bancroftians,Old Foresters,0,10,10,0.0,1
Old Bancroftians,Old Haberdashers,3,8,11,1.5,2
Old Bancroftians AFC,Bancroft's School 1st XI,12,1,13,1.3333333333333333,3
Old Bancroftians AFC,Bealonians,5,0,5,0.0,1
Old Bancroftians AFC,Egbertian FC,3,2,5,4.0,1
Old Bancroftians AFC,Kings College Wimbledon III,2,7,9,2.5,2
Old Bancroftians AFC,Leyton County Old Boys,3,1,4,3.0,1
Old Bancroftians AFC,Old Alleynians AFC,1,4,5,2.0,1
Old Bancroftians AFC,Old Alleynians AFC II,12,8,20,3.0,6
Old Bancroftians AFC,Old Amplefordians,5,5,10,5.0,2
Old Bancroftians AFC,Old Berkhamstedians,3,9,12,2.5,2
Old Bancroftians AFC,Old Brentwoods II,5,7,12,4.0,3
Old Bancroftians AFC,Old Brentwoods III,11,3,14,2.6666666666666665,6
Old Bancroftians AFC,Old Brentwoods IV,3,3,6,2.5,2
Old Bancroftians AFC,Old Buckwellians,0,5,5,0.0,1
Old Bancroftians AFC,Old Carthusians III,0,5,5,0.0,1
Old Bancroftians AFC,Old Chigwellians III,6,4,10,4.0,4
Old Bancroftians AFC,Old Cholmeleians,3,5,8,4.0,1
Old Bancroftians AFC,Old Cholmeleians II,8,2,10,2.5,2
Old Bancroftians AFC,Old Cholmeleians IV,28,4,32,1.2,5
Old Bancroftians AFC,Old Citizens,1,10,11,1.5,2
Old Bancroftians AFC,Old Columbans,4,8,12,3.0,2
Old Bancroftians AFC,Old Eastbournians,9,8,17,2.75,4
Old Bancroftians AFC,Old Etonians II,0,6,6,0.0,1
Old Bancroftians AFC,Old Finchleians,0,3,3,2.0,1
Old Bancroftians AFC,Old Foresters III,8,7,15,2.25,4
Old Bancroftians AFC,Old Haberdashers,8,9,17,3.0,4
Old Bancroftians AFC,Old Harrovians III,18,19,37,2.7,10
Old Bancroftians AFC,Old Johnians FC,3,5,8,3.5,2
Old Bancroftians AFC,Old Kimboltonians,3,10,13,2.0,2
Old Bancroftians AFC,Old King's Scholars,7,4,11,3.25,4
Old Bancroftians AFC,Old Malvernians II,2,3,5,4.0,2
Old Bancroftians AFC,Old Marlburians,1,2,3,4.0,1
Old Bancroftians AFC,Old Merchant Taylors,15,12,27,3.625,8
Old Bancroftians AFC,Old Merchant Taylors II,10,9,19,3.75,4
Old Bancroftians AFC,Old Millfieldians,1,3,4,3.0,1
Old Bancroftians AFC,Old Millhillians,2,0,2,2.0,1
Old Bancroftians AFC,Old Oundelians,2,5,7,2.0,1
Old Bancroftians AFC,Old Parmiterians,7,1,8,0.0,1
Old Bancroftians AFC,Old Reptonians,1,4,5,2.0,1
Old Bancroftians AFC,Old Rugbeians,1,15,16,1.3333333333333333,3
Old Bancroftians AFC,Old Salopians II,2,3,5,4.0,2
Old Bancroftians AFC,Old Salvatorians,0,5,5,0.0,1
Old Bancroftians AFC,Old Shirburnians,2,9,11,1.0,2
Old Bancroftians AFC,Old Stoics,17,21,38,3.0,10
Old Bancroftians AFC,Old Suttonians,1,0,1,3.0,1
Old Bancroftians AFC,Old Suttonians SV,13,16,29,2.8333333333333335,6
Old Bancroftians AFC,Old Tonbridgians II,8,16,24,2.75,8
Old Bancroftians AFC,Old Westminsters II,2,3,5,4.0,2
Old Bancroftians AFC,Old Wykehamists II,12,8,20,3.75,4
Old Bancroftians AFC,Somerville Old Boys,0,1,1,3.0,1
Old Bancroftians AFC,St. James' Old Boys,2,5,7,2.0,1
Old Bancroftians AFC,UCL Academicals IV,0,2,2,2.0,1
Old Bancroftians AFC,UCL Academicals V,1,0,1,3.0,1
Old Barryians,Old Brentwoods II,5,0,5,0.0,1
Old Barryians,Old Merchant Taylors' II,2,2,4,5.0,1
Old Barryians,Old Millfieldians,3,5,8,4.0,1
Old Barryians,Old Wykehamists,1,0,1,3.0,1
Old Berkhamstedians,Kings College Wimbledon II,18,16,34,3.142857142857143,7
Old Berkhamstedians,Lancing Old Boys,34,31,65,3.3076923076923075,13
Old Berkhamstedians,Lancing Old Boys II,3,7,10,3.0,4
Old Berkhamstedians,Northchurch Baptist Church FC,4,2,6,3.0,1
Old Berkhamstedians,Old Albanians,5,3,8,4.0,2
Old Berkhamstedians,Old Aldenhamians,41,21,62,2.4,10
Old Berkhamstedians,Old Aldenhamians II,6,0,6,1.5,2
Old Berkhamstedians,Old Alleynians,2,5,7,2.0,1
Old Berkhamstedians,Old Alleynians AFC,3,5,8,3.0,2
Old Berkhamstedians,Old Alleynians II,5,11,16,3.2,5
Old Berkhamstedians,Old Amplefordians,15,8,23,3.0,3
Old Berkhamstedians,Old Ardinians,9,10,19,5.5,2
Old Berkhamstedians,Old Bancroftians AFC,9,3,12,2.5,2
Old Berkhamstedians,Old Bradfieldians,3,7,10,3.0,2
Old Berkhamstedians,Old Brentwoods,8,19,27,3.0,4
Old Berkhamstedians,Old Brentwoods II,16,18,34,3.3333333333333335,6
Old Berkhamstedians,Old Canfordians,5,2,7,2.0,1
Old Berkhamstedians,Old Carthusians,0,3,3,2.0,1
Old Berkhamstedians,Old Carthusians II,9,8,17,3.0,4
Old Berkhamstedians,Old Carthusians III,9,10,19,3.4,5
Old Berkhamstedians,Old Chigwellians,4,18,22,2.2,5
Old Berkhamstedians,Old Chigwellians II,15,5,20,1.5,4
Old Berkhamstedians,Old Chigwellians III,13,4,17,2.3333333333333335,3
Old Berkhamstedians,Old Cholmeleians,19,31,50,3.1,10
Old Berkhamstedians,Old Cholmeleians II,7,1,8,2.6666666666666665,3
Old Berkhamstedians,Old Cholmeleians III,6,4,10,3.25,4
Old Berkhamstedians,Old Citizens,8,1,9,1.5,2
Old Berkhamstedians,Old Eastbournians,7,6,13,2.6666666666666665,3
Old Berkhamstedians,Old Epsomians,17,9,26,3.142857142857143,7
Old Berkhamstedians,Old Etonians II,22,21,43,3.2,10
Old Berkhamstedians,Old Foresters,4,7,11,3.5,2
Old Berkhamstedians,Old Foresters II,14,14,28,2.5,6
Old Berkhamstedians,Old Haberdashers,3,0,3,2.0,1
Old Berkhamstedians,Old Haileyburians,22,2,24,0.5,2
Old Berkhamstedians,Old Harrovians,19,22,41,3.8333333333333335,6
Old Berkhamstedians,Old Harrovians II,19,9,28,2.6,5
Old Berkhamstedians,Old Johnians,2,6,8,3.0,2
Old Berkhamstedians,Old Kimboltonians,5,6,11,4.5,2
Old Berkhamstedians,Old Malvernians,22,16,38,3.2,10
Old Berkhamstedians,Old Malvernians II,5,2,7,2.0,1
Old Berkhamstedians,Old Marlburians,19,32,51,2.5555555555555554,9
Old Berkhamstedians,Old Merchant Taylors,6,4,10,2.0,2
Old Berkhamstedians,Old Millfieldians,6,8,14,3.8,5
Old Berkhamstedians,Old Radleians,11,11,22,4.2,5
Old Berkhamstedians,Old Reptonians,25,39,64,2.3333333333333335,12
Old Berkhamstedians,Old Rugbeians,9,16,25,3.6,5
Old Berkhamstedians,Old Salopians,11,17,28,3.1666666666666665,6
Old Berkhamstedians,Old Salopians II,7,2,9,3.0,2
Old Berkhamstedians,Old Sedcopians,0,4,4,1.0,1
Old Berkhamstedians,Old Sennockians,8,8,16,4.0,3
Old Berkhamstedians,Old Stoics,4,1,5,2.0,1
Old Berkhamstedians,Old Suttonians,2,3,5,4.0,1
Old Berkhamstedians,Old Suttonians SV,12,3,15,0.5,2
Old Berkhamstedians,Old Tonbridgians,0,2,2,2.0,1
Old Berkhamstedians,Old Tonbridgians II,2,3,5,4.0,1
Old Berkhamstedians,Old Wellingtonians,8,2,10,2.0,2
Old Berkhamstedians,Old Westminsters,35,38,73,3.2,15
Old Berkhamstedians,Old Westminsters II,5,2,7,3.5,2
Old Berkhamstedians,Old Wykehamists,7,11,18,2.5,4
Old Berkhamstedians,Old Wykehamists II,5,6,11,5.0,2
Old Berkhamstedians,Spaniards,4,4,8,6.0,1
Old Berkhamstedians,Witan,3,2,5,4.0,1
Old Berkhamstedians II,Old Albanians,0,0,0,4.0,1
Old Berkhamstedians II,Old Alleynians AFC III,5,12,17,2.0,2
Old Berkhamstedians II,Old Alleynians II,0,0,0,4.0,1
Old Berkhamstedians II,Old Alleynians III,3,0,3,2.0,1
Old Berkhamstedians II,Old Amplefordians,32,19,51,3.5,12
Old Berkhamstedians II,Old Ardinians,0,3,3,2.0,1
Old Berkhamstedians II,Old Ardinians II,20,5,25,2.0,4
Old Berkhamstedians II,Old Brentwoods III,15,9,24,3.0,6
Old Berkhamstedians II,Old Brentwoods IV,6,3,9,3.5,2
Old Berkhamstedians II,Old Carthusians II,2,2,4,5.0,1
Old Berkhamstedians II,Old Cheltonians,1,4,5,2.0,1
Old Berkhamstedians II,Old Chigwellians II,1,2,3,3.5,2
Old Berkhamstedians II,Old Cholmeleians II,2,4,6,3.0,1
Old Berkhamstedians II,Old Columbans,2,8,10,0.0,1
Old Berkhamstedians II,Old Eastbournians,17,17,34,2.8333333333333335,6
Old Berkhamstedians II,Old Haberdashers,12,15,27,3.5,6
Old Berkhamstedians II,Old Harrovians II,1,2,3,4.0,2
Old Berkhamstedians II,Old Harrovians III,14,5,19,3.0,5
Old Berkhamstedians II,Old King's Scholars,11,10,21,3.1666666666666665,6
Old Berkhamstedians II,Old Kingstonians,18,3,21,1.5,4
Old Berkhamstedians II,Old Kingstonians KGS,13,12,25,2.8,5
Old Berkhamstedians II,Old Rugbeians II,5,2,7,2.0,1
Old Berkhamstedians II,Old Salopians II,11,9,20,3.75,4
Old Berkhamstedians II,Old Sennockians,7,5,12,4.0,2
Old Berkhamstedians II,Old Shirburnians,4,5,9,2.5,2
Old Berkhamstedians II,Old Stoics,5,5,10,3.6666666666666665,3
Old Berkhamstedians II,Old Tonbridgians II,4,2,6,3.5,2
Old Berkhamstedians II,Old Wellingtonians,27,9,36,2.4,5
Old Berkhamstedians II,Old Westminsters II,21,22,43,3.111111111111111,9
Old Berkhamstedians II,Old Wykehamists II,25,19,44,3.5,8
Old Berkhamstedians Vets,Old Aldenhamians Vets,4,2,6,3.0,1
Old Berkhamstedians Vets,Old Carthusians Vets,0,2,2,2.0,1
Old Berkhamstedians Vets,Old Etonians Vets,1,1,2,3.0,2
Old Berkhamstedians Vets,Old Wellingtonians Vets,1,7,8,2.0,2
Old Berkhamstedians Vets,Old Westminsters Vets,2,1,3,4.0,1
Old Blues,KCS Old Boys,0,4,4,1.0,1
Old Blues,Lancing Old Boys,1,1,2,4.0,1
Old Blues,Lancing Old Boys II,3,1,4,3.0,1
Old Blues,Old Ardinians,2,0,2,2.0,1
Old Blues,Old Brentwoods,0,1,1,3.0,1
Old Blues,Old Carthusians,0,4,4,1.0,1
Old Blues,Old Etonians II,0,7,7,0.0,1
Old Blues II,Old King's Scholars,0,2,2,2.0,1
Old Boilers FC,Old Haileyburians,5,0,5,0.0,1
Old Bradfieldians,Alexandra Park FC,1,0,1,3.0,1
Old Bradfieldians,Bradfield College,10,4,14,3.25,4
Old Bradfieldians,KCS Old Boys,31,61,92,2.75,16
Old Bradfieldians,Old Aldenhamians,36,23,59,2.6666666666666665,12
Old Bradfieldians,Old Alleynians,25,36,61,3.111111111111111,9
Old Bradfieldians,Old Alleynians AFC,3,6,9,3.5,2
Old Bradfieldians,Old Aloysians,0,3,3,2.0,1
Old Bradfieldians,Old Ardinians,5,3,8,4.0,1
Old Bradfieldians,Old Berkhamstedians,7,3,10,3.0,2
Old Bradfieldians,Old Brentwoods,26,38,64,2.230769230769231,13
Old Bradfieldians,Old Carthusians,17,27,44,3.0833333333333335,12
Old Bradfieldians,Old Chigwellians,30,23,53,2.6,10
Old Bradfieldians,Old Cholmeleians,28,14,42,2.888888888888889,9
Old Bradfieldians,Old Eastbournians,15,2,17,2.0,3
Old Bradfieldians,Old Epsomians,10,0,10,0.0,1
Old Bradfieldians,Old Etonians,32,28,60,3.7142857142857144,14
Old Bradfieldians,Old Foresters,43,31,74,2.8333333333333335,12
Old Bradfieldians,Old Haberdashers,2,1,3,4.0,1
Old Bradfieldians,Old Haileyburians,23,17,40,2.875,8
Old Bradfieldians,Old Harrovians,43,22,65,1.8,10
Old Bradfieldians,Old Johnians,3,2,5,4.0,1
Old Bradfieldians,Old Kimboltonians,3,1,4,3.0,1
Old Bradfieldians,Old King's Scholars,16,3,19,2.0,4
Old Bradfieldians,Old Kingstonians,8,0,8,0.0,1
Old Bradfieldians,Old Malvernians,33,27,60,3.1,10
Old Bradfieldians,Old Marlburians,1,7,8,2.0,2
Old Bradfieldians,Old Millfieldians,6,7,13,0.0,2
Old Bradfieldians,Old Radleians,26,23,49,3.9,10
Old Bradfieldians,Old Reptonians,34,43,77,3.0,17
Old Bradfieldians,Old Rugbeians,5,1,6,2.0,1
Old Bradfieldians,Old Salopians,14,10,24,3.857142857142857,7
Old Bradfieldians,Old Shirburnians,7,1,8,2.0,2
Old Bradfieldians,Old Suttonians,9,3,12,0.0,1
Old Bradfieldians,Old Tonbridgians,24,29,53,3.2142857142857144,14
Old Bradfieldians,Old Wellingtonians,22,13,35,2.8333333333333335,6
Old Bradfieldians,Old Westminsters,26,15,41,2.875,8
Old Bradfieldians,Old Wykehamists,52,34,86,2.9411764705882355,17
Old Bradfieldians Vets,Lancing Old Boys Vets,1,8,9,1.5,2
Old Bradfieldians Vets,Old Aldenhamians Vets,8,1,9,0.0,1
Old Bradfieldians Vets,Old Carthusians Vets,6,4,10,2.6666666666666665,3
Old Bradfieldians Vets,Old Chigwellians Vets,11,7,18,2.0,3
Old Bradfieldians Vets,Old Etonians Vets,1,4,5,3.0,2
Old Bradfieldians Vets,Old Foresters Vets,0,2,2,2.0,1
Old Bradfieldians Vets,Old Haileyburians Vets,1,0,1,3.0,1
Old Bradfieldians Vets,Old Malvernians Vets,5,7,12,4.5,2
Old Bradfieldians Vets,Old Reptonians Vets,2,0,2,2.0,1
Old Bradfieldians Vets,Old Salopians Vets,12,16,28,3.4,5
Old Bradfieldians Vets,Old Wellingtonians Vets,12,9,21,2.6666666666666665,3
Old Bradfieldians Vets,Old Westminsters Vets,4,2,6,2.5,2
Old Bradfieldians Vets,Old Wykehamists Veterans,6,0,6,0.0,1
Old Brentwoods,Bealonians,1,8,9,2.6666666666666665,3
Old Brentwoods,Brentwood School 1st XI,32,17,49,3.1333333333333333,15
Old Brentwoods,Crouch End Vampires,4,1,5,2.0,1
Old Brentwoods,Enfield Old Grammarians,4,2,6,3.0,1
Old Brentwoods,Globe Rangers,5,2,7,2.0,1
Old Brentwoods,Harold Wood FC,7,1,8,0.0,1
Old Brentwoods,KCS Old Boys,24,42,66,2.933333333333333,15
Old Brentwoods,Lancing Old Boys,36,30,66,2.1666666666666665,12
Old Brentwoods,Mayfield,9,7,16,3.5,2
Old Brentwoods,Old Aldenhamians,31,4,35,0.5,4
Old Brentwoods,Old Alleynians,16,23,39,2.888888888888889,9
Old Brentwoods,Old Alleynians AFC,4,0,4,1.0,1
Old Brentwoods,Old Aloysians,2,3,5,4.0,1
Old Brentwoods,Old Ardinians,2,1,3,4.0,1
Old Brentwoods,Old Berkhamstedians,19,8,27,3.0,4
Old Brentwoods,Old Blues,1,0,1,3.0,1
Old Brentwoods,Old Bradfieldians,38,26,64,2.230769230769231,13
Old Brentwoods,Old Brentwoods II,1,0,1,3.0,1
Old Brentwoods,Old Carthusians,18,61,79,2.3684210526315788,19
Old Brentwoods,Old Chigwellians,25,25,50,3.272727272727273,11
Old Brentwoods,Old Cholmeleians,38,32,70,3.25,16
Old Brentwoods,Old Columbans,0,1,1,3.0,1
Old Brentwoods,Old Etonians,42,43,85,3.25,20
Old Brentwoods,Old Finchleians,6,4,10,4.0,1
Old Brentwoods,Old Foresters,34,48,82,2.7,20
Old Brentwoods,Old Garchonians,1,4,5,2.0,1
Old Brentwoods,Old Haileyburians,16,2,18,2.0,2
Old Brentwoods,Old Harrovians,35,36,71,2.6875,16
Old Brentwoods,Old Kimboltonians,4,1,5,2.0,1
Old Brentwoods,Old Malvernians,32,12,44,2.75,8
Old Brentwoods,Old Marlburians,26,15,41,2.1666666666666665,6
Old Brentwoods,Old Parkonians,6,5,11,3.5,2
Old Brentwoods,Old Parmiterians,2,1,3,4.0,1
Old Brentwoods,Old Pauline,2,0,2,2.0,1
Old Brentwoods,Old Radleians,24,5,29,1.5,4
Old Brentwoods,Old Reptonians,34,16,50,2.6666666666666665,12
Old Brentwoods,Old Rugbeians,6,3,9,3.0,1
Old Brentwoods,Old Salopians,12,20,32,2.8181818181818183,11
Old Brentwoods,Old Sedcopians,4,2,6,3.0,1
Old Brentwoods,Old Sennockians,5,0,5,0.0,1
Old Brentwoods,Old Suttonians,4,8,12,3.5,2
Old Brentwoods,Old Tonbridgians,37,36,73,2.857142857142857,14
Old Brentwoods,Old Wellingtonians,14,5,19,2.75,4
Old Brentwoods,Old Westminsters,13,11,24,2.5,4
Old Brentwoods,Old Wilsonians,2,1,3,4.0,1
Old Brentwoods,Old Wykehamists,40,36,76,2.9166666666666665,12
Old Brentwoods,Polytechnic,2,3,5,4.0,1
Old Brentwoods,UCL Academicals,0,3,3,2.0,1
Old Brentwoods,Weirside Rangers,3,1,4,3.0,1
Old Brentwoods,West Wickham,1,6,7,0.0,1
Old Brentwoods,Winchmore Hill,0,1,1,3.0,1
Old Brentwoods II,Alleyn Old Boys,1,3,4,3.0,1
Old Brentwoods II,Bealonians,5,1,6,2.0,1
Old Brentwoods II,Bealonians II,4,2,6,3.0,1
Old Brentwoods II,Brentwood School 2nd XI,41,42,83,2.066666666666667,15
Old Brentwoods II,East Barnet Old Grammarians,5,1,6,2.0,1
Old Brentwoods II,Hale End Athletic,4,3,7,4.0,1
Old Brentwoods II,KCS Old Boys II,10,5,15,2.3333333333333335,3
Old Brentwoods II,Kings College Wimbledon II,34,30,64,2.9166666666666665,12
Old Brentwoods II,Kings Old Boys,0,2,2,2.0,1
Old Brentwoods II,Lancing Old Boys,5,0,5,2.0,2
Old Brentwoods II,Old Albanians,2,8,10,2.0,2
Old Brentwoods II,Old Albanians SA,2,4,6,3.5,2
Old Brentwoods II,Old Aldenhamians,2,2,4,5.0,1
Old Brentwoods II,Old Aldenhamians II,6,5,11,3.3333333333333335,3
Old Brentwoods II,Old Alleynians AFC,2,4,6,3.0,1
Old Brentwoods II,Old Alleynians AFC II,9,9,18,3.0,5
Old Brentwoods II,Old Alleynians II,2,18,20,1.0,4
Old Brentwoods II,Old Alleynians III,19,23,42,2.1666666666666665,6
Old Brentwoods II,Old Aloysians,3,2,5,4.0,1
Old Brentwoods II,Old Ardinians,2,9,11,2.0,2
Old Brentwoods II,Old Bancroftians AFC,7,5,12,4.0,3
Old Brentwoods II,Old Barryians,0,5,5,0.0,1
Old Brentwoods II,Old Berkhamstedians,18,16,34,3.3333333333333335,6
Old Brentwoods II,Old Brentwoods,0,1,1,3.0,1
Old Brentwoods II,Old Brentwoods III,13,7,20,3.4,5
Old Brentwoods II,Old Carthusians II,19,18,37,2.875,8
Old Brentwoods II,Old Carthusians III,3,2,5,4.0,1
Old Brentwoods II,Old Chigwellians II,1,1,2,4.0,1
Old Brentwoods II,Old Chigwellians III,10,8,18,3.0,5
Old Brentwoods II,Old Cholmeleians II,14,20,34,3.2857142857142856,7
Old Brentwoods II,Old Cholmeleians III,5,6,11,2.75,4
Old Brentwoods II,Old Citizens,7,10,17,2.5,4
Old Brentwoods II,Old Columbans,1,11,12,2.0,4
Old Brentwoods II,Old Eastbournians,9,11,20,2.5,4
Old Brentwoods II,Old Epsomians,25,34,59,2.1,10
Old Brentwoods II,Old Epsomians II,3,4,7,1.5,2
Old Brentwoods II,Old Etonians II,4,10,14,3.2,5
Old Brentwoods II,Old Finchleians II,3,1,4,3.0,1
Old Brentwoods II,Old Foresters II,14,12,26,2.8,5
Old Brentwoods II,Old Foresters III,15,5,20,3.0,5
Old Brentwoods II,Old Haberdashers,23,11,34,3.0,5
Old Brentwoods II,Old Harrovians II,33,32,65,2.6363636363636362,11
Old Brentwoods II,Old Harrovians III,6,4,10,4.0,3
Old Brentwoods II,Old Johnians FC,2,3,5,4.0,1
Old Brentwoods II,Old Kimboltonians,6,18,24,2.8333333333333335,6
Old Brentwoods II,Old King's Scholars,14,7,21,3.5,4
Old Brentwoods II,Old Kingsburians,1,3,4,3.0,1
Old Brentwoods II,Old Malvernians II,8,0,8,1.0,2
Old Brentwoods II,Old Marlburians,3,9,12,2.5,2
Old Brentwoods II,Old Meadonians,3,5,8,4.0,1
Old Brentwoods II,Old Merchant Taylors,9,12,21,2.857142857142857,7
Old Brentwoods II,Old Merchant Taylors II,5,9,14,3.0,4
Old Brentwoods II,Old Millfieldians,6,4,10,0.5,2
Old Brentwoods II,Old Minchendenians,4,2,6,3.0,1
Old Brentwoods II,Old Owens,2,3,5,4.0,1
Old Brentwoods II,Old Parkonians,2,2,4,5.0,1
Old Brentwoods II,Old Salopians II,15,8,23,3.5,6
Old Brentwoods II,Old Sennockians,13,7,20,3.4,5
Old Brentwoods II,Old Shirburnians,16,8,24,2.5,6
Old Brentwoods II,Old Stoics,9,10,19,2.25,4
Old Brentwoods II,Old Suttonians SV,6,8,14,2.0,3
Old Brentwoods II,Old Tonbridgians II,11,18,29,2.8333333333333335,6
Old Brentwoods II,Old Wellingburians,8,0,8,0.0,1
Old Brentwoods II,Old Westminsters,1,0,1,3.0,1
Old Brentwoods II,Old Woodhouseians II,4,6,10,4.0,1
Old Brentwoods II,Old Wykehamists II,15,9,24,3.0,5
Old Brentwoods II,Royal Bank of Scotland,0,4,4,1.0,1
Old Brentwoods II,Sinjun Grammarians,1,3,4,3.0,1
Old Brentwoods II,Southgate County III,1,4,5,2.0,1
Old Brentwoods II,UCL Academicals,6,5,11,5.0,1
Old Brentwoods II,UCL Academicals II,0,4,4,1.0,1
Old Brentwoods II,UCL Academicals III,3,4,7,4.0,1
Old Brentwoods II,West Wickham,3,2,5,4.0,1
Old Brentwoods II,Wood Green Old Boys,7,1,8,0.0,1
Old Brentwoods III,Albanian FC,6,0,6,0.0,1
Old Brentwoods III,Brentwood School 3rd XI,42,32,74,2.8666666666666667,15
Old Brentwoods III,Broomfield FC,5,5,10,6.0,1
Old Brentwoods III,Brymans Park FC,3,2,5,4.0,1
Old Brentwoods III,Hale End Athletic,2,7,9,0.0,1
Old Brentwoods III,Lancing Old Boys II,2,0,2,2.0,1
Old Brentwoods III,Old Albanians,2,3,5,4.0,1
Old Brentwoods III,Old Albanians SA,17,23,40,2.4285714285714284,7
Old Brentwoods III,Old Alleynians AFC II,2,4,6,3.5,2
Old Brentwoods III,Old Alleynians II,1,2,3,4.0,1
Old Brentwoods III,Old Alleynians III,9,3,12,2.5,2
Old Brentwoods III,Old Amplefordians,40,17,57,2.1,10
Old Brentwoods III,Old Ardinians II,9,0,9,0.0,1
Old Brentwoods III,Old Bancroftians AFC,3,11,14,2.6666666666666665,6
Old Brentwoods III,Old Berkhamstedians II,9,15,24,3.0,6
Old Brentwoods III,Old Brentwoods II,7,13,20,3.4,5
Old Brentwoods III,Old Brentwoods IV,35,13,48,1.3333333333333333,6
Old Brentwoods III,Old Carthusians II,3,1,4,3.0,1
Old Brentwoods III,Old Cheltonians,13,6,19,2.0,2
Old Brentwoods III,Old Chigwellians II,2,7,9,2.0,2
Old Brentwoods III,Old Chigwellians III,26,14,40,3.2857142857142856,14
Old Brentwoods III,Old Chigwellians IV,7,4,11,3.0,2
Old Brentwoods III,Old Cholmeleians II,17,30,47,1.8571428571428572,7
Old Brentwoods III,Old Cholmeleians III,11,9,20,2.75,4
Old Brentwoods III,Old Cholmeleians IV,18,12,30,3.5,4
Old Brentwoods III,Old Citizens,1,30,31,0.0,4
Old Brentwoods III,Old Columbans,6,4,10,2.5,2
Old Brentwoods III,Old Eastbournians,5,8,13,3.25,4
Old Brentwoods III,Old Epsomians,5,2,7,2.0,1
Old Brentwoods III,Old Finchleians,3,1,4,3.0,1
Old Brentwoods III,Old Foresters III,29,26,55,2.909090909090909,11
Old Brentwoods III,Old Foresters IV,6,4,10,4.0,2
Old Brentwoods III,Old Haberdashers,23,30,53,2.375,8
Old Brentwoods III,Old Harrovians II,10,14,24,3.0,3
Old Brentwoods III,Old Harrovians III,29,23,52,2.2222222222222223,9
Old Brentwoods III,Old Kimboltonians,3,3,6,4.5,2
Old Brentwoods III,Old King's Scholars,18,10,28,2.0,4
Old Brentwoods III,Old Kingstonians,5,5,10,4.0,2
Old Brentwoods III,Old Malvernians II,4,12,16,2.0,4
Old Brentwoods III,Old Merchant Taylors,1,8,9,1.5,2
Old Brentwoods III,Old Merchant Taylors II,15,19,34,3.142857142857143,7
Old Brentwoods III,Old Merchant Taylors',3,4,7,4.0,1
Old Brentwoods III,Old Merchant Taylors' II,11,3,14,1.5,2
Old Brentwoods III,Old Millfieldians,4,6,10,4.0,1
Old Brentwoods III,Old Millhillians,4,3,7,4.0,1
Old Brentwoods III,Old Oundelians,0,4,4,1.0,1
Old Brentwoods III,Old Parkonians,0,5,5,2.0,2
Old Brentwoods III,Old Parkonians IV,1,4,5,2.0,1
Old Brentwoods III,Old Sennockians,5,20,25,1.8,5
Old Brentwoods III,Old Shirburnians,3,1,4,3.0,1
Old Brentwoods III,Old Stoics,15,16,31,2.2857142857142856,7
Old Brentwoods III,Old Tonbridgians II,5,7,12,3.0,2
Old Brentwoods III,Old Wellingtonians,8,8,16,3.0,3
Old Brentwoods III,Old Westminsters II,22,11,33,2.4,5
Old Brentwoods III,Old Wilsonians,1,5,6,2.0,1
Old Brentwoods III,Old Wykehamists II,1,11,12,0.0,1
Old Brentwoods III,Queen Mary College Old Boys,5,5,10,6.0,1
Old Brentwoods IV,Bank of England,1,1,2,4.0,1
Old Brentwoods IV,Bealonians VII,1,2,3,4.0,1
Old Brentwoods IV,Brentwood School 4th XI,15,15,30,2.625,8
Old Brentwoods IV,KCS Old Boys II,5,4,9,5.0,1
Old Brentwoods IV,Lancing Old Boys II,5,7,12,4.0,2
Old Brentwoods IV,Old Albanians SA,0,19,19,1.0,1
Old Brentwoods IV,Old Alleynians AFC,1,4,5,2.0,1
Old Brentwoods IV,Old Amplefordians,14,9,23,1.75,4
Old Brentwoods IV,Old Bancroftians,1,8,9,0.0,1
Old Brentwoods IV,Old Bancroftians AFC,3,3,6,2.5,2
Old Brentwoods IV,Old Berkhamstedians II,3,6,9,3.5,2
Old Brentwoods IV,Old Brentwoods III,13,35,48,1.3333333333333333,6
Old Brentwoods IV,Old Canfordians,8,4,12,3.0,2
Old Brentwoods IV,Old Cheltonians,14,17,31,2.5,6
Old Brentwoods IV,Old Chigwellians IV,3,3,6,2.5,2
Old Brentwoods IV,Old Cholmeleians IV,11,10,21,3.3333333333333335,6
Old Brentwoods IV,Old Citizens,6,10,16,3.5,2
Old Brentwoods IV,Old Eastbournians,3,1,4,3.5,2
Old Brentwoods IV,Old Epsomians,1,1,2,4.0,1
Old Brentwoods IV,Old Felstedians,4,2,6,3.0,1
Old Brentwoods IV,Old Foresters III,16,10,26,2.6666666666666665,6
Old Brentwoods IV,Old Foresters IV,9,4,13,2.5,2
Old Brentwoods IV,Old Haberdashers,5,19,24,2.5,4
Old Brentwoods IV,Old Harrovians II,3,5,8,4.0,1
Old Brentwoods IV,Old Harrovians III,14,7,21,3.0,4
Old Brentwoods IV,Old Johnians II,8,7,15,5.0,2
Old Brentwoods IV,Old King's Scholars,4,5,9,3.6666666666666665,3
Old Brentwoods IV,Old Kingstonians,4,3,7,3.5,2
Old Brentwoods IV,Old Malvernians II,2,7,9,2.5,2
Old Brentwoods IV,Old Merchant Taylors,2,4,6,3.0,1
Old Brentwoods IV,Old Merchant Taylors' II,1,6,7,0.0,1
Old Brentwoods IV,Old Millhillians,3,5,8,3.3333333333333335,3
Old Brentwoods IV,Old Oundelians,20,4,24,1.0,4
Old Brentwoods IV,Old Parkonians,0,1,1,3.0,1
Old Brentwoods IV,Old Parkonians VI,5,4,9,5.0,1
Old Brentwoods IV,Old Parmiterians VII,7,2,9,0.0,1
Old Brentwoods IV,Old Salopians II,18,10,28,1.0,5
Old Brentwoods IV,Old Sennockians,7,7,14,4.5,2
Old Brentwoods IV,Old Shirburnians,6,10,16,3.3333333333333335,3
Old Brentwoods IV,Old Stoics,6,4,10,3.3333333333333335,3
Old Brentwoods IV,Old Tonbridgians II,0,2,2,2.0,1
Old Brentwoods IV,Old Westminsters II,4,12,16,2.6666666666666665,3
Old Brentwoods IV,Old Wykehamists II,4,2,6,3.0,1
Old Brentwoods IV,South Bank Cuaco,3,2,5,4.0,1
Old Brentwoods IV,St. James' Old Boys IV,8,0,8,0.0,1
Old Brentwoods Vets,Brentwood School 4th XI,0,0,0,4.0,2
Old Brentwoods Vets,Brentwood School 5th XI,5,16,21,3.25,4
Old Brentwoods Vets,Enfield Old Grammarians Vets,1,0,1,3.0,1
Old Brentwoods Vets,KCS Old Boys Vets,4,1,5,3.0,2
Old Brentwoods Vets,Lancing Old Boys Vets,5,4,9,3.6666666666666665,3
Old Brentwoods Vets,Old Aldenhamians Vets,6,0,6,0.0,1
Old Brentwoods Vets,Old Carthusians Vets,3,3,6,3.5,2
Old Brentwoods Vets,Old Chigwellians Vets,3,3,6,2.5,2
Old Brentwoods Vets,Old Finchleians,3,5,8,1.0,2
Old Brentwoods Vets,Old Foresters Vets,9,9,18,4.75,4
Old Brentwoods Vets,Old Haileyburians Vets,7,8,15,2.0,3
Old Brentwoods Vets,Old Harrovians Vets,11,7,18,2.3333333333333335,3
Old Brentwoods Vets,Old Kimboltonians Vets,1,0,1,3.0,1
Old Brentwoods Vets,Old Malvernians Vets,4,5,9,3.6666666666666665,3
Old Brentwoods Vets,Old Reptonians Vets,4,4,8,3.0,2
Old Brentwoods Vets,Old Salopians Vets,9,2,11,2.3333333333333335,3
Old Brentwoods Vets,Old Salvatorians,2,3,5,4.0,1
Old Brentwoods Vets,Old Tonbridgians Vets,4,4,8,3.0,2
Old Brentwoods Vets,Old Westminster Citizens Vets,3,4,7,4.0,1
Old Brentwoods Vets,Old Wykehamists Vets,4,0,4,2.0,2
Old Bromleians,KCS Old Boys,1,2,3,4.0,1
Old Bromleians,Old Carthusians II,0,8,8,0.0,1
Old Buckwellians,Old Bancroftians AFC,5,0,5,0.0,1
Old Buckwellians,Old Cholmeleians III,1,1,2,4.0,1
Old Canfordians,Old Amplefordians,3,0,3,2.0,1
Old Canfordians,Old Berkhamstedians,2,5,7,2.0,1
Old Canfordians,Old Brentwoods IV,4,8,12,3.0,2
Old Canfordians,Old Cheltonians,9,5,14,4.0,4
Old Canfordians,Old Cranleighans,5,2,7,2.0,1
Old Canfordians,Old Harrovians III,1,2,3,4.0,1
Old Canfordians,Old Johnians II,2,4,6,3.5,2
Old Canfordians,Old Kingstonians,7,7,14,3.5,2
Old Canfordians,Old Merchant Taylors II,9,1,10,0.0,1
Old Canfordians,Old Oundelians,4,4,8,4.0,2
Old Canfordians,Old Salopians II,10,11,21,2.0,3
Old Canfordians,Old Stoics,9,11,20,3.0,4
Old Canfordians,Old Wellingtonians,5,1,6,2.5,2
Old Canfordians,Old Wykehamists II,3,5,8,4.0,2
Old Carthusians,Alexandra Park FC,4,2,6,3.0,1
Old Carthusians,Alleyn Old Boys,1,0,1,3.0,1
Old Carthusians,Bank of England,3,0,3,2.0,1
Old Carthusians,Bromleians,7,0,7,0.0,1
Old Carthusians,Charterhouse School 1st XI,38,5,43,1.4285714285714286,7
Old Carthusians,Civil Service,1,2,3,4.0,1
Old Carthusians,Clapham Old Xaverians,9,1,10,1.0,2
Old Carthusians,Clapham Rovers,3,0,3,2.0,1
Old Carthusians,Dorkinians,8,9,17,4.0,3
Old Carthusians,Economicals,3,0,3,2.0,1
Old Carthusians,Enfield Old Grammarians,4,1,5,2.0,1
Old Carthusians,Honourable Artillery Company,0,1,1,3.0,1
Old Carthusians,Ibis Eagles,3,0,3,2.0,1
Old Carthusians,KCS Old Boys,57,23,80,2.8095238095238093,21
Old Carthusians,Lancing Old Boys,37,10,47,2.857142857142857,14
Old Carthusians,Merton,4,1,5,2.0,1
Old Carthusians,Nottsborough FC,17,12,29,3.5714285714285716,7
Old Carthusians,Old Actonians Association FC,2,0,2,2.0,1
Old Carthusians,Old Alleynians,10,23,33,2.5714285714285716,7
Old Carthusians,Old Alleynians AFC,13,4,17,2.5,4
Old Carthusians,Old Aloysians,11,3,14,2.0,2
Old Carthusians,Old Ardinians,3,3,6,5.0,1
Old Carthusians,Old Berkhamstedians,3,0,3,2.0,1
Old Carthusians,Old Blues,4,0,4,1.0,1
Old Carthusians,Old Bradfieldians,27,17,44,3.0833333333333335,12
Old Carthusians,Old Brentwoods,61,18,79,2.3684210526315788,19
Old Carthusians,Old Chigwellians,45,15,60,2.5384615384615383,13
Old Carthusians,Old Cholmeleians,55,17,72,2.6666666666666665,15
Old Carthusians,Old Etonians,71,26,97,3.107142857142857,28
Old Carthusians,Old Finchleians,9,3,12,0.0,1
Old Carthusians,Old Foresters,83,32,115,2.7777777777777777,27
Old Carthusians,Old Foresters II,1,0,1,3.0,1
Old Carthusians,Old Haileyburians,5,1,6,2.0,1
Old Carthusians,Old Hamptonians,11,5,16,3.5,4
Old Carthusians,Old Harrovians,78,14,92,1.7333333333333334,15
Old Carthusians,Old Johnians,8,0,8,1.0,2
Old Carthusians,Old King's Scholars,5,0,5,0.0,1
Old Carthusians,Old Kingstonians KGS,9,0,9,0.0,1
Old Carthusians,Old Malvernians,11,2,13,1.0,2
Old Carthusians,Old Marlburians,29,7,36,1.8571428571428572,7
Old Carthusians,Old Meadonians,3,1,4,3.0,1
Old Carthusians,Old Merchant Taylors,9,1,10,2.0,2
Old Carthusians,Old Minchendenians,9,2,11,2.3333333333333335,3
Old Carthusians,Old Owens,11,6,17,2.3333333333333335,3
Old Carthusians,Old Parkonians,14,11,25,2.75,4
Old Carthusians,Old Radleians,16,1,17,0.0,2
Old Carthusians,Old Reptonians,16,4,20,3.1,10
Old Carthusians,Old Rugbeians,4,0,4,1.0,1
Old Carthusians,Old Salopians,59,18,77,2.6,15
Old Carthusians,Old Salvatorians,5,0,5,0.0,1
Old Carthusians,Old Stationers,2,1,3,4.0,1
Old Carthusians,Old Suttonians,4,0,4,2.5,2
Old Carthusians,Old Tenisonians,2,1,3,4.0,1
Old Carthusians,Old Thorntonians,8,2,10,2.0,2
Old Carthusians,Old Tonbridgians,91,40,131,2.5833333333333335,24
Old Carthusians,Old Westminsters,5,0,5,0.0,1
Old Carthusians,Old Wilsonians,8,8,16,3.5,6
Old Carthusians,Old Wokingians,0,2,2,2.0,1
Old Carthusians,Old Woodhouseians,9,1,10,0.0,1
Old Carthusians,Old Wykehamists,46,11,57,2.3333333333333335,12
Old Carthusians,Park View,3,0,3,2.0,1
Old Carthusians,Polytechnic,2,9,11,2.6666666666666665,3
Old Carthusians,Richmond & Kew SAL,4,0,4,1.0,1
Old Carthusians,Rob Roy Rovers,3,0,3,2.0,1
Old Carthusians,South Bank Cuaco,3,2,5,4.0,1
Old Carthusians,West Wickham,3,3,6,4.5,2
Old Carthusians,Winchmore Hill,8,1,9,1.6666666666666667,3
Old Carthusians II,Albanian FC,5,0,5,0.0,1
Old Carthusians II,Charterhouse School 2nd XI,10,8,18,4.0,7
Old Carthusians II,Economicals,2,2,4,5.0,1
Old Carthusians II,Enfield Old Grammarians,6,2,8,2.0,1
Old Carthusians II,Fulham Compton Old Boys,0,1,1,3.0,1
Old Carthusians II,Glynn Old Boys II,1,4,5,2.0,1
Old Carthusians II,Hale End Athletic,0,5,5,0.0,1
Old Carthusians II,Honourable Artillery Company,0,6,6,0.0,1
Old Carthusians II,KCS Old Boys II,9,4,13,3.0,2
Old Carthusians II,Kings College Wimbledon II,21,16,37,3.125,8
Old Carthusians II,Lancing Old Boys II,26,11,37,3.076923076923077,13
Old Carthusians II,Merton,1,4,5,2.0,1
Old Carthusians II,NUFC Oilers,4,6,10,4.0,2
Old Carthusians II,Old Albanians,8,15,23,3.5,4
Old Carthusians II,Old Aldenhamians,10,11,21,2.8,5
Old Carthusians II,Old Aldenhamians II,11,3,14,2.5,2
Old Carthusians II,Old Alleynians AFC,2,3,5,4.0,2
Old Carthusians II,Old Alleynians AFC II,2,3,5,4.0,2
Old Carthusians II,Old Alleynians II,5,7,12,4.0,3
Old Carthusians II,Old Alleynians III,17,16,33,2.0,6
Old Carthusians II,Old Ardinians,2,11,13,1.0,2
Old Carthusians II,Old Berkhamstedians,8,9,17,3.0,4
Old Carthusians II,Old Berkhamstedians II,2,2,4,5.0,1
Old Carthusians II,Old Brentwoods II,18,19,37,2.875,8
Old Carthusians II,Old Brentwoods III,1,3,4,3.0,1
Old Carthusians II,Old Bromleians,8,0,8,0.0,1
Old Carthusians II,Old Carthusians III,29,32,61,3.25,16
Old Carthusians II,Old Chigwellians II,48,20,68,2.6666666666666665,15
Old Carthusians II,Old Cholmeleians II,18,6,24,2.875,8
Old Carthusians II,Old Citizens,11,7,18,3.6666666666666665,3
Old Carthusians II,Old Columbans,4,0,4,2.6666666666666665,3
Old Carthusians II,Old Epsomians,21,13,34,3.1666666666666665,6
Old Carthusians II,Old Etonians II,33,34,67,3.125,16
Old Carthusians II,Old Foresters II,30,13,43,2.6153846153846154,13
Old Carthusians II,Old Garchonians,1,0,1,3.0,1
Old Carthusians II,Old Haberdashers,26,16,42,2.2857142857142856,7
Old Carthusians II,Old Haileyburians,4,1,5,2.0,1
Old Carthusians II,Old Hamptonians,4,5,9,5.0,1
Old Carthusians II,Old Harrovians II,31,21,52,3.230769230769231,13
Old Carthusians II,Old Isleworthians II,7,3,10,2.0,1
Old Carthusians II,Old Johnians,0,11,11,1.5,2
Old Carthusians II,Old Kimboltonians,2,2,4,5.0,1
Old Carthusians II,Old King's Scholars,4,1,5,2.0,1
Old Carthusians II,Old Kingstonians,0,2,2,2.0,1
Old Carthusians II,Old Malvernians,5,0,5,0.0,1
Old Carthusians II,Old Manorians,2,3,5,4.0,1
Old Carthusians II,Old Marlburians,6,9,15,3.8,5
Old Carthusians II,Old Meadonians,1,2,3,4.0,1
Old Carthusians II,Old Merchant Taylors,22,8,30,2.875,8
Old Carthusians II,Old Merchant Taylors',5,3,8,4.0,2
Old Carthusians II,Old Millfieldians,6,7,13,3.0,3
Old Carthusians II,Old Millhillians,3,2,5,4.0,1
Old Carthusians II,Old Minchendenians,3,2,5,4.0,1
Old Carthusians II,Old Owens,2,0,2,2.0,1
Old Carthusians II,Old Parmiterians,4,2,6,3.0,1
Old Carthusians II,Old Radleians,13,14,27,4.2,5
Old Carthusians II,Old Reptonians,1,6,7,2.0,2
Old Carthusians II,Old Rugbeians,10,1,11,1.0,2
Old Carthusians II,Old Salopians II,10,4,14,3.25,4
Old Carthusians II,Old Sedcopians,7,2,9,0.0,1
Old Carthusians II,Old Sennockians,27,16,43,3.1,10
Old Carthusians II,Old Shirburnians,14,11,25,1.5,4
Old Carthusians II,Old Thorntonians,1,5,6,2.0,1
Old Carthusians II,Old Thorntonians III,1,2,3,4.0,1
Old Carthusians II,Old Tonbridgians II,10,8,18,3.75,4
Old Carthusians II,Old Wellingtonians,20,3,23,2.2857142857142856,7
Old Carthusians II,Old Westminsters,21,21,42,3.0,9
Old Carthusians II,Old Wokingians,3,1,4,3.0,2
Old Carthusians II,Reigatians,4,1,5,2.0,1
Old Carthusians II,Royal Bank of Scotland,3,3,6,5.0,1
Old Carthusians II,West Wickham,3,0,3,2.0,1
Old Carthusians II,Wood Green Old Boys,7,1,8,0.0,1
Old Carthusians III,Alleyn Old Boys,1,2,3,4.0,1
Old Carthusians III,Bealonians,3,1,4,3.0,1
Old Carthusians III,Carshalton,2,3,5,4.0,1
Old Carthusians III,Charterhouse School 1st XI,3,1,4,3.0,1
Old Carthusians III,Charterhouse School 3rd XI,20,9,29,2.4,5
Old Carthusians III,Civil Service III,1,0,1,3.0,1
Old Carthusians III,Economicals,2,1,3,4.0,1
Old Carthusians III,Enfield Old Grammarians,5,1,6,2.0,1
Old Carthusians III,Fulham Compton Old Boys,4,2,6,3.0,1
Old Carthusians III,Hale End Athletic,2,2,4,5.0,1
Old Carthusians III,Heathrow Seniors,5,0,5,0.0,1
Old Carthusians III,John Fisher Old Boys,4,1,5,2.0,1
Old Carthusians III,Kings College Wimbledon II,12,13,25,3.142857142857143,7
Old Carthusians III,Lancing Old Boys II,35,25,60,2.625,16
Old Carthusians III,London Welsh F.C.,6,0,6,0.0,1
Old Carthusians III,Merton,4,2,6,3.0,1
Old Carthusians III,Nottsborough FC,3,4,7,2.5,2
Old Carthusians III,Nottsborough FC III,1,1,2,4.0,1
Old Carthusians III,Old Actonians Association FC,7,2,9,2.5,2
Old Carthusians III,Old Aldenhamians II,10,4,14,3.25,4
Old Carthusians III,Old Alleynians AFC,3,9,12,2.3333333333333335,3
Old Carthusians III,Old Alleynians II,3,3,6,5.0,1
Old Carthusians III,Old Bancroftians AFC,5,0,5,0.0,1
Old Carthusians III,Old Berkhamstedians,10,9,19,3.4,5
Old Carthusians III,Old Brentwoods II,2,3,5,4.0,1
Old Carthusians III,Old Carthusians II,32,29,61,3.25,16
Old Carthusians III,Old Chigwellians II,26,9,35,2.4444444444444446,9
Old Carthusians III,Old Cholmeleians II,30,15,45,2.5,10
Old Carthusians III,Old Columbans,3,10,13,1.5,2
Old Carthusians III,Old Epsomians,9,11,20,3.1666666666666665,6
Old Carthusians III,Old Etonians II,27,6,33,2.0,9
Old Carthusians III,Old Foresters II,25,21,46,3.272727272727273,11
Old Carthusians III,Old Haberdashers,26,8,34,2.3333333333333335,6
Old Carthusians III,Old Haileyburians,11,0,11,0.0,1
Old Carthusians III,Old Harrovians II,3,2,5,4.0,2
Old Carthusians III,Old Johnians FC,5,18,23,2.0,4
Old Carthusians III,Old King's Scholars,7,3,10,2.0,1
Old Carthusians III,Old Kingsburians,2,2,4,5.0,1
Old Carthusians III,Old Marlburians,4,6,10,3.0,2
Old Carthusians III,Old Meadonians,1,0,1,3.0,1
Old Carthusians III,Old Millfieldians,11,4,15,2.0,2
Old Carthusians III,Old Oundelians,6,2,8,2.0,1
Old Carthusians III,Old Owens,3,1,4,3.0,1
Old Carthusians III,Old Radleians,2,12,14,1.5,2
Old Carthusians III,Old Reptonians,5,4,9,4.5,2
Old Carthusians III,Old Rugbeians,11,14,25,2.0,5
Old Carthusians III,Old Salopians II,17,8,25,2.3333333333333335,6
Old Carthusians III,Old Salvatorians,3,1,4,3.0,1
Old Carthusians III,Old Sennockians,16,9,25,2.5,4
Old Carthusians III,Old Suttonians,2,5,7,2.0,1
Old Carthusians III,Old Suttonians SV,6,15,21,3.0,3
Old Carthusians III,Old Tonbridgians II,9,18,27,3.6,5
Old Carthusians III,Old Wellingtonians,26,17,43,3.6,10
Old Carthusians III,Old Westminsters,26,15,41,3.625,8
Old Carthusians III,Old Whitgiftians,3,0,3,2.0,1
Old Carthusians III,Old Wokingians,4,1,5,3.0,2
Old Carthusians III,Polytechnic 3s,3,1,4,3.0,1
Old Carthusians III,Reigatians,3,0,3,2.0,1
Old Carthusians III,Wandsworth Borough,6,1,7,0.0,1
Old Carthusians III,Weirside Rangers,5,0,5,0.0,1
Old Carthusians III,Winchmore Hill,2,3,5,4.0,1
Old Carthusians Vets,KCS Old Boys Vets,6,10,16,4.0,2
Old Carthusians Vets,Lancing Old Boys Vets,2,5,7,3.0,2
Old Carthusians Vets,Old Berkhamstedians Vets,2,0,2,2.0,1
Old Carthusians Vets,Old Bradfieldians Vets,4,6,10,2.6666666666666665,3
Old Carthusians Vets,Old Brentwoods Vets,3,3,6,3.5,2
Old Carthusians Vets,Old Cholmeleians Vets,4,4,8,3.0,2
Old Carthusians Vets,Old Etonians Vets,0,1,1,3.0,1
Old Carthusians Vets,Old Foresters Vets,5,11,16,3.0,3
Old Carthusians Vets,Old Harrovians Vets,16,21,37,3.8,5
Old Carthusians Vets,Old Malvernians Vets,2,5,7,2.0,1
Old Carthusians Vets,Old Pauline,0,2,2,2.0,1
Old Carthusians Vets,Old Reptonians Vets,12,4,16,1.5,2
Old Carthusians Vets,Old Salopians Vets,9,2,11,0.0,1
Old Carthusians Vets,Old Tonbridgians Vets,9,4,13,3.0,4
Old Carthusians Vets,Old Wellingtonians Vets,1,4,5,2.0,1
Old Carthusians Vets,Old Westminsters Vets,7,1,8,2.0,2
Old Carthusians Vets,Old Wykehamists Vets,7,4,11,2.0,3
Old Challoners,Old Aldenhamians II,0,2,2,2.0,1
Old Challoners,Old Cholmeleians II,0,1,1,3.0,1
Old Challoners,Old Millhillians,6,6,12,6.0,1
Old Challoners,Old Sennockians,0,0,0,4.0,1
Old Cheltonians,Cheltenham College 1st XI,4,3,7,4.0,1
Old Cheltonians,Lancing Old Boys II,3,1,4,2.5,2
Old Cheltonians,Old Berkhamstedians II,4,1,5,2.0,1
Old Cheltonians,Old Brentwoods III,6,13,19,2.0,2
Old Cheltonians,Old Brentwoods IV,17,14,31,2.5,6
Old Cheltonians,Old Canfordians,5,9,14,4.0,4
Old Cheltonians,Old Cranleighans,3,5,8,4.0,2
Old Cheltonians,Old Eastbournians,5,1,6,2.5,2
Old Cheltonians,Old Etonians II,0,2,2,2.0,1
Old Cheltonians,Old Haberdashers,3,6,9,3.3333333333333335,3
Old Cheltonians,Old Harrovians III,4,5,9,4.5,2
Old Cheltonians,Old Johnians II,8,5,13,3.0,3
Old Cheltonians,Old Kingstonians,4,7,11,2.3333333333333335,3
Old Cheltonians,Old Merchant Taylors II,5,4,9,5.0,1
Old Cheltonians,Old Oundelians,27,3,30,1.4,5
Old Cheltonians,Old Salopians II,20,17,37,3.5,6
Old Cheltonians,Old Stoics,2,1,3,4.0,1
Old Cheltonians,Old Tonbridgians II,0,2,2,2.0,1
Old Cheltonians,Old Wellingtonians,1,3,4,3.0,1
Old Cheltonians,Old Westminsters II,4,7,11,3.6666666666666665,3
Old Cheltonians,Old Wykehamists II,3,4,7,4.0,1
Old Chigwellians,Altis,1,4,5,2.0,1
Old Chigwellians,Chigwell School 1st XI,3,0,3,3.0,2
Old Chigwellians,East Barnet Old Grammarians,8,0,8,0.0,1
Old Chigwellians,Glyn Old Boys,2,3,5,4.0,1
Old Chigwellians,Hale End Athletic,1,3,4,3.0,1
Old Chigwellians,KCS Old Boys,18,24,42,3.1666666666666665,12
Old Chigwellians,Lancing Old Boys,18,18,36,3.2142857142857144,14
Old Chigwellians,London Welsh F.C.,4,3,7,4.0,1
Old Chigwellians,Merton,3,1,4,3.0,1
Old Chigwellians,New College Old Boys,3,3,6,5.0,1
Old Chigwellians,Old Aldenhamians,13,3,16,2.2,5
Old Chigwellians,Old Alleynians,8,9,17,4.0,3
Old Chigwellians,Old Alleynians AFC,7,15,22,2.6666666666666665,3
Old Chigwellians,Old Ardinians,1,3,4,3.0,1
Old Chigwellians,Old Berkhamstedians,18,4,22,2.2,5
Old Chigwellians,Old Bradfieldians,23,30,53,2.6,10
Old Chigwellians,Old Brentwoods,25,25,50,3.272727272727273,11
Old Chigwellians,Old Carthusians,15,45,60,2.5384615384615383,13
Old Chigwellians,Old Chigwellians II,3,3,6,5.0,1
Old Chigwellians,Old Cholmeleians,25,38,63,2.4,15
Old Chigwellians,Old Eastbournians,13,0,13,1.0,1
Old Chigwellians,Old Etonians,21,48,69,2.8125,16
Old Chigwellians,Old Finchleians,2,7,9,2.5,2
Old Chigwellians,Old Foresters,27,34,61,3.6470588235294117,17
Old Chigwellians,Old Haileyburians,6,3,9,3.5,2
Old Chigwellians,Old Hamptonians,0,8,8,0.0,1
Old Chigwellians,Old Harrovians,24,25,49,3.090909090909091,11
Old Chigwellians,Old Johnians,3,5,8,2.0,2
Old Chigwellians,Old Kimboltonians,4,6,10,4.0,2
Old Chigwellians,Old Lyonians,2,3,5,4.0,1
Old Chigwellians,Old Malvernians,40,9,49,1.8888888888888888,9
Old Chigwellians,Old Marlburians,34,25,59,2.75,12
Old Chigwellians,Old Merchant Taylors,7,3,10,2.0,2
Old Chigwellians,Old Millfieldians,6,1,7,2.0,2
Old Chigwellians,Old Parkonians,1,4,5,3.0,2
Old Chigwellians,Old Radleians,21,5,26,2.2,5
Old Chigwellians,Old Reptonians,29,26,55,3.25,12
Old Chigwellians,Old Rugbeians,19,16,35,3.4,5
Old Chigwellians,Old Salopians,39,33,72,2.9375,16
Old Chigwellians,Old Sennockians,10,3,13,2.0,2
Old Chigwellians,Old Stationers,3,2,5,4.0,1
Old Chigwellians,Old Tonbridgians,21,38,59,2.9166666666666665,12
Old Chigwellians,Old Wellingtonians,8,3,11,3.3333333333333335,3
Old Chigwellians,Old Westminsters,23,18,41,2.25,8
Old Chigwellians,Old Wilsonians,1,2,3,4.0,1
Old Chigwellians,Old Wykehamists,26,15,41,2.3,10
Old Chigwellians,Richmond & Kew SSEC,3,5,8,4.0,1
Old Chigwellians,Spaniards,4,0,4,1.0,1
Old Chigwellians,Winchmore Hill,0,5,5,2.0,2
Old Chigwellians II,Albanian FC,3,4,7,4.0,1
Old Chigwellians II,Chigwell School 2nd XI,0,0,0,4.0,2
Old Chigwellians II,Civil Service II,1,4,5,2.0,1
Old Chigwellians II,East Barnet Old Grammarians,3,1,4,3.0,1
Old Chigwellians II,East Barnet Old Grammarians III,4,1,5,2.0,1
Old Chigwellians II,Galleywood Reserves,1,2,3,4.0,1
Old Chigwellians II,Kings College Wimbledon II,5,8,13,3.4,5
Old Chigwellians II,Lancing Old Boys,2,13,15,1.0,2
Old Chigwellians II,Lancing Old Boys II,16,19,35,3.5,12
Old Chigwellians II,Old Albanians,6,15,21,3.0,3
Old Chigwellians II,Old Aldenhamians,15,18,33,3.2222222222222223,9
Old Chigwellians II,Old Aldenhamians II,13,7,20,2.6666666666666665,6
Old Chigwellians II,Old Alleynians AFC,4,4,8,2.5,2
Old Chigwellians II,Old Alleynians AFC II,1,1,2,4.0,1
Old Chigwellians II,Old Alleynians II,13,21,34,2.6666666666666665,6
Old Chigwellians II,Old Alleynians III,2,1,3,4.0,1
Old Chigwellians II,Old Ardinians,3,10,13,1.5,2
Old Chigwellians II,Old Berkhamstedians,5,15,20,1.5,4
Old Chigwellians II,Old Berkhamstedians II,2,1,3,3.5,2
Old Chigwellians II,Old Brentwoods II,1,1,2,4.0,1
Old Chigwellians II,Old Brentwoods III,7,2,9,2.0,2
Old Chigwellians II,Old Carthusians II,20,48,68,2.6666666666666665,15
Old Chigwellians II,Old Carthusians III,9,26,35,2.4444444444444446,9
Old Chigwellians II,Old Chigwellians,3,3,6,5.0,1
Old Chigwellians II,Old Cholmeleians II,21,28,49,2.2,10
Old Chigwellians II,Old Citizens,14,6,20,3.142857142857143,7
Old Chigwellians II,Old Eastbournians,10,9,19,2.75,4
Old Chigwellians II,Old Epsomians,20,8,28,2.8333333333333335,6
Old Chigwellians II,Old Etonians II,30,34,64,3.357142857142857,14
Old Chigwellians II,Old Finchleians,2,3,5,4.0,1
Old Chigwellians II,Old Foresters II,12,6,18,3.5,8
Old Chigwellians II,Old Haberdashers,27,16,43,3.2,10
Old Chigwellians II,Old Harrovians II,19,30,49,3.25,12
Old Chigwellians II,Old Johnians,4,11,15,2.6666666666666665,3
Old Chigwellians II,Old Johnians FC,3,1,4,3.0,1
Old Chigwellians II,Old Kimboltonians,15,24,39,3.857142857142857,7
Old Chigwellians II,Old King's Scholars,2,2,4,4.5,2
Old Chigwellians II,Old Malvernians,4,6,10,4.0,2
Old Chigwellians II,Old Marlburians,5,12,17,2.6666666666666665,3
Old Chigwellians II,Old Merchant Taylors,11,11,22,2.7142857142857144,7
Old Chigwellians II,Old Merchant Taylors II,5,2,7,3.0,2
Old Chigwellians II,Old Merchant Taylors',5,4,9,4.5,2
Old Chigwellians II,Old Millfieldians,1,12,13,1.0,2
Old Chigwellians II,Old Parmiterians,0,0,0,4.0,1
Old Chigwellians II,Old Parmiterians II,2,3,5,4.0,1
Old Chigwellians II,Old Pauline,5,6,11,5.0,1
Old Chigwellians II,Old Radleians,8,13,21,2.6,5
Old Chigwellians II,Old Reptonians,2,7,9,2.0,2
Old Chigwellians II,Old Rugbeians,2,1,3,4.0,1
Old Chigwellians II,Old Salopians II,23,11,34,2.0,8
Old Chigwellians II,Old Sennockians,10,16,26,3.3,10
Old Chigwellians II,Old Tenisonians,1,2,3,4.0,1
Old Chigwellians II,Old Tonbridgians II,4,1,5,3.0,2
Old Chigwellians II,Old Wellingtonians,12,10,22,3.3333333333333335,6
Old Chigwellians II,Old Westminsters,3,16,19,1.5,4
Old Chigwellians II,Old Wykehamists II,7,2,9,0.0,1
Old Chigwellians III,Chigwell School 3rd XI,3,3,6,4.5,2
Old Chigwellians III,Old Albanians SA,7,13,20,3.6,5
Old Chigwellians III,Old Aldenhamians II,5,1,6,1.5,2
Old Chigwellians III,Old Alleynians AFC,1,3,4,3.0,2
Old Chigwellians III,Old Aloysians,3,9,12,2.0,2
Old Chigwellians III,Old Amplefordians,11,15,26,2.6666666666666665,6
Old Chigwellians III,Old Bancroftians AFC,4,6,10,4.0,4
Old Chigwellians III,Old Berkhamstedians,4,13,17,2.3333333333333335,3
Old Chigwellians III,Old Brentwoods II,8,10,18,3.0,5
Old Chigwellians III,Old Brentwoods III,14,26,40,3.2857142857142856,14
Old Chigwellians III,Old Chigwellians Vets,0,1,1,3.0,1
Old Chigwellians III,Old Cholmeleians II,10,18,28,2.8333333333333335,6
Old Chigwellians III,Old Cholmeleians III,21,7,28,2.625,8
Old Chigwellians III,Old Cholmeleians IV,6,1,7,0.0,1
Old Chigwellians III,Old Citizens,2,8,10,2.0,2
Old Chigwellians III,Old Columbans,1,14,15,0.0,2
Old Chigwellians III,Old Eastbournians,11,13,24,3.5714285714285716,7
Old Chigwellians III,Old Epsomians,5,6,11,2.5,2
Old Chigwellians III,Old Foresters III,14,15,29,3.0,7
Old Chigwellians III,Old Kimboltonians,2,8,10,2.0,2
Old Chigwellians III,Old Malvernians II,4,5,9,4.5,2
Old Chigwellians III,Old Merchant Taylors,1,3,4,3.0,1
Old Chigwellians III,Old Merchant Taylors II,19,11,30,2.8333333333333335,6
Old Chigwellians III,Old Millhillians,5,9,14,3.5,2
Old Chigwellians III,Old Minchendenians IV,0,6,6,0.0,1
Old Chigwellians III,Old Parkonians,0,4,4,1.0,1
Old Chigwellians III,Old Rugbeians,3,5,8,4.0,1
Old Chigwellians III,Old Sennockians,3,5,8,2.6666666666666665,3
Old Chigwellians III,Old Shirburnians,1,4,5,2.0,1
Old Chigwellians III,Old Stoics,15,8,23,2.1666666666666665,6
Old Chigwellians III,Old Suttonians SV,3,4,7,4.0,1
Old Chigwellians III,Old Westminsters II,9,4,13,3.0,4
Old Chigwellians III,Old Wykehamists II,4,6,10,3.25,4
Old Chigwellians IV,Old Brentwoods III,4,7,11,3.0,2
Old Chigwellians IV,Old Brentwoods IV,3,3,6,2.5,2
Old Chigwellians IV,Old Cholmeleians IV,2,4,6,3.5,2
Old Chigwellians IV,Old Citizens,1,5,6,2.0,1
Old Chigwellians IV,Old Foresters III,3,7,10,2.0,2
Old Chigwellians IV,Old Foresters IV,1,3,4,3.5,2
Old Chigwellians IV,Old Malvernians II,1,10,11,1.5,2
Old Chigwellians Veterans,Old Foresters Vets,0,2,2,2.0,1
Old Chigwellians Vets,Albanian FC,7,3,10,3.3333333333333335,3
Old Chigwellians Vets,Alleyn Old Boys,1,0,1,3.0,1
Old Chigwellians Vets,Globe Rangers Vets 2nd,7,3,10,2.0,1
Old Chigwellians Vets,Hale End Athletic,4,2,6,3.0,1
Old Chigwellians Vets,Lancing Old Boys Vets,0,0,0,4.0,1
Old Chigwellians Vets,London Lions Vets,2,4,6,3.0,1
Old Chigwellians Vets,Old Aloysians,2,1,3,4.0,1
Old Chigwellians Vets,Old Bradfieldians Vets,7,11,18,2.0,3
Old Chigwellians Vets,Old Brentwoods Vets,3,3,6,2.5,2
Old Chigwellians Vets,Old Chigwellians III,1,0,1,3.0,1
Old Chigwellians Vets,Old Cholmeleians Vets,8,0,8,1.0,2
Old Chigwellians Vets,Old Etonians Vets,4,9,13,3.25,4
Old Chigwellians Vets,Old Foresters Vets,3,2,5,3.0,2
Old Chigwellians Vets,Old Haileyburians Vets,2,2,4,5.0,1
Old Chigwellians Vets,Old Harrovians Vets,4,1,5,2.0,1
Old Chigwellians Vets,Old Ignatians,7,1,8,0.0,1
Old Chigwellians Vets,Old Lyonians,4,0,4,1.0,1
Old Chigwellians Vets,Old Malvernians Vets,1,3,4,3.0,1
Old Chigwellians Vets,Old Reptonians Vets,6,4,10,4.0,1
Old Chigwellians Vets,Old Salopians Vets,11,7,18,3.3333333333333335,3
Old Chigwellians Vets,Old Tonbridgians Vets,2,1,3,4.0,1
Old Chigwellians Vets,Old Westminsters Vets,4,2,6,3.0,1
Old Chigwellians Vets,Old Wilsonians Vets,0,4,4,1.0,1
Old Chigwellians Vets,Old Wykehamists Vets,11,10,21,1.0,3
Old Chigwellians Vets,Wormley Rovers Vets FC,3,1,4,3.0,1
Old Chigwellians Vets Blues,Atletico Trotters Vets,5,2,7,2.0,1
Old Chigwellians Vets Blues,Canning Town Vets,3,5,8,4.0,1
Old Chigwellians Vets Blues,Croxley Green Vets,3,0,3,2.0,1
Old Chigwellians Vets Blues,Halstead Town Vets,3,2,5,4.0,1
Old Chigwellians Vets Blues,Old Foresters Vets,7,10,17,3.3333333333333335,3
Old Chigwellians Vets Blues,Old Wellingtonians Vets,5,3,8,4.0,1
Old Chigwellians Vets Blues,Polytechnic Vets,3,0,3,2.0,1
Old Cholmeleians,Bealonians,1,1,2,4.0,1
Old Cholmeleians,City of London,6,0,6,0.0,1
Old Cholmeleians,Earlsfield FC,5,1,6,2.0,1
Old Cholmeleians,FC Brotherhood,1,1,2,4.0,1
Old Cholmeleians,Fulham Compton Old Boys,0,3,3,2.0,1
Old Cholmeleians,Globe Rangers,1,0,1,3.0,1
Old Cholmeleians,Hale End Athletic,8,2,10,3.0,3
Old Cholmeleians,Highgate School 1st XI,7,6,13,3.2857142857142856,7
Old Cholmeleians,KCS Old Boys,14,25,39,3.272727272727273,11
Old Cholmeleians,Lancing Old Boys,23,22,45,3.2,15
Old Cholmeleians,Leyton County Old Boys,2,1,3,4.0,1
Old Cholmeleians,London Lawyers,4,2,6,3.0,1
Old Cholmeleians,New Magdalen,0,1,1,3.0,1
Old Cholmeleians,Oakhill Tigers,4,3,7,4.0,1
Old Cholmeleians,Old Aldenhamians,29,7,36,2.4285714285714284,7
Old Cholmeleians,Old Alleynians,5,22,27,1.8,5
Old Cholmeleians,Old Alleynians AFC,4,6,10,3.0,2
Old Cholmeleians,Old Bancroftians AFC,5,3,8,4.0,1
Old Cholmeleians,Old Berkhamstedians,31,19,50,3.1,10
Old Cholmeleians,Old Bradfieldians,14,28,42,2.888888888888889,9
Old Cholmeleians,Old Brentwoods,32,38,70,3.25,16
Old Cholmeleians,Old Carthusians,17,55,72,2.6666666666666665,15
Old Cholmeleians,Old Chigwellians,38,25,63,2.4,15
Old Cholmeleians,Old Epsomians,4,2,6,3.0,1
Old Cholmeleians,Old Etonians,22,32,54,3.4615384615384617,13
Old Cholmeleians,Old Foresters,13,26,39,2.4,10
Old Cholmeleians,Old Garchonians,0,3,3,2.0,1
Old Cholmeleians,Old Haileyburians,2,3,5,4.0,1
Old Cholmeleians,Old Harrovians,24,21,45,3.4545454545454546,11
Old Cholmeleians,Old Johnians,2,1,3,4.0,1
Old Cholmeleians,Old Lyonians,7,1,8,0.0,1
Old Cholmeleians,Old Malvernians,36,16,52,3.230769230769231,13
Old Cholmeleians,Old Marlburians,17,9,26,2.5714285714285716,7
Old Cholmeleians,Old Merchant Taylors,3,2,5,4.0,1
Old Cholmeleians,Old Millfieldians,3,1,4,3.0,2
Old Cholmeleians,Old Owens,1,5,6,2.0,1
Old Cholmeleians,Old Radleians,20,13,33,3.7142857142857144,7
Old Cholmeleians,Old Reptonians,20,47,67,2.6666666666666665,15
Old Cholmeleians,Old Rugbeians,17,6,23,2.5,4
Old Cholmeleians,Old Salopians,16,22,38,3.1,10
Old Cholmeleians,Old Sedcopians,6,4,10,4.0,2
Old Cholmeleians,Old Sennockians,1,2,3,4.0,1
Old Cholmeleians,Old Suttonians,0,8,8,0.0,1
Old Cholmeleians,Old Tiffinians,2,1,3,4.0,1
Old Cholmeleians,Old Tollingtonians,3,1,4,3.0,1
Old Cholmeleians,Old Tonbridgians,23,16,39,3.4444444444444446,9
Old Cholmeleians,Old Vaughanians,0,3,3,2.0,1
Old Cholmeleians,Old Wellingtonians,17,8,25,2.25,4
Old Cholmeleians,Old Westminsters,8,5,13,3.75,4
Old Cholmeleians,Old Wilsonians,1,3,4,3.0,1
Old Cholmeleians,Old Woodhouseians,1,3,4,3.0,1
Old Cholmeleians,Old Wykehamists,13,18,31,3.2857142857142856,7
Old Cholmeleians,Park View,4,3,7,4.0,1
Old Cholmeleians,Polytechnic,1,3,4,3.0,1
Old Cholmeleians,Putney Saint-Germain,2,0,2,2.0,1
Old Cholmeleians,Shene Old Grammarians,1,2,3,4.0,1
Old Cholmeleians,Somerville Old Boys,4,1,5,2.0,1
Old Cholmeleians,Spaniards,2,3,5,3.0,2
Old Cholmeleians,Worcester College Old Boys,3,2,5,4.0,1
Old Cholmeleians II,Albanian FC,7,17,24,2.75,4
Old Cholmeleians II,Egbertian FC,1,4,5,2.0,1
Old Cholmeleians II,Fulham Compton Old Boys II,1,4,5,2.0,1
Old Cholmeleians II,Highgate School 2nd XI,2,1,3,4.0,5
Old Cholmeleians II,Icarus,1,2,3,4.0,1
Old Cholmeleians II,Kings College Wimbledon II,6,12,18,3.3333333333333335,3
Old Cholmeleians II,Lancing Old Boys,16,2,18,0.3333333333333333,3
Old Cholmeleians II,Lancing Old Boys II,24,11,35,3.0,7
Old Cholmeleians II,Mill Hill Village,4,2,6,3.0,1
Old Cholmeleians II,Old Albanians,10,3,13,2.0,2
Old Cholmeleians II,Old Albanians SA,17,23,40,3.875,8
Old Cholmeleians II,Old Aldenhamians,11,9,20,3.2,5
Old Cholmeleians II,Old Aldenhamians II,11,6,17,2.6666666666666665,3
Old Cholmeleians II,Old Alleynians AFC III,2,3,5,4.0,1
Old Cholmeleians II,Old Alleynians II,13,12,25,3.0,6
Old Cholmeleians II,Old Alleynians III,9,6,15,3.3333333333333335,3
Old Cholmeleians II,Old Amplefordians,2,0,2,2.0,1
Old Cholmeleians II,Old Ardinians,4,5,9,2.3333333333333335,3
Old Cholmeleians II,Old Bancroftians AFC,2,8,10,2.5,2
Old Cholmeleians II,Old Berkhamstedians,1,7,8,2.6666666666666665,3
Old Cholmeleians II,Old Berkhamstedians II,4,2,6,3.0,1
Old Cholmeleians II,Old Brentwoods II,20,14,34,3.2857142857142856,7
Old Cholmeleians II,Old Brentwoods III,30,17,47,1.8571428571428572,7
Old Cholmeleians II,Old Carthusians II,6,18,24,2.875,8
Old Cholmeleians II,Old Carthusians III,15,30,45,2.5,10
Old Cholmeleians II,Old Challoners,1,0,1,3.0,1
Old Cholmeleians II,Old Chigwellians II,28,21,49,2.2,10
Old Cholmeleians II,Old Chigwellians III,18,10,28,2.8333333333333335,6
Old Cholmeleians II,Old Columbans,3,7,10,3.0,2
Old Cholmeleians II,Old Eastbournians,3,1,4,3.0,1
Old Cholmeleians II,Old Epsomians,4,12,16,2.3333333333333335,3
Old Cholmeleians II,Old Etonians II,14,31,45,2.3333333333333335,9
Old Cholmeleians II,Old Foresters II,12,18,30,2.0,4
Old Cholmeleians II,Old Foresters III,10,6,16,2.75,4
Old Cholmeleians II,Old Haberdashers,26,25,51,3.3636363636363638,11
Old Cholmeleians II,Old Hamptonians,1,2,3,4.0,1
Old Cholmeleians II,Old Harrovians II,6,3,9,1.5,2
Old Cholmeleians II,Old Harrovians III,12,0,12,0.0,1
Old Cholmeleians II,Old Ignatians,1,0,1,3.0,1
Old Cholmeleians II,Old Kimboltonians,20,16,36,3.625,8
Old Cholmeleians II,Old King's Scholars,5,2,7,3.3333333333333335,3
Old Cholmeleians II,Old Kingsburians,4,2,6,3.0,1
Old Cholmeleians II,Old Kingstonians KGS,6,1,7,0.0,1
Old Cholmeleians II,Old Malvernians,6,6,12,4.0,2
Old Cholmeleians II,Old Manorians,5,2,7,2.0,1
Old Cholmeleians II,Old Marlburians,4,9,13,2.5,2
Old Cholmeleians II,Old Merchant Taylors,10,15,25,2.6666666666666665,6
Old Cholmeleians II,Old Merchant Taylors II,18,5,23,1.75,4
Old Cholmeleians II,Old Millfieldians,3,4,7,4.0,1
Old Cholmeleians II,Old Millhillians,15,0,15,1.0,1
Old Cholmeleians II,Old Owens,4,3,7,4.0,1
Old Cholmeleians II,Old Parmiterians,2,6,8,2.0,1
Old Cholmeleians II,Old Radleians,4,4,8,3.5,2
Old Cholmeleians II,Old Reptonians,2,10,12,1.5,2
Old Cholmeleians II,Old Rugbeians,0,2,2,2.0,1
Old Cholmeleians II,Old Salopians II,13,4,17,2.5,4
Old Cholmeleians II,Old Salvatorians,1,5,6,2.0,1
Old Cholmeleians II,Old Sedcopians,1,2,3,4.0,1
Old Cholmeleians II,Old Sennockians,3,3,6,4.0,2
Old Cholmeleians II,Old Shirburnians,3,0,3,2.0,1
Old Cholmeleians II,Old Stoics,9,10,19,4.0,3
Old Cholmeleians II,Old Suttonians SV,14,20,34,3.75,4
Old Cholmeleians II,Old Tonbridgians II,11,9,20,2.0,5
Old Cholmeleians II,Old Wellingtonians,24,26,50,3.5555555555555554,9
Old Cholmeleians II,Old Westminsters,7,13,20,3.0,2
Old Cholmeleians II,Old Wykehamists II,4,11,15,3.25,4
Old Cholmeleians II,Parkfield,11,0,11,0.0,1
Old Cholmeleians II,Polytechnic,2,6,8,2.0,1
Old Cholmeleians II,Royal Bank of Scotland II,0,10,10,0.0,1
Old Cholmeleians II,South Bank Cuaco,4,2,6,3.0,1
Old Cholmeleians II,Southgate County,7,1,8,2.0,2
Old Cholmeleians II,UCL Academicals III,0,3,3,2.0,1
Old Cholmeleians II,Wandsworth Borough,8,1,9,0.0,1
Old Cholmeleians III,Alleyn Old Boys,2,1,3,4.0,1
Old Cholmeleians III,Highgate School 3rd XI,1,3,4,3.0,2
Old Cholmeleians III,Hornsey and Highgate FC,4,2,6,3.0,1
Old Cholmeleians III,Kings College Wimbledon II,6,6,12,3.5,2
Old Cholmeleians III,Oakhill Tigers,1,8,9,0.0,1
Old Cholmeleians III,Old Aldenhamians II,0,3,3,2.5,2
Old Cholmeleians III,Old Alleynians AFC,2,17,19,0.0,2
Old Cholmeleians III,Old Amplefordians,12,5,17,2.25,4
Old Cholmeleians III,Old Berkhamstedians,4,6,10,3.25,4
Old Cholmeleians III,Old Brentwoods II,6,5,11,2.75,4
Old Cholmeleians III,Old Brentwoods III,9,11,20,2.75,4
Old Cholmeleians III,Old Buckwellians,1,1,2,4.0,1
Old Cholmeleians III,Old Chigwellians III,7,21,28,2.625,8
Old Cholmeleians III,Old Cholmeleians IV,3,2,5,4.0,1
Old Cholmeleians III,Old Citizens,2,4,6,3.5,2
Old Cholmeleians III,Old Eastbournians,11,10,21,3.75,4
Old Cholmeleians III,Old Edmontonians,4,3,7,4.0,1
Old Cholmeleians III,Old Epsomians,7,9,16,3.75,4
Old Cholmeleians III,Old Etonians II,2,5,7,3.0,2
Old Cholmeleians III,Old Foresters II,1,3,4,3.0,2
Old Cholmeleians III,Old Foresters III,6,13,19,3.6666666666666665,3
Old Cholmeleians III,Old Harrovians II,6,5,11,2.0,2
Old Cholmeleians III,Old Harrovians III,3,1,4,3.0,1
Old Cholmeleians III,Old Johnians FC,1,9,10,0.0,1
Old Cholmeleians III,Old Merchant Taylors,1,6,7,2.5,2
Old Cholmeleians III,Old Merchant Taylors II,2,11,13,2.0,2
Old Cholmeleians III,Old Millhillians,4,8,12,3.5,2
Old Cholmeleians III,Old Oundelians,0,5,5,0.0,1
Old Cholmeleians III,Old Parmiterians,0,2,2,2.0,1
Old Cholmeleians III,Old Sennockians,6,8,14,3.0,2
Old Cholmeleians III,Old Shirburnians,0,5,5,0.0,1
Old Cholmeleians III,Old Stoics,7,3,10,3.0,4
Old Cholmeleians III,Old Westminsters II,7,7,14,2.0,2
Old Cholmeleians III,Old Wykehamists II,11,19,30,3.1666666666666665,6
Old Cholmeleians III,Southgate County,4,2,6,3.0,1
Old Cholmeleians III,UCL Academicals III,1,5,6,2.0,1
Old Cholmeleians III,Weirside Rangers,0,4,4,1.0,1
Old Cholmeleians IV,Old Amplefordians,1,4,5,3.0,2
Old Cholmeleians IV,Old Bancroftians AFC,4,28,32,1.2,5
Old Cholmeleians IV,Old Brentwoods III,12,18,30,3.5,4
Old Cholmeleians IV,Old Brentwoods IV,10,11,21,3.3333333333333335,6
Old Cholmeleians IV,Old Chigwellians III,1,6,7,0.0,1
Old Cholmeleians IV,Old Chigwellians IV,4,2,6,3.5,2
Old Cholmeleians IV,Old Cholmeleians III,2,3,5,4.0,1
Old Cholmeleians IV,Old Citizens,2,13,15,0.0,2
Old Cholmeleians IV,Old Foresters III,19,27,46,2.4444444444444446,9
Old Cholmeleians IV,Old Foresters IV,3,6,9,3.5,2
Old Cholmeleians IV,Old Harrovians III,15,19,34,2.6666666666666665,6
Old Cholmeleians IV,Old Malvernians II,1,12,13,1.0,1
Old Cholmeleians IV,Old Merchant Taylors,8,17,25,3.25,4
Old Cholmeleians IV,Old Millhillians,11,14,25,4.0,3
Old Cholmeleians IV,Old Oundelians,1,4,5,2.0,1
Old Cholmeleians IV,Old Sennockians,6,10,16,4.0,2
Old Cholmeleians IV,Old Tonbridgians II,2,14,16,1.5,2
Old Cholmeleians Vets,KCS Old Boys Vets,1,6,7,0.0,1
Old Cholmeleians Vets,Lancing Old Boys Vets,4,4,8,5.0,2
Old Cholmeleians Vets,Old Carthusians Vets,4,4,8,3.0,2
Old Cholmeleians Vets,Old Chigwellians Vets,0,8,8,1.0,2
Old Cholmeleians Vets,Old Etonians Vets,4,8,12,3.6666666666666665,3
Old Cholmeleians Vets,Old Foresters Vets,10,16,26,3.5,4
Old Cholmeleians Vets,Old Haileyburians Vets,8,8,16,6.0,2
Old Cholmeleians Vets,Old Reptonians Vets,11,6,17,3.3333333333333335,3
Old Cholmeleians Vets,Old Westminsters Vets,5,3,8,3.5,2
Old Citizens,Blackheath Wanderers (Youth) First Team,2,3,5,4.0,1
Old Citizens,Kings College Wimbledon II,19,6,25,2.0,6
Old Citizens,Lancing Old Boys II,5,2,7,3.5,2
Old Citizens,Old Aldenhamians II,14,8,22,3.6,5
Old Citizens,Old Alleynians AFC,6,10,16,1.6666666666666667,3
Old Citizens,Old Bancroftians AFC,10,1,11,1.5,2
Old Citizens,Old Berkhamstedians,1,8,9,1.5,2
Old Citizens,Old Brentwoods II,10,7,17,2.5,4
Old Citizens,Old Brentwoods III,30,1,31,0.0,4
Old Citizens,Old Brentwoods IV,10,6,16,3.5,2
Old Citizens,Old Carthusians II,7,11,18,3.6666666666666665,3
Old Citizens,Old Chigwellians II,6,14,20,3.142857142857143,7
Old Citizens,Old Chigwellians III,8,2,10,2.0,2
Old Citizens,Old Chigwellians IV,5,1,6,2.0,1
Old Citizens,Old Cholmeleians III,4,2,6,3.5,2
Old Citizens,Old Cholmeleians IV,13,2,15,0.0,2
Old Citizens,Old Eastbournians,29,11,40,2.0,8
Old Citizens,Old Epsomians,21,20,41,2.3333333333333335,9
Old Citizens,Old Etonians II,2,9,11,2.3333333333333335,3
Old Citizens,Old Foresters II,11,9,20,3.6666666666666665,3
Old Citizens,Old Foresters III,14,1,15,1.0,2
Old Citizens,Old Foresters IV,11,2,13,1.0,2
Old Citizens,Old Haberdashers,17,5,22,3.0,3
Old Citizens,Old Harrovians II,31,23,54,2.111111111111111,9
Old Citizens,Old King's Scholars,5,0,5,0.0,1
Old Citizens,Old Malvernians,0,1,1,3.0,1
Old Citizens,Old Malvernians II,12,12,24,3.8333333333333335,6
Old Citizens,Old Merchant Taylors,10,6,16,3.25,4
Old Citizens,Old Millfieldians,1,4,5,3.0,2
Old Citizens,Old Oundelians,2,2,4,5.0,1
Old Citizens,Old Radleians,7,2,9,0.0,1
Old Citizens,Old Salopians II,27,13,40,3.0,8
Old Citizens,Old Sennockians,14,8,22,2.5,4
Old Citizens,Old Shirburnians,2,4,6,3.0,1
Old Citizens,Old Stoics,5,3,8,3.5,2
Old Citizens,Old Tonbridgians II,11,1,12,2.0,2
Old Citizens,Old Westminsters,5,9,14,3.6666666666666665,3
Old Citizens,Old Westminsters II,13,4,17,2.6666666666666665,3
Old Citizens,Old Wykehamists II,4,2,6,3.0,1
Old Columbans,Albanian FC,4,7,11,3.0,1
Old Columbans,Bealonians,7,5,12,4.5,2
Old Columbans,Kings College Wimbledon II,11,6,17,3.0,2
Old Columbans,Kings College Wimbledon III,3,1,4,3.0,1
Old Columbans,Lancing Old Boys II,6,1,7,2.5,2
Old Columbans,Mill Hill Village,4,3,7,4.0,1
Old Columbans,Old Albanians SA,16,5,21,2.3333333333333335,3
Old Columbans,Old Aldenhamians,4,4,8,6.0,1
Old Columbans,Old Alleynians,1,4,5,2.0,1
Old Columbans,Old Alleynians AFC II,4,2,6,3.5,2
Old Columbans,Old Bancroftians AFC,8,4,12,3.0,2
Old Columbans,Old Berkhamstedians II,8,2,10,0.0,1
Old Columbans,Old Brentwoods,1,0,1,3.0,1
Old Columbans,Old Brentwoods II,11,1,12,2.0,4
Old Columbans,Old Brentwoods III,4,6,10,2.5,2
Old Columbans,Old Carthusians II,0,4,4,2.6666666666666665,3
Old Columbans,Old Carthusians III,10,3,13,1.5,2
Old Columbans,Old Chigwellians III,14,1,15,0.0,2
Old Columbans,Old Cholmeleians II,7,3,10,3.0,2
Old Columbans,Old Eastbournians,9,1,10,1.0,2
Old Columbans,Old Epsomians,9,8,17,1.3333333333333333,3
Old Columbans,Old Etonians II,1,1,2,4.0,1
Old Columbans,Old Foresters II,3,3,6,4.0,2
Old Columbans,Old Foresters III,6,1,7,2.5,2
Old Columbans,Old Haberdashers,12,4,16,1.5,2
Old Columbans,Old Harrovians II,1,0,1,3.0,1
Old Columbans,Old Harrovians III,3,5,8,3.3333333333333335,3
Old Columbans,Old Johnians,0,4,4,1.0,1
Old Columbans,Old Johnians FC,8,15,23,2.25,4
Old Columbans,Old Kimboltonians,1,2,3,4.0,1
Old Columbans,Old King's Scholars,5,0,5,0.0,1
Old Columbans,Old Kingsburians,3,0,3,2.0,1
Old Columbans,Old Merchant Taylors,6,2,8,2.0,1
Old Columbans,Old Parmiterians,6,1,7,0.0,1
Old Columbans,Old Radleians,1,1,2,4.0,1
Old Columbans,Old Rugbeians,5,7,12,4.0,2
Old Columbans,Old Sennockians,4,4,8,3.5,2
Old Columbans,Old Shirburnians,4,4,8,2.0,2
Old Columbans,Old Stoics,9,6,15,3.0,3
Old Columbans,Old Suttonians SV,10,9,19,3.25,4
Old Columbans,Old Tonbridgians II,7,5,12,4.5,2
Old Columbans,Old Wellingtonians,8,5,13,4.0,2
Old Columbans,Old Westminsters,2,4,6,3.0,1
Old Columbans,Old Westminsters II,5,0,5,0.0,1
Old Columbans,Somerville Old Boys,3,2,5,4.0,1
Old Cranleighans,Old Canfordians,2,5,7,2.0,1
Old Cranleighans,Old Cheltonians,5,3,8,4.0,2
Old Cranleighans,Old Kingstonians,2,2,4,4.0,2
Old Cranleighans,Old Oundelians,1,1,2,4.0,1
Old Cranleighans,Old Salopians II,1,1,2,4.0,1
Old Cranleighans,Old Stoics,1,0,1,3.0,1
Old Cranleighans,Old Wellingtonians,1,3,4,3.0,1
Old Crosbeians,Old Aldenhamians II,0,3,3,2.0,1
Old Dorkinians,Kings College Wimbledon II,0,2,2,2.0,1
Old Dorkinians,Lancing Old Boys,2,3,5,4.0,1
Old Dorkinians,Old Foresters,3,0,3,2.0,1
Old Dorkinians,Old Johnians FC,2,3,5,4.0,1
Old Dorkinians,Old Kingstonians KGS,0,6,6,0.0,1
Old Dorkinians,Old Rugbeians,3,5,8,4.0,1
Old Dorkinians,Old Tonbridgians II,1,5,6,2.0,1
Old Eastbournians,Fulham Compton Old Boys,4,3,7,4.0,1
Old Eastbournians,KCS Old Boys,1,7,8,0.0,1
Old Eastbournians,Kings College Wimbledon II,2,3,5,4.0,2
Old Eastbournians,Lancing Old Boys II,3,2,5,4.0,2
Old Eastbournians,Mayfield,1,2,3,4.0,1
Old Eastbournians,Old Aldenhamians II,11,10,21,3.75,4
Old Eastbournians,Old Alleynians AFC,4,7,11,4.0,2
Old Eastbournians,Old Alleynians AFC II,1,8,9,1.5,2
Old Eastbournians,Old Alleynians AFC III,7,13,20,3.3333333333333335,3
Old Eastbournians,Old Amplefordians,24,18,42,3.75,8
Old Eastbournians,Old Ardinians,0,7,7,0.0,1
Old Eastbournians,Old Ardinians II,6,5,11,2.5,2
Old Eastbournians,Old Bancroftians AFC,8,9,17,2.75,4
Old Eastbournians,Old Berkhamstedians,6,7,13,2.6666666666666665,3
Old Eastbournians,Old Berkhamstedians II,17,17,34,2.8333333333333335,6
Old Eastbournians,Old Bradfieldians,2,15,17,2.0,3
Old Eastbournians,Old Brentwoods II,11,9,20,2.5,4
Old Eastbournians,Old Brentwoods III,8,5,13,3.25,4
Old Eastbournians,Old Brentwoods IV,1,3,4,3.5,2
Old Eastbournians,Old Cheltonians,1,5,6,2.5,2
Old Eastbournians,Old Chigwellians,0,13,13,1.0,1
Old Eastbournians,Old Chigwellians II,9,10,19,2.75,4
Old Eastbournians,Old Chigwellians III,13,11,24,3.5714285714285716,7
Old Eastbournians,Old Cholmeleians II,1,3,4,3.0,1
Old Eastbournians,Old Cholmeleians III,10,11,21,3.75,4
Old Eastbournians,Old Citizens,11,29,40,2.0,8
Old Eastbournians,Old Columbans,1,9,10,1.0,2
Old Eastbournians,Old Epsomians,12,17,29,3.375,8
Old Eastbournians,Old Etonians II,0,2,2,2.0,1
Old Eastbournians,Old Haberdashers,17,16,33,3.5,6
Old Eastbournians,Old Haileyburians,0,4,4,1.0,1
Old Eastbournians,Old Hamptonians,1,2,3,4.0,1
Old Eastbournians,Old Harrovians II,8,23,31,2.8333333333333335,6
Old Eastbournians,Old Harrovians III,2,6,8,3.0,2
Old Eastbournians,Old Harrovians IV,2,1,3,4.0,1
Old Eastbournians,Old King's Scholars,5,4,9,4.5,2
Old Eastbournians,Old Kingstonians,10,8,18,2.75,4
Old Eastbournians,Old Kingstonians KGS,7,7,14,3.6666666666666665,3
Old Eastbournians,Old Malvernians II,2,6,8,2.5,2
Old Eastbournians,Old Meadonians,2,2,4,3.5,2
Old Eastbournians,Old Merchant Taylors,2,5,7,3.0,2
Old Eastbournians,Old Merchant Taylors II,2,4,6,3.0,1
Old Eastbournians,Old Merchant Taylors' II,2,3,5,4.0,1
Old Eastbournians,Old Oundelians,5,2,7,3.5,2
Old Eastbournians,Old Reptonians,0,8,8,0.0,1
Old Eastbournians,Old Salopians,0,5,5,0.0,1
Old Eastbournians,Old Salopians II,16,25,41,3.7,10
Old Eastbournians,Old Sennockians,8,17,25,3.5,6
Old Eastbournians,Old Shirburnians,1,2,3,4.0,1
Old Eastbournians,Old Stoics,19,21,40,3.6666666666666665,6
Old Eastbournians,Old Suttonians SV,7,15,22,2.0,3
Old Eastbournians,Old Tonbridgians II,2,8,10,2.6666666666666665,3
Old Eastbournians,Old Wellingtonians,1,2,3,4.0,1
Old Eastbournians,Old Westminsters,2,17,19,1.3333333333333333,3
Old Eastbournians,Old Westminsters II,12,27,39,3.25,12
Old Eastbournians,Old Wykehamists,2,6,8,2.0,1
Old Eastbournians,Old Wykehamists II,18,27,45,2.6666666666666665,9
Old Eastbournians,Shene Old Grammarians,1,7,8,2.0,2
Old Edmontonians,Old Aldenhamians,2,4,6,3.0,1
Old Edmontonians,Old Cholmeleians III,3,4,7,4.0,1
Old Epsomians,Clapham Old Xaverians,0,1,1,3.0,1
Old Epsomians,Donnington Wanderers,4,4,8,6.0,1
Old Epsomians,Earlsfield United,2,9,11,0.0,1
Old Epsomians,Economicals III,1,2,3,4.0,1
Old Epsomians,Epsom College 1st XI,14,11,25,4.0,6
Old Epsomians,KCS Old Boys II,5,1,6,3.0,2
Old Epsomians,Kings College Wimbledon II,28,25,53,3.4615384615384617,13
Old Epsomians,Lancing Old Boys II,6,5,11,4.5,2
Old Epsomians,Old Albanians,6,9,15,3.6666666666666665,3
Old Epsomians,Old Albanians SA,5,2,7,2.0,1
Old Epsomians,Old Aldenhamians,2,1,3,4.0,1
Old Epsomians,Old Aldenhamians II,24,20,44,3.375,8
Old Epsomians,Old Alleynians AFC,3,7,10,3.0,2
Old Epsomians,Old Alleynians II,6,10,16,2.6666666666666665,3
Old Epsomians,Old Alleynians III,12,16,28,3.0,7
Old Epsomians,Old Amplefordians,7,5,12,4.0,2
Old Epsomians,Old Ardinians,7,10,17,4.25,4
Old Epsomians,Old Berkhamstedians,9,17,26,3.142857142857143,7
Old Epsomians,Old Bradfieldians,0,10,10,0.0,1
Old Epsomians,Old Brentwoods II,34,25,59,2.1,10
Old Epsomians,Old Brentwoods III,2,5,7,2.0,1
Old Epsomians,Old Brentwoods IV,1,1,2,4.0,1
Old Epsomians,Old Carthusians II,13,21,34,3.1666666666666665,6
Old Epsomians,Old Carthusians III,11,9,20,3.1666666666666665,6
Old Epsomians,Old Chigwellians II,8,20,28,2.8333333333333335,6
Old Epsomians,Old Chigwellians III,6,5,11,2.5,2
Old Epsomians,Old Cholmeleians,2,4,6,3.0,1
Old Epsomians,Old Cholmeleians II,12,4,16,2.3333333333333335,3
Old Epsomians,Old Cholmeleians III,9,7,16,3.75,4
Old Epsomians,Old Citizens,20,21,41,2.3333333333333335,9
Old Epsomians,Old Columbans,8,9,17,1.3333333333333333,3
Old Epsomians,Old Eastbournians,17,12,29,3.375,8
Old Epsomians,Old Epsomians II,2,2,4,5.0,1
Old Epsomians,Old Etonians II,5,3,8,3.5,2
Old Epsomians,Old Foresters II,6,3,9,3.25,4
Old Epsomians,Old Haberdashers,32,17,49,1.875,8
Old Epsomians,Old Harrovians II,33,24,57,2.909090909090909,11
Old Epsomians,Old Johnians FC,7,6,13,3.75,4
Old Epsomians,Old Kimboltonians,3,6,9,3.6666666666666665,3
Old Epsomians,Old King's Scholars,3,4,7,4.0,1
Old Epsomians,Old Malvernians,2,6,8,2.0,1
Old Epsomians,Old Malvernians II,7,5,12,4.0,1
Old Epsomians,Old Merchant Taylors,9,22,31,2.75,8
Old Epsomians,Old Millfieldians,3,5,8,4.0,2
Old Epsomians,Old Radleians,2,11,13,1.0,1
Old Epsomians,Old Rugbeians,7,14,21,2.25,4
Old Epsomians,Old Salopians II,27,12,39,3.2,10
Old Epsomians,Old Sennockians,16,21,37,2.7777777777777777,9
Old Epsomians,Old Shirburnians,12,9,21,3.6666666666666665,6
Old Epsomians,Old Stoics,2,3,5,4.0,1
Old Epsomians,Old Suttonians IV,0,3,3,2.0,1
Old Epsomians,Old Suttonians SV,5,8,13,1.5,2
Old Epsomians,Old Tonbridgians,1,5,6,2.0,1
Old Epsomians,Old Tonbridgians II,21,21,42,3.3636363636363638,11
Old Epsomians,Old Wellingtonians,9,9,18,3.5,4
Old Epsomians,Old Westminsters,1,9,10,0.0,1
Old Epsomians,Old Westminsters II,4,8,12,3.6666666666666665,3
Old Epsomians,Old Whitgiftians,0,0,0,4.0,1
Old Epsomians,Old Wykehamists II,6,6,12,3.0,2
Old Epsomians,UCC Diaspora 1st XI,1,2,3,4.0,1
Old Epsomians II,Epsom College 2nd XI,0,0,0,4.0,1
Old Epsomians II,Kings College Wimbledon III,0,2,2,3.0,2
Old Epsomians II,Old Albanians SA,6,2,8,2.0,1
Old Epsomians II,Old Alleynians AFC II,1,2,3,4.0,1
Old Epsomians II,Old Amplefordians,0,5,5,2.0,2
Old Epsomians II,Old Brentwoods II,4,3,7,1.5,2
Old Epsomians II,Old Epsomians,2,2,4,5.0,1
Old Epsomians II,Old Haberdashers,4,3,7,4.0,1
Old Epsomians II,Old Harrovians III,0,2,2,3.0,2
Old Epsomians II,Old King's Scholars,3,0,3,2.0,1
Old Epsomians II,Old Rugbeians,1,4,5,2.0,1
Old Epsomians II,Old Shirburnians,6,7,13,1.3333333333333333,3
Old Epsomians II,Old Tonbridgians II,0,2,2,2.0,1
Old Epsomians II,Old Westminsters II,2,6,8,2.0,2
Old Epsomians II,Old Wykehamists II,6,1,7,0.0,1
Old Esthameians,Old Rugbeians,4,1,5,2.0,1
Old Etonians,Actonians Association,0,1,1,3.0,1
Old Etonians,Alleyn Old Boys,4,6,10,2.0,2
Old Etonians,Bank of England,2,0,2,2.0,1
Old Etonians,Bealonians,4,4,8,3.0,2
Old Etonians,Eton College 1st XI,26,20,46,3.857142857142857,14
Old Etonians,Honourable Artillery Company,1,4,5,2.0,1
Old Etonians,KCS Old Boys,56,44,100,2.96,25
Old Etonians,Lancing Old Boys,19,21,40,3.3846153846153846,13
Old Etonians,Latymer Old Boys,4,1,5,2.0,1
Old Etonians,Lea Valley,5,1,6,2.0,1
Old Etonians,Old Alleynians,19,22,41,3.3,10
Old Etonians,Old Alleynians AFC,4,6,10,4.0,3
Old Etonians,Old Ardinians,5,1,6,2.0,1
Old Etonians,Old Bradfieldians,28,32,60,3.7142857142857144,14
Old Etonians,Old Brentwoods,43,42,85,3.25,20
Old Etonians,Old Carthusians,26,71,97,3.107142857142857,28
Old Etonians,Old Chigwellians,48,21,69,2.8125,16
Old Etonians,Old Cholmeleians,32,22,54,3.4615384615384617,13
Old Etonians,Old Etonians II,3,0,3,2.0,1
Old Etonians,Old Finchleians,0,1,1,3.0,1
Old Etonians,Old Foresters,43,48,91,3.217391304347826,23
Old Etonians,Old Haberdashers,8,0,8,0.0,1
Old Etonians,Old Harrovians,30,26,56,3.466666666666667,15
Old Etonians,Old Johnians,2,3,5,4.0,1
Old Etonians,Old Kimboltonians,3,1,4,3.0,1
Old Etonians,Old Lyonians,4,2,6,3.0,1
Old Etonians,Old Malvernians,11,4,15,2.6666666666666665,3
Old Etonians,Old Marlburians,17,8,25,2.6666666666666665,6
Old Etonians,Old Meadonians,2,3,5,4.0,1
Old Etonians,Old Merchant Taylors,7,0,7,0.0,1
Old Etonians,Old Minchendenians,5,8,13,4.0,2
Old Etonians,Old Owens,2,3,5,4.0,1
Old Etonians,Old Parmiterians,6,3,9,1.5,2
Old Etonians,Old Pauline,5,0,5,0.0,1
Old Etonians,Old Radleians,7,0,7,1.5,2
Old Etonians,Old Reptonians,7,27,34,1.6666666666666667,6
Old Etonians,Old Salopians,24,23,47,3.5,16
Old Etonians,Old Thorntonians,0,2,2,2.0,1
Old Etonians,Old Tonbridgians,46,44,90,3.130434782608696,23
Old Etonians,Old Westminsters,3,2,5,4.0,1
Old Etonians,Old Wilsonians,4,0,4,2.5,2
Old Etonians,Old Wykehamists,24,20,44,3.5454545454545454,11
Old Etonians,PWC Select XI,5,4,9,4.5,2
Old Etonians,Queen Mary College Old Boys,0,2,2,2.0,1
Old Etonians II,Bealonians,5,0,5,2.0,2
Old Etonians II,Enfield Old Grammarians,9,5,14,3.0,2
Old Etonians II,Eton College 2nd XI,9,17,26,3.2,10
Old Etonians II,Glyn Old Boys,0,1,1,3.0,1
Old Etonians II,Glynn Old Boys II,1,0,1,3.0,1
Old Etonians II,Kings College Wimbledon II,22,21,43,2.5454545454545454,11
Old Etonians II,Lancing Old Boys,11,5,16,3.0,3
Old Etonians II,Lancing Old Boys II,17,14,31,2.8,10
Old Etonians II,Old Albanians,8,6,14,4.5,2
Old Etonians II,Old Aldenhamians,36,11,47,2.6363636363636362,11
Old Etonians II,Old Aldenhamians II,4,4,8,4.0,2
Old Etonians II,Old Alleynians AFC,1,7,8,2.0,2
Old Etonians II,Old Alleynians II,28,14,42,2.5555555555555554,9
Old Etonians II,Old Alleynians III,9,0,9,0.0,1
Old Etonians II,Old Ardinians,4,10,14,3.25,4
Old Etonians II,Old Bancroftians AFC,6,0,6,0.0,1
Old Etonians II,Old Berkhamstedians,21,22,43,3.2,10
Old Etonians II,Old Blues,7,0,7,0.0,1
Old Etonians II,Old Brentwoods II,10,4,14,3.2,5
Old Etonians II,Old Carthusians II,34,33,67,3.125,16
Old Etonians II,Old Carthusians III,6,27,33,2.0,9
Old Etonians II,Old Cheltonians,2,0,2,2.0,1
Old Etonians II,Old Chigwellians II,34,30,64,3.357142857142857,14
Old Etonians II,Old Cholmeleians II,31,14,45,2.3333333333333335,9
Old Etonians II,Old Cholmeleians III,5,2,7,3.0,2
Old Etonians II,Old Citizens,9,2,11,2.3333333333333335,3
Old Etonians II,Old Columbans,1,1,2,4.0,1
Old Etonians II,Old Eastbournians,2,0,2,2.0,1
Old Etonians II,Old Epsomians,3,5,8,3.5,2
Old Etonians II,Old Etonians,0,3,3,2.0,1
Old Etonians II,Old Foresters II,41,19,60,2.9375,16
Old Etonians II,Old Haberdashers,2,5,7,3.5,2
Old Etonians II,Old Haileyburians,9,1,10,0.0,1
Old Etonians II,Old Harrovians II,54,35,89,3.3333333333333335,18
Old Etonians II,Old Johnians,7,9,16,3.25,4
Old Etonians II,Old Kimboltonians,19,18,37,3.7142857142857144,7
Old Etonians II,Old King's Scholars,3,0,3,2.5,2
Old Etonians II,Old Malvernians,10,2,12,1.0,2
Old Etonians II,Old Marlburians,4,9,13,2.5,2
Old Etonians II,Old Merchant Taylors,17,5,22,2.857142857142857,7
Old Etonians II,Old Merchant Taylors',10,1,11,1.0,2
Old Etonians II,Old Millfieldians,4,9,13,3.0,3
Old Etonians II,Old Minchendenians II,3,1,4,3.0,1
Old Etonians II,Old Owens,6,4,10,3.0,2
Old Etonians II,Old Owens II,1,4,5,2.0,1
Old Etonians II,Old Parmiterians,0,2,2,2.0,1
Old Etonians II,Old Radleians,28,23,51,2.7777777777777777,9
Old Etonians II,Old Rugbeians,2,4,6,3.6666666666666665,3
Old Etonians II,Old Salopians II,9,2,11,1.5,2
Old Etonians II,Old Sennockians,24,11,35,2.7777777777777777,9
Old Etonians II,Old Shirburnians,4,2,6,3.0,1
Old Etonians II,Old Suttonians,1,0,1,3.0,1
Old Etonians II,Old Suttonians II,0,2,2,2.0,1
Old Etonians II,Old Tenisonians,4,0,4,2.5,2
Old Etonians II,Old Tonbridgians II,6,3,9,3.5,2
Old Etonians II,Old Wellingtonians,5,1,6,1.5,2
Old Etonians II,Old Westminsters,19,35,54,3.5454545454545454,11
Old Etonians II,Old Wilsonians,1,4,5,2.0,1
Old Etonians II,Old Wykehamists II,13,4,17,2.5,4
Old Etonians II,Southgate County II,8,6,14,4.0,1
Old Etonians Vets,Eton College 3rd XI,3,5,8,4.0,1
Old Etonians Vets,KCS Old Boys Vets,1,4,5,3.3333333333333335,3
Old Etonians Vets,Lancing Old Boys Vets,13,4,17,2.3333333333333335,3
Old Etonians Vets,Old Aldenhamians Vets,5,0,5,0.0,1
Old Etonians Vets,Old Berkhamstedians Vets,1,1,2,3.0,2
Old Etonians Vets,Old Bradfieldians Vets,4,1,5,3.0,2
Old Etonians Vets,Old Carthusians Vets,1,0,1,3.0,1
Old Etonians Vets,Old Chigwellians Vets,9,4,13,3.25,4
Old Etonians Vets,Old Cholmeleians Vets,8,4,12,3.6666666666666665,3
Old Etonians Vets,Old Finchleians Vets,3,1,4,3.0,1
Old Etonians Vets,Old Foresters Vets,9,6,15,2.6666666666666665,3
Old Etonians Vets,Old Haileyburians Vets,6,0,6,0.0,1
Old Etonians Vets,Old Harrovians Vets,15,4,19,2.6666666666666665,3
Old Etonians Vets,Old Ignatian Vets,3,0,3,2.0,1
Old Etonians Vets,Old Kimboltonians Vets,6,1,7,0.0,1
Old Etonians Vets,Old Malvernians Vets,4,5,9,4.0,3
Old Etonians Vets,Old Reptonians Vets,5,5,10,0.0,2
Old Etonians Vets,Old Tonbridgians Vets,5,3,8,3.5,2
Old Etonians Vets,Old Wykehamists Vets,15,3,18,1.75,4
Old Etonians Vets,Queen Mary College Old Boys,0,5,5,0.0,1
Old Felstedians,Old Brentwoods IV,2,4,6,3.0,1
Old Felstedians,Old Kingstonians,0,9,9,0.0,1
Old Finchleians,Old Bancroftians AFC,3,0,3,2.0,1
Old Finchleians,Old Brentwoods,4,6,10,4.0,1
Old Finchleians,Old Brentwoods III,1,3,4,3.0,1
Old Finchleians,Old Brentwoods Vets,5,3,8,1.0,2
Old Finchleians,Old Carthusians,3,9,12,0.0,1
Old Finchleians,Old Chigwellians,7,2,9,2.5,2
Old Finchleians,Old Chigwellians II,3,2,5,4.0,1
Old Finchleians,Old Etonians,1,0,1,3.0,1
Old Finchleians,Old Foresters II,6,5,11,5.0,1
Old Finchleians,Old King's Scholars,7,2,9,2.5,2
Old Finchleians,Old Merchant Taylors,3,5,8,4.0,1
Old Finchleians II,Old Brentwoods II,1,3,4,3.0,1
Old Finchleians Vets,Old Etonians Vets,1,3,4,3.0,1
Old Foresters,Albanian FC,3,1,4,3.0,1
Old Foresters,Altis,2,2,4,5.0,1
Old Foresters,Bealonians,2,2,4,3.5,2
Old Foresters,Broomfield FC,6,1,7,0.0,1
Old Foresters,Cambridge Heath,2,1,3,4.0,1
Old Foresters,Chelmsford City Reserves,1,2,3,4.0,1
Old Foresters,Chingford Athletic,8,5,13,2.0,2
Old Foresters,Civil Service,1,3,4,3.0,1
Old Foresters,Earls Colne,3,5,8,4.0,1
Old Foresters,Enfield Old Grammarians,2,1,3,4.0,1
Old Foresters,Forest School 1st XI,18,3,21,2.5,6
Old Foresters,Gas Recreation FC,1,3,4,3.0,1
Old Foresters,Globe Rangers,13,3,16,0.0,2
Old Foresters,Hedinghams United,6,1,7,0.0,1
Old Foresters,Hullbridge Sports Saturday Reserves,1,2,3,4.0,1
Old Foresters,Icarus,3,1,4,3.0,1
Old Foresters,KCS Old Boys,51,43,94,3.4761904761904763,21
Old Foresters,Lancing Old Boys,52,21,73,2.75,20
Old Foresters,Latymer Old Boys,4,1,5,2.0,1
Old Foresters,NUFC Oilers,1,4,5,2.0,2
Old Foresters,Norsemen,13,2,15,0.0,2
Old Foresters,Old Aldenhamians,9,1,10,1.5,2
Old Foresters,Old Alleynians,18,18,36,2.857142857142857,7
Old Foresters,Old Alleynians AFC,5,3,8,3.5,2
Old Foresters,Old Ardinians,4,2,6,3.0,1
Old Foresters,Old Bancroftians,10,0,10,0.0,1
Old Foresters,Old Berkhamstedians,7,4,11,3.5,2
Old Foresters,Old Bradfieldians,31,43,74,2.8333333333333335,12
Old Foresters,Old Brentwoods,48,34,82,2.7,20
Old Foresters,Old Carthusians,32,83,115,2.7777777777777777,27
Old Foresters,Old Chigwellians,34,27,61,3.6470588235294117,17
Old Foresters,Old Cholmeleians,26,13,39,2.4,10
Old Foresters,Old Dorkinians,0,3,3,2.0,1
Old Foresters,Old Etonians,48,43,91,3.217391304347826,23
Old Foresters,Old Foresters II,1,0,1,3.0,1
Old Foresters,Old Garchonians,2,0,2,2.0,1
Old Foresters,Old Hamptonians,4,11,15,2.0,2
Old Foresters,Old Harrovians,45,21,66,2.7857142857142856,14
Old Foresters,Old Ignatian,2,0,2,2.0,1
Old Foresters,Old Johnians,11,16,27,1.75,4
Old Foresters,Old King's Scholars,0,1,1,3.0,1
Old Foresters,Old Kingsburians,7,1,8,0.0,1
Old Foresters,Old Malvernians,24,2,26,0.0,3
Old Foresters,Old Manorians,2,3,5,4.0,1
Old Foresters,Old Marlburians,27,5,32,2.5,10
Old Foresters,Old Meadonians,4,6,10,4.0,2
Old Foresters,Old Owens,1,3,4,3.0,1
Old Foresters,Old Parkonians,7,5,12,3.0,2
Old Foresters,Old Radleians,4,1,5,2.0,1
Old Foresters,Old Reptonians,10,10,20,3.8,5
Old Foresters,Old Rugbeians,8,3,11,3.0,3
Old Foresters,Old Salesians,0,2,2,2.0,1
Old Foresters,Old Salopians,44,19,63,3.176470588235294,17
Old Foresters,Old Suttonians,2,3,5,4.0,1
Old Foresters,Old Tonbridgians,38,33,71,3.0,19
Old Foresters,Old Westminsters,5,2,7,3.0,2
Old Foresters,Old Wokingians,2,1,3,4.0,1
Old Foresters,Old Wykehamists,18,12,30,3.0,9
Old Foresters,Polytechnic,1,3,4,3.0,1
Old Foresters,Southgate County,1,0,1,3.0,1
Old Foresters,Spaniards,6,0,6,0.0,1
Old Foresters,Toby Football Club,1,4,5,2.0,1
Old Foresters,Wake Green Amateur,7,0,7,0.0,1
Old Foresters,Waltham Abbey,0,3,3,2.0,1
Old Foresters,Worcester College Old Boys,4,1,5,2.0,1
Old Foresters II,Albanian FC,1,6,7,0.0,1
Old Foresters II,Broomfield FC,7,7,14,6.0,1
Old Foresters II,Forest School 1st XI,6,12,18,3.3333333333333335,3
Old Foresters II,Forest School 2nd XI,2,2,4,4.333333333333333,3
Old Foresters II,Hale End Athletic,3,2,5,4.0,1
Old Foresters II,Kings College Wimbledon II,34,25,59,3.1818181818181817,11
Old Foresters II,Lancing Old Boys II,10,18,28,2.6,10
Old Foresters II,Mill Hill Village,3,0,3,2.0,1
Old Foresters II,Old Aldenhamians,5,5,10,5.0,2
Old Foresters II,Old Aldenhamians II,3,6,9,3.6666666666666665,3
Old Foresters II,Old Alleynians AFC,4,6,10,4.0,3
Old Foresters II,Old Alleynians II,2,3,5,4.0,1
Old Foresters II,Old Ardinians,7,2,9,0.0,1
Old Foresters II,Old Berkhamstedians,14,14,28,2.5,6
Old Foresters II,Old Brentwoods II,12,14,26,2.8,5
Old Foresters II,Old Carthusians,0,1,1,3.0,1
Old Foresters II,Old Carthusians II,13,30,43,2.6153846153846154,13
Old Foresters II,Old Carthusians III,21,25,46,3.272727272727273,11
Old Foresters II,Old Chigwellians II,6,12,18,3.5,8
Old Foresters II,Old Cholmeleians II,18,12,30,2.0,4
Old Foresters II,Old Cholmeleians III,3,1,4,3.0,2
Old Foresters II,Old Citizens,9,11,20,3.6666666666666665,3
Old Foresters II,Old Columbans,3,3,6,4.0,2
Old Foresters II,Old Epsomians,3,6,9,3.25,4
Old Foresters II,Old Etonians II,19,41,60,2.9375,16
Old Foresters II,Old Finchleians,5,6,11,5.0,1
Old Foresters II,Old Foresters,0,1,1,3.0,1
Old Foresters II,Old Garchonians,0,4,4,1.0,1
Old Foresters II,Old Haberdashers,4,1,5,3.0,2
Old Foresters II,Old Haileyburians,10,4,14,2.5,2
Old Foresters II,Old Harrovians,1,0,1,3.0,1
Old Foresters II,Old Harrovians II,20,19,39,3.2222222222222223,9
Old Foresters II,Old Kimboltonians,1,4,5,2.0,1
Old Foresters II,Old King's Scholars,7,7,14,5.5,2
Old Foresters II,Old Manorians,3,5,8,4.0,1
Old Foresters II,Old Marlburians,2,6,8,3.3333333333333335,3
Old Foresters II,Old Merchant Taylors,5,11,16,3.0,4
Old Foresters II,Old Millfieldians,10,14,24,4.0,3
Old Foresters II,Old Radleians,6,2,8,3.0,2
Old Foresters II,Old Reptonians,2,1,3,4.0,1
Old Foresters II,Old Rugbeians,2,9,11,2.0,2
Old Foresters II,Old Salvatorians,3,1,4,3.0,1
Old Foresters II,Old Sennockians,4,7,11,2.3333333333333335,3
Old Foresters II,Old Suttonians,0,5,5,0.0,1
Old Foresters II,Old Suttonians SV,2,2,4,5.0,1
Old Foresters II,Old Tonbridgians II,2,2,4,3.5,2
Old Foresters II,Old Wellingtonians,1,3,4,3.5,2
Old Foresters II,Old Westminsters,18,18,36,3.6666666666666665,9
Old Foresters II,Old Wykehamists II,12,6,18,3.8,5
Old Foresters III,Bealonians,3,5,8,4.0,1
Old Foresters III,Forest School 3rd XI,5,1,6,2.0,1
Old Foresters III,Kings College Wimbledon III,4,2,6,3.5,2
Old Foresters III,Old Albanians SA,5,6,11,3.0,3
Old Foresters III,Old Alleynians AFC,2,17,19,1.3333333333333333,3
Old Foresters III,Old Alleynians AFC II,0,6,6,0.0,1
Old Foresters III,Old Amplefordians,3,14,17,2.3333333333333335,3
Old Foresters III,Old Bancroftians AFC,7,8,15,2.25,4
Old Foresters III,Old Brentwoods II,5,15,20,3.0,5
Old Foresters III,Old Brentwoods III,26,29,55,2.909090909090909,11
Old Foresters III,Old Brentwoods IV,10,16,26,2.6666666666666665,6
Old Foresters III,Old Chigwellians III,15,14,29,3.0,7
Old Foresters III,Old Chigwellians IV,7,3,10,2.0,2
Old Foresters III,Old Cholmeleians II,6,10,16,2.75,4
Old Foresters III,Old Cholmeleians III,13,6,19,3.6666666666666665,3
Old Foresters III,Old Cholmeleians IV,27,19,46,2.4444444444444446,9
Old Foresters III,Old Citizens,1,14,15,1.0,2
Old Foresters III,Old Columbans,1,6,7,2.5,2
Old Foresters III,Old Foresters IV,3,4,7,4.5,2
Old Foresters III,Old Haberdashers,0,1,1,3.0,1
Old Foresters III,Old Harrovians III,17,18,35,4.142857142857143,7
Old Foresters III,Old Kimboltonians,3,13,16,2.0,3
Old Foresters III,Old Malvernians II,3,11,14,2.0,2
Old Foresters III,Old Merchant Taylors,7,18,25,2.8,5
Old Foresters III,Old Merchant Taylors II,12,13,25,2.8,5
Old Foresters III,Old Millhillians,5,12,17,2.0,3
Old Foresters III,Old Parkonians,0,13,13,1.0,1
Old Foresters III,Old Rugbeians,1,9,10,2.0,2
Old Foresters III,Old Sennockians,3,13,16,2.0,3
Old Foresters III,Old Westminsters II,5,7,12,3.3333333333333335,3
Old Foresters III,UCL Academicals IV,1,9,10,0.0,1
Old Foresters IV,Old Brentwoods III,4,6,10,4.0,2
Old Foresters IV,Old Brentwoods IV,4,9,13,2.5,2
Old Foresters IV,Old Chigwellians IV,3,1,4,3.5,2
Old Foresters IV,Old Cholmeleians IV,6,3,9,3.5,2
Old Foresters IV,Old Citizens,2,11,13,1.0,2
Old Foresters IV,Old Foresters III,4,3,7,4.5,2
Old Foresters IV,Old Malvernians II,0,9,9,0.0,1
Old Foresters Vets,Albanian Vets,6,2,8,2.0,1
Old Foresters Vets,Enfield Old Grammarians,8,1,9,0.0,1
Old Foresters Vets,KCS Old Boys Vets,1,4,5,2.0,1
Old Foresters Vets,Lancing Old Boys Vets,9,5,14,3.6666666666666665,3
Old Foresters Vets,Old Aldenhamians Vets,15,12,27,0.6666666666666666,3
Old Foresters Vets,Old Bradfieldians Vets,2,0,2,2.0,1
Old Foresters Vets,Old Brentwoods Vets,9,9,18,4.75,4
Old Foresters Vets,Old Carthusians Vets,11,5,16,3.0,3
Old Foresters Vets,Old Chigwellians Veterans,2,0,2,2.0,1
Old Foresters Vets,Old Chigwellians Vets,2,3,5,3.0,2
Old Foresters Vets,Old Chigwellians Vets Blues,10,7,17,3.3333333333333335,3
Old Foresters Vets,Old Cholmeleians Vets,16,10,26,3.5,4
Old Foresters Vets,Old Etonians Vets,6,9,15,2.6666666666666665,3
Old Foresters Vets,Old Haileyburians Vets,7,3,10,3.0,2
Old Foresters Vets,Old Harrovians Vets,5,3,8,3.0,2
Old Foresters Vets,Old Ignatians,3,1,4,3.0,1
Old Foresters Vets,Old Kimboltonians Vets,1,0,1,3.0,1
Old Foresters Vets,Old Malvernians Vets,17,10,27,2.75,4
Old Foresters Vets,Old Owens,6,1,7,0.0,1
Old Foresters Vets,Old Salopians Vets,4,4,8,1.0,2
Old Foresters Vets,Old Westminsters Vets,4,1,5,2.0,1
Old Foresters Vets,Old Wykehamists Vets,0,1,1,3.0,1
Old Garchonians,Old Brentwoods,4,1,5,2.0,1
Old Garchonians,Old Carthusians II,0,1,1,3.0,1
Old Garchonians,Old Cholmeleians,3,0,3,2.0,1
Old Garchonians,Old Foresters,0,2,2,2.0,1
Old Garchonians,Old Foresters II,4,0,4,1.0,1
Old Garchonians,Old Haileyburians,8,2,10,0.0,1
Old Gregorians,Old Alleynians AFC III,3,10,13,1.0,1
Old Gregorians,Old Kingstonians KGS,5,3,8,4.0,1
Old Gregorians,TBC,3,3,6,5.0,1
Old Haberdashers,Actonians Association VII,3,4,7,4.0,1
Old Haberdashers,Actonians Association VIII,11,1,12,0.0,1
Old Haberdashers,Albanian V,4,0,4,1.0,1
Old Haberdashers,Bank of England,0,1,1,3.0,1
Old Haberdashers,East Barnet Old Grammarians IV,6,3,9,3.0,1
Old Haberdashers,Haberdashers Aske School 1st XI,12,20,32,2.7142857142857144,7
Old Haberdashers,Inter London,9,4,13,1.0,1
Old Haberdashers,KCS Old Boys II,6,4,10,3.0,2
Old Haberdashers,Kings College Wimbledon II,3,11,14,1.5,2
Old Haberdashers,Lancing Old Boys II,7,14,21,2.8333333333333335,6
Old Haberdashers,Old Albanians SA,6,12,18,3.0,4
Old Haberdashers,Old Aldenhamians II,12,9,21,3.5,4
Old Haberdashers,Old Alleynians AFC II,4,17,21,0.0,2
Old Haberdashers,Old Alleynians III,3,4,7,3.5,2
Old Haberdashers,Old Amplefordians,19,10,29,2.4,5
Old Haberdashers,Old Ardinians,2,10,12,0.0,1
Old Haberdashers,Old Ardinians II,6,3,9,3.0,1
Old Haberdashers,Old Bancroftians,8,3,11,1.5,2
Old Haberdashers,Old Bancroftians AFC,9,8,17,3.0,4
Old Haberdashers,Old Berkhamstedians,0,3,3,2.0,1
Old Haberdashers,Old Berkhamstedians II,15,12,27,3.5,6
Old Haberdashers,Old Bradfieldians,1,2,3,4.0,1
Old Haberdashers,Old Brentwoods II,11,23,34,3.0,5
Old Haberdashers,Old Brentwoods III,30,23,53,2.375,8
Old Haberdashers,Old Brentwoods IV,19,5,24,2.5,4
Old Haberdashers,Old Carthusians II,16,26,42,2.2857142857142856,7
Old Haberdashers,Old Carthusians III,8,26,34,2.3333333333333335,6
Old Haberdashers,Old Cheltonians,6,3,9,3.3333333333333335,3
Old Haberdashers,Old Chigwellians II,16,27,43,3.2,10
Old Haberdashers,Old Cholmeleians II,25,26,51,3.3636363636363638,11
Old Haberdashers,Old Citizens,5,17,22,3.0,3
Old Haberdashers,Old Columbans,4,12,16,1.5,2
Old Haberdashers,Old Eastbournians,16,17,33,3.5,6
Old Haberdashers,Old Epsomians,17,32,49,1.875,8
Old Haberdashers,Old Epsomians II,3,4,7,4.0,1
Old Haberdashers,Old Etonians,0,8,8,0.0,1
Old Haberdashers,Old Etonians II,5,2,7,3.5,2
Old Haberdashers,Old Foresters II,1,4,5,3.0,2
Old Haberdashers,Old Foresters III,1,0,1,3.0,1
Old Haberdashers,Old Haileyburians,1,5,6,2.0,1
Old Haberdashers,Old Harrovians II,16,10,26,3.2,5
Old Haberdashers,Old Harrovians III,12,19,31,1.2,5
Old Haberdashers,Old Kimboltonians,1,2,3,4.0,1
Old Haberdashers,Old King's Scholars,11,9,20,2.5,4
Old Haberdashers,Old Marlburians,1,9,10,2.0,2
Old Haberdashers,Old Meadonians VI,8,4,12,2.0,1
Old Haberdashers,Old Merchant Taylors,10,24,34,2.8333333333333335,6
Old Haberdashers,Old Merchant Taylors II,14,12,26,2.2,5
Old Haberdashers,Old Merchant Taylors' II,5,3,8,3.0,2
Old Haberdashers,Old Oundelians,4,5,9,5.0,1
Old Haberdashers,Old Parkonians,6,1,7,0.0,1
Old Haberdashers,Old Reptonians,6,9,15,4.0,2
Old Haberdashers,Old Salopians II,20,26,46,3.0,9
Old Haberdashers,Old Sennockians,12,23,35,2.7142857142857144,7
Old Haberdashers,Old Shirburnians,8,6,14,3.6666666666666665,3
Old Haberdashers,Old Stoics,17,18,35,2.857142857142857,7
Old Haberdashers,Old Suttonians SV,28,26,54,3.2857142857142856,7
Old Haberdashers,Old Tonbridgians II,11,11,22,2.75,4
Old Haberdashers,Old Vaughanians,7,3,10,2.0,1
Old Haberdashers,Old Wellingtonians,28,21,49,2.5,8
Old Haberdashers,Old Westminsters II,4,5,9,3.0,3
Old Haberdashers,Old Wykehamists II,5,5,10,2.0,2
Old Haberdashers,Pembroke Old Boys,7,0,7,0.0,1
Old Haberdashers,Polytechnic 2s,0,4,4,1.0,1
Old Haberdashers,Royal Bank of Scotland,4,6,10,4.0,1
Old Haberdashers,West Wickham,3,3,6,5.0,1
Old Haileyburians,Haileybury College,7,6,13,3.5,2
Old Haileyburians,KCS Old Boys,3,12,15,1.0,2
Old Haileyburians,Kings College Wimbledon II,3,4,7,4.0,1
Old Haileyburians,Lancing Old Boys II,0,0,0,4.0,1
Old Haileyburians,Old Aldenhamians,14,33,47,2.5555555555555554,9
Old Haileyburians,Old Berkhamstedians,2,22,24,0.5,2
Old Haileyburians,Old Boilers FC,0,5,5,0.0,1
Old Haileyburians,Old Bradfieldians,17,23,40,2.875,8
Old Haileyburians,Old Brentwoods,2,16,18,2.0,2
Old Haileyburians,Old Carthusians,1,5,6,2.0,1
Old Haileyburians,Old Carthusians II,1,4,5,2.0,1
Old Haileyburians,Old Carthusians III,0,11,11,0.0,1
Old Haileyburians,Old Chigwellians,3,6,9,3.5,2
Old Haileyburians,Old Cholmeleians,3,2,5,4.0,1
Old Haileyburians,Old Eastbournians,4,0,4,1.0,1
Old Haileyburians,Old Etonians II,1,9,10,0.0,1
Old Haileyburians,Old Foresters II,4,10,14,2.5,2
Old Haileyburians,Old Garchonians,2,8,10,0.0,1
Old Haileyburians,Old Haberdashers,5,1,6,2.0,1
Old Haileyburians,Old Harrovians,1,11,12,1.5,2
Old Haileyburians,Old King's Scholars,12,8,20,3.5,4
Old Haileyburians,Old Malvernians,15,8,23,3.5,6
Old Haileyburians,Old Marlburians,2,15,17,1.5,2
Old Haileyburians,Old Radleians,19,25,44,2.75,8
Old Haileyburians,Old Reptonians,10,18,28,3.0,7
Old Haileyburians,Old Salopians,1,11,12,1.0,2
Old Haileyburians,Old Sennockians,1,8,9,2.0,2
Old Haileyburians,Old Tonbridgians,5,6,11,4.5,2
Old Haileyburians,Old Wellingtonians,2,16,18,1.0,2
Old Haileyburians,Old Westminsters,14,28,42,2.4444444444444446,9
Old Haileyburians,Old Wykehamists,13,27,40,2.75,8
Old Haileyburians,Putney Ferrets,3,1,4,3.0,1
Old Haileyburians Vets,Old Bradfieldians Vets,0,1,1,3.0,1
Old Haileyburians Vets,Old Brentwoods Vets,8,7,15,2.0,3
Old Haileyburians Vets,Old Chigwellians Vets,2,2,4,5.0,1
Old Haileyburians Vets,Old Cholmeleians Vets,8,8,16,6.0,2
Old Haileyburians Vets,Old Etonians Vets,0,6,6,0.0,1
Old Haileyburians Vets,Old Foresters Vets,3,7,10,3.0,2
Old Haileyburians Vets,Old Lyonians,3,1,4,3.0,1
Old Haileyburians Vets,Old Wellingtonians Vets,8,8,16,0.0,2
Old Haileyburians Vets,Old Westminsters Vets,5,3,8,4.0,1
Old Haileyburians Vets,Old Wykehamists Veterans,3,3,6,4.0,2
Old Hamptonians,Lancing Old Boys,5,2,7,2.0,1
Old Hamptonians,Old Aldenhamians,1,2,3,4.0,1
Old Hamptonians,Old Alleynians,7,1,8,2.0,2
Old Hamptonians,Old Alleynians AFC,2,1,3,4.0,1
Old Hamptonians,Old Carthusians,5,11,16,3.5,4
Old Hamptonians,Old Carthusians II,5,4,9,5.0,1
Old Hamptonians,Old Chigwellians,8,0,8,0.0,1
Old Hamptonians,Old Cholmeleians II,2,1,3,4.0,1
Old Hamptonians,Old Eastbournians,2,1,3,4.0,1
Old Hamptonians,Old Foresters,11,4,15,2.0,2
Old Hamptonians,Old Sennockians,1,3,4,3.0,1
Old Harrovians,Harrow School 1st XI,15,8,23,3.625,8
Old Harrovians,KCS Old Boys,21,29,50,2.933333333333333,15
Old Harrovians,Lancing Old Boys,24,44,68,2.357142857142857,14
Old Harrovians,Old Aldenhamians,22,5,27,1.8333333333333333,6
Old Harrovians,Old Alleynians,5,24,29,2.0,4
Old Harrovians,Old Alleynians AFC,15,26,41,3.2857142857142856,7
Old Harrovians,Old Ardinians,6,8,14,2.5,2
Old Harrovians,Old Berkhamstedians,22,19,41,3.8333333333333335,6
Old Harrovians,Old Bradfieldians,22,43,65,1.8,10
Old Harrovians,Old Brentwoods,36,35,71,2.6875,16
Old Harrovians,Old Carthusians,14,78,92,1.7333333333333334,15
Old Harrovians,Old Chigwellians,25,24,49,3.090909090909091,11
Old Harrovians,Old Cholmeleians,21,24,45,3.4545454545454546,11
Old Harrovians,Old Etonians,26,30,56,3.466666666666667,15
Old Harrovians,Old Foresters,21,45,66,2.7857142857142856,14
Old Harrovians,Old Foresters II,0,1,1,3.0,1
Old Harrovians,Old Haileyburians,11,1,12,1.5,2
Old Harrovians,Old Johnians,8,17,25,2.75,4
Old Harrovians,Old Kimboltonians,0,7,7,0.0,1
Old Harrovians,Old Malvernians,36,19,55,2.727272727272727,11
Old Harrovians,Old Marlburians,31,30,61,2.5384615384615383,13
Old Harrovians,Old Radleians,14,15,29,3.375,8
Old Harrovians,Old Reptonians,15,17,32,2.5,8
Old Harrovians,Old Rugbeians,19,17,36,4.2,5
Old Harrovians,Old Salopians,20,38,58,3.2857142857142856,14
Old Harrovians,Old Shirburnians,1,5,6,2.0,1
Old Harrovians,Old Stoics,13,3,16,1.0,2
Old Harrovians,Old Tonbridgians,26,36,62,3.0714285714285716,14
Old Harrovians,Old Wellingtonians,16,1,17,1.5,4
Old Harrovians,Old Westminsters,9,9,18,2.6,5
Old Harrovians,Old Wykehamists,20,34,54,2.4444444444444446,9
Old Harrovians II,East Barnet Old Grammarians,3,0,3,2.0,1
Old Harrovians II,Harrow School 2nd XI,13,8,21,3.888888888888889,9
Old Harrovians II,KCS Old Boys II,1,4,5,3.0,2
Old Harrovians II,Kings College Wimbledon II,27,25,52,3.6923076923076925,13
Old Harrovians II,Lancing Old Boys II,11,15,26,3.6666666666666665,6
Old Harrovians II,Old Albanians,2,3,5,4.0,1
Old Harrovians II,Old Aldenhamians,17,15,32,3.857142857142857,7
Old Harrovians II,Old Aldenhamians II,13,12,25,1.6666666666666667,6
Old Harrovians II,Old Alleynians AFC,12,16,28,3.1666666666666665,6
Old Harrovians II,Old Alleynians AFC II,2,1,3,4.0,1
Old Harrovians II,Old Alleynians II,4,12,16,1.25,4
Old Harrovians II,Old Alleynians III,4,5,9,4.333333333333333,3
Old Harrovians II,Old Berkhamstedians,9,19,28,2.6,5
Old Harrovians II,Old Berkhamstedians II,2,1,3,4.0,2
Old Harrovians II,Old Brentwoods II,32,33,65,2.6363636363636362,11
Old Harrovians II,Old Brentwoods III,14,10,24,3.0,3
Old Harrovians II,Old Brentwoods IV,5,3,8,4.0,1
Old Harrovians II,Old Carthusians II,21,31,52,3.230769230769231,13
Old Harrovians II,Old Carthusians III,2,3,5,4.0,2
Old Harrovians II,Old Chigwellians II,30,19,49,3.25,12
Old Harrovians II,Old Cholmeleians II,3,6,9,1.5,2
Old Harrovians II,Old Cholmeleians III,5,6,11,2.0,2
Old Harrovians II,Old Citizens,23,31,54,2.111111111111111,9
Old Harrovians II,Old Columbans,0,1,1,3.0,1
Old Harrovians II,Old Eastbournians,23,8,31,2.8333333333333335,6
Old Harrovians II,Old Epsomians,24,33,57,2.909090909090909,11
Old Harrovians II,Old Etonians II,35,54,89,3.3333333333333335,18
Old Harrovians II,Old Foresters II,19,20,39,3.2222222222222223,9
Old Harrovians II,Old Haberdashers,10,16,26,3.2,5
Old Harrovians II,Old Harrovians Select XI,4,4,8,6.0,1
Old Harrovians II,Old Johnians,8,15,23,3.0,3
Old Harrovians II,Old Kimboltonians,2,9,11,2.3333333333333335,3
Old Harrovians II,Old Malvernians,7,5,12,4.5,2
Old Harrovians II,Old Malvernians II,5,0,5,0.0,1
Old Harrovians II,Old Marlburians,2,6,8,3.0,2
Old Harrovians II,Old Merchant Taylors,24,19,43,3.2222222222222223,9
Old Harrovians II,Old Merchant Taylors',4,2,6,3.0,2
Old Harrovians II,Old Millfieldians,6,19,25,2.5,4
Old Harrovians II,Old Minchendenians,3,4,7,4.0,1
Old Harrovians II,Old Parkonians,1,2,3,4.0,1
Old Harrovians II,Old Radleians,14,23,37,3.625,8
Old Harrovians II,Old Rugbeians,4,4,8,3.0,2
Old Harrovians II,Old Rugbeians II,9,0,9,0.0,1
Old Harrovians II,Old Salopians II,14,5,19,2.8333333333333335,6
Old Harrovians II,Old Sennockians,30,20,50,3.4166666666666665,12
Old Harrovians II,Old Shirburnians,8,5,13,3.0,2
Old Harrovians II,Old Stoics,8,2,10,2.0,2
Old Harrovians II,Old Suttonians SV,5,1,6,2.0,1
Old Harrovians II,Old Westminsters,4,16,20,2.2,5
Old Harrovians II,Old Westminsters II,13,5,18,2.6666666666666665,3
Old Harrovians II,Old Wykehamists II,11,8,19,3.25,4
Old Harrovians III,Harrow School 3rd XI,9,8,17,4.285714285714286,7
Old Harrovians III,KCS Old Boys II,2,3,5,4.0,1
Old Harrovians III,Kings College Wimbledon III,12,8,20,2.0,4
Old Harrovians III,Lancing Old Boys II,11,7,18,3.6,5
Old Harrovians III,Old Albanians SA,6,14,20,2.6666666666666665,3
Old Harrovians III,Old Alleynians AFC II,19,16,35,2.1666666666666665,6
Old Harrovians III,Old Alleynians AFC III,6,10,16,3.5,2
Old Harrovians III,Old Amplefordians,18,28,46,2.3636363636363638,11
Old Harrovians III,Old Ardinians,1,12,13,0.0,2
Old Harrovians III,Old Ardinians II,5,4,9,3.5,2
Old Harrovians III,Old Bancroftians AFC,19,18,37,2.7,10
Old Harrovians III,Old Berkhamstedians II,5,14,19,3.0,5
Old Harrovians III,Old Brentwoods II,4,6,10,4.0,3
Old Harrovians III,Old Brentwoods III,23,29,52,2.2222222222222223,9
Old Harrovians III,Old Brentwoods IV,7,14,21,3.0,4
Old Harrovians III,Old Canfordians,2,1,3,4.0,1
Old Harrovians III,Old Cheltonians,5,4,9,4.5,2
Old Harrovians III,Old Cholmeleians II,0,12,12,0.0,1
Old Harrovians III,Old Cholmeleians III,1,3,4,3.0,1
Old Harrovians III,Old Cholmeleians IV,19,15,34,2.6666666666666665,6
Old Harrovians III,Old Columbans,5,3,8,3.3333333333333335,3
Old Harrovians III,Old Eastbournians,6,2,8,3.0,2
Old Harrovians III,Old Epsomians II,2,0,2,3.0,2
Old Harrovians III,Old Foresters III,18,17,35,4.142857142857143,7
Old Harrovians III,Old Haberdashers,19,12,31,1.2,5
Old Harrovians III,Old Johnians FC,2,18,20,0.6666666666666666,3
Old Harrovians III,Old Johnians II,6,3,9,3.0,2
Old Harrovians III,Old Kimboltonians,4,13,17,2.3333333333333335,3
Old Harrovians III,Old King's Scholars,24,20,44,3.1,10
Old Harrovians III,Old Kingstonians,8,3,11,3.0,2
Old Harrovians III,Old Kingstonians KGS,4,2,6,3.0,1
Old Harrovians III,Old Malvernians II,5,2,7,3.0,2
Old Harrovians III,Old Merchant Taylors,5,10,15,3.0,4
Old Harrovians III,Old Merchant Taylors II,0,0,0,4.0,1
Old Harrovians III,Old Millhillians,7,6,13,5.0,2
Old Harrovians III,Old Oundelians,5,10,15,3.0,2
Old Harrovians III,Old Rugbeians,5,11,16,2.3333333333333335,3
Old Harrovians III,Old Salopians II,7,3,10,3.0,2
Old Harrovians III,Old Sennockians,7,16,23,0.25,4
Old Harrovians III,Old Shirburnians,17,17,34,3.111111111111111,9
Old Harrovians III,Old Stoics,26,26,52,2.8181818181818183,11
Old Harrovians III,Old Suttonians SV,5,8,13,2.0,3
Old Harrovians III,Old Tonbridgians II,7,8,15,3.25,4
Old Harrovians III,Old Wellingtonians,21,12,33,3.5714285714285716,7
Old Harrovians III,Old Westminsters,2,2,4,5.0,1
Old Harrovians III,Old Westminsters II,19,31,50,3.3,10
Old Harrovians IV,Old Amplefordians,1,3,4,3.0,1
Old Harrovians IV,Old Eastbournians,1,2,3,4.0,1
Old Harrovians Select XI,Old Harrovians II,4,4,8,6.0,1
Old Harrovians Vets,KCS Old Boys Vets,2,14,16,0.0,2
Old Harrovians Vets,Lancing Old Boys Vets,5,5,10,4.0,2
Old Harrovians Vets,Old Brentwoods Vets,7,11,18,2.3333333333333335,3
Old Harrovians Vets,Old Carthusians Vets,21,16,37,3.8,5
Old Harrovians Vets,Old Chigwellians Vets,1,4,5,2.0,1
Old Harrovians Vets,Old Etonians Vets,4,15,19,2.6666666666666665,3
Old Harrovians Vets,Old Foresters Vets,3,5,8,3.0,2
Old Harrovians Vets,Old Malvernians Vets,10,17,27,3.0,4
Old Harrovians Vets,Old Reptonians Vets,16,12,28,3.5,4
Old Harrovians Vets,Old Salopians Vets,14,5,19,2.6666666666666665,3
Old Harrovians Vets,Old Tonbridgians Vets,2,1,3,4.0,2
Old Harrovians Vets,Old Westminsters Vets,5,3,8,4.0,2
Old Harrovians Vets,Old Wykehamists Vets,8,9,17,4.0,3
Old Ignatian,Old Foresters,0,2,2,2.0,1
Old Ignatian II,Old Merchant Taylors,1,2,3,4.0,1
Old Ignatian Vets,Old Etonians Vets,0,3,3,2.0,1
Old Ignatians,Old Chigwellians Vets,1,7,8,0.0,1
Old Ignatians,Old Cholmeleians II,0,1,1,3.0,1
Old Ignatians,Old Foresters Vets,1,3,4,3.0,1
Old Ignatians,Old Salopians,2,2,4,5.0,1
Old Ignatians,Old Tonbridgians,6,1,7,0.0,1
Old Isleworthians,Old Millfieldians,5,3,8,4.0,1
Old Isleworthians,Old Westminsters,1,4,5,2.0,1
Old Isleworthians II,Old Carthusians II,3,7,10,2.0,1
Old Johnians,KCS Old Boys,2,2,4,5.0,1
Old Johnians,Kings College Wimbledon II,6,2,8,3.3333333333333335,3
Old Johnians,Lancing Old Boys,5,3,8,3.3333333333333335,3
Old Johnians,Old Albanians SA,4,4,8,6.0,1
Old Johnians,Old Aldenhamians,12,2,14,2.25,4
Old Johnians,Old Alleynians,0,7,7,0.0,1
Old Johnians,Old Alleynians II,9,6,15,4.0,3
Old Johnians,Old Berkhamstedians,6,2,8,3.0,2
Old Johnians,Old Bradfieldians,2,3,5,4.0,1
Old Johnians,Old Carthusians,0,8,8,1.0,2
Old Johnians,Old Carthusians II,11,0,11,1.5,2
Old Johnians,Old Chigwellians,5,3,8,2.0,2
Old Johnians,Old Chigwellians II,11,4,15,2.6666666666666665,3
Old Johnians,Old Cholmeleians,1,2,3,4.0,1
Old Johnians,Old Columbans,4,0,4,1.0,1
Old Johnians,Old Etonians,3,2,5,4.0,1
Old Johnians,Old Etonians II,9,7,16,3.25,4
Old Johnians,Old Foresters,16,11,27,1.75,4
Old Johnians,Old Harrovians,17,8,25,2.75,4
Old Johnians,Old Harrovians II,15,8,23,3.0,3
Old Johnians,Old Johnians II,4,4,8,6.0,1
Old Johnians,Old Malvernians,13,6,19,2.5,2
Old Johnians,Old Marlburians,11,7,18,3.5,4
Old Johnians,Old Merchant Taylors',4,2,6,1.5,2
Old Johnians,Old Radleians,17,4,21,2.5,4
Old Johnians,Old Reptonians,0,2,2,2.0,1
Old Johnians,Old Rugbeians,11,8,19,2.75,4
Old Johnians,Old Salopians,13,8,21,2.25,4
Old Johnians,Old Sennockians,10,3,13,2.5,4
Old Johnians,Old Tonbridgians,5,3,8,3.6666666666666665,3
Old Johnians,Old Westminsters,9,8,17,2.75,4
Old Johnians,Old Wykehamists,6,5,11,4.5,2
Old Johnians,Shene Old Grammarians,1,2,3,4.0,1
Old Johnians FC,Kings College Wimbledon II,3,1,4,3.5,2
Old Johnians FC,Kings College Wimbledon III,7,1,8,1.5,2
Old Johnians FC,Lancing Old Boys II,8,2,10,2.6666666666666665,3
Old Johnians FC,London Welsh F.C.,5,4,9,5.0,1
Old Johnians FC,Old Albanians SA,5,5,10,6.0,1
Old Johnians FC,Old Aldenhamians II,9,0,9,0.0,1
Old Johnians FC,Old Alleynians AFC II,16,13,29,4.166666666666667,6
Old Johnians FC,Old Amplefordians,11,3,14,1.0,2
Old Johnians FC,Old Bancroftians AFC,5,3,8,3.5,2
Old Johnians FC,Old Brentwoods II,3,2,5,4.0,1
Old Johnians FC,Old Carthusians III,18,5,23,2.0,4
Old Johnians FC,Old Chigwellians II,1,3,4,3.0,1
Old Johnians FC,Old Cholmeleians III,9,1,10,0.0,1
Old Johnians FC,Old Columbans,15,8,23,2.25,4
Old Johnians FC,Old Dorkinians,3,2,5,4.0,1
Old Johnians FC,Old Epsomians,6,7,13,3.75,4
Old Johnians FC,Old Harrovians III,18,2,20,0.6666666666666666,3
Old Johnians FC,Old Malvernians II,6,5,11,3.5,2
Old Johnians FC,Old Merchant Taylors,4,6,10,4.0,2
Old Johnians FC,Old Merchant Taylors II,9,6,15,3.6666666666666665,3
Old Johnians FC,Old Rugbeians,20,10,30,3.25,8
Old Johnians FC,Old Salopians II,6,4,10,3.0,2
Old Johnians FC,Old Sennockians,2,2,4,3.5,2
Old Johnians FC,Old Stoics,5,0,5,2.0,2
Old Johnians FC,Old Suttonians SV,10,4,14,3.25,4
Old Johnians FC,Old Tonbridgians II,14,7,21,2.5,4
Old Johnians FC,Old Wellingtonians,13,7,20,3.0,4
Old Johnians FC,Old Westminsters II,9,3,12,2.3333333333333335,3
Old Johnians FC,Old Wokingians,2,1,3,4.0,1
Old Johnians FC,Old Wykehamists II,12,2,14,1.0,2
Old Johnians FC,St. John's School,0,0,0,4.0,1
Old Johnians II,KCS Old Boys II,1,7,8,0.0,1
Old Johnians II,Old Amplefordians,3,4,7,4.0,1
Old Johnians II,Old Brentwoods IV,7,8,15,5.0,2
Old Johnians II,Old Canfordians,4,2,6,3.5,2
Old Johnians II,Old Cheltonians,5,8,13,3.0,3
Old Johnians II,Old Harrovians III,3,6,9,3.0,2
Old Johnians II,Old Johnians,4,4,8,6.0,1
Old Johnians II,Old King's Scholars,0,3,3,2.0,1
Old Johnians II,Old Oundelians,7,1,8,2.0,2
Old Johnians II,Old Salopians II,8,2,10,2.0,2
Old Johnians II,Old Shirburnians,1,2,3,4.0,1
Old Johnians II,Old Stoics,4,3,7,4.5,2
Old Johnians II,Old Tonbridgians II,0,5,5,2.0,2
Old Johnians II,Old Wellingtonians,4,4,8,4.0,2
Old Johnians II,Old Westminsters II,1,4,5,2.0,1
Old Josephians,KCS Old Boys,0,16,16,1.0,1
Old Kimboltonians,KCS Old Boys,5,14,19,1.5,2
Old Kimboltonians,Kimbolton School 1st XI,10,3,13,2.75,4
Old Kimboltonians,Kings College Wimbledon II,11,7,18,2.75,4
Old Kimboltonians,Lancing Old Boys,11,5,16,2.0,4
Old Kimboltonians,Old Albanians,11,5,16,3.0,2
Old Kimboltonians,Old Albanians SA,14,6,20,2.0,3
Old Kimboltonians,Old Aldenhamians,28,17,45,3.375,8
Old Kimboltonians,Old Alleynians,3,0,3,2.0,1
Old Kimboltonians,Old Alleynians AFC,4,5,9,4.5,2
Old Kimboltonians,Old Alleynians AFC II,4,6,10,4.0,2
Old Kimboltonians,Old Alleynians AFC III,4,4,8,6.0,1
Old Kimboltonians,Old Alleynians II,12,19,31,2.1666666666666665,6
Old Kimboltonians,Old Alleynians III,5,2,7,3.5,2
Old Kimboltonians,Old Amplefordians,12,3,15,1.0,2
Old Kimboltonians,Old Ardinians,9,16,25,3.6,5
Old Kimboltonians,Old Bancroftians AFC,10,3,13,2.0,2
Old Kimboltonians,Old Berkhamstedians,6,5,11,4.5,2
Old Kimboltonians,Old Bradfieldians,1,3,4,3.0,1
Old Kimboltonians,Old Brentwoods,1,4,5,2.0,1
Old Kimboltonians,Old Brentwoods II,18,6,24,2.8333333333333335,6
Old Kimboltonians,Old Brentwoods III,3,3,6,4.5,2
Old Kimboltonians,Old Carthusians II,2,2,4,5.0,1
Old Kimboltonians,Old Chigwellians,6,4,10,4.0,2
Old Kimboltonians,Old Chigwellians II,24,15,39,3.857142857142857,7
Old Kimboltonians,Old Chigwellians III,8,2,10,2.0,2
Old Kimboltonians,Old Cholmeleians II,16,20,36,3.625,8
Old Kimboltonians,Old Columbans,2,1,3,4.0,1
Old Kimboltonians,Old Epsomians,6,3,9,3.6666666666666665,3
Old Kimboltonians,Old Etonians,1,3,4,3.0,1
Old Kimboltonians,Old Etonians II,18,19,37,3.7142857142857144,7
Old Kimboltonians,Old Foresters II,4,1,5,2.0,1
Old Kimboltonians,Old Foresters III,13,3,16,2.0,3
Old Kimboltonians,Old Haberdashers,2,1,3,4.0,1
Old Kimboltonians,Old Harrovians,7,0,7,0.0,1
Old Kimboltonians,Old Harrovians II,9,2,11,2.3333333333333335,3
Old Kimboltonians,Old Harrovians III,13,4,17,2.3333333333333335,3
Old Kimboltonians,Old King's Scholars,10,4,14,3.0,3
Old Kimboltonians,Old Malvernians,12,8,20,4.25,4
Old Kimboltonians,Old Marlburians,3,1,4,3.0,1
Old Kimboltonians,Old Merchant Taylors,5,0,5,0.0,1
Old Kimboltonians,Old Merchant Taylors II,9,2,11,1.0,2
Old Kimboltonians,Old Oundelians,2,8,10,0.0,1
Old Kimboltonians,Old Radleians,10,11,21,3.0,4
Old Kimboltonians,Old Reptonians,2,3,5,4.0,2
Old Kimboltonians,Old Rugbeians,5,6,11,5.0,2
Old Kimboltonians,Old Salopians,5,14,19,2.75,4
Old Kimboltonians,Old Salopians II,3,1,4,2.5,2
Old Kimboltonians,Old Sennockians,10,4,14,3.0,3
Old Kimboltonians,Old Shirburnians,12,9,21,2.4,5
Old Kimboltonians,Old Stoics,12,5,17,1.5,2
Old Kimboltonians,Old Tonbridgians,1,2,3,4.0,1
Old Kimboltonians,Old Tonbridgians II,21,4,25,2.0,4
Old Kimboltonians,Old Wellingburians,9,7,16,1.3333333333333333,3
Old Kimboltonians,Old Westminsters II,5,0,5,0.0,1
Old Kimboltonians,Old Wykehamists,2,3,5,4.0,1
Old Kimboltonians,Old Wykehamists II,6,0,6,0.0,1
Old Kimboltonians Vets,Old Brentwoods Vets,0,1,1,3.0,1
Old Kimboltonians Vets,Old Etonians Vets,1,6,7,0.0,1
Old Kimboltonians Vets,Old Foresters Vets,0,1,1,3.0,1
Old Kimboltonians Vets,Old Westminsters Vets,2,1,3,4.0,1
Old King's Scholars,Alleyn Old Boys,0,5,5,0.0,1
Old King's Scholars,Bealonians,1,2,3,4.0,1
Old King's Scholars,KCS Old Boys,1,21,22,0.3333333333333333,3
Old King's Scholars,KCS Old Boys II,3,2,5,4.0,1
Old King's Scholars,Kings College Wimbledon III,7,4,11,3.5,2
Old King's Scholars,Lancing Old Boys,1,11,12,2.0,2
Old King's Scholars,Lancing Old Boys II,8,12,20,3.0,5
Old King's Scholars,Old Albanians SA,2,7,9,3.0,3
Old King's Scholars,Old Aldenhamians,3,18,21,2.0,5
Old King's Scholars,Old Alleynians AFC II,3,4,7,4.0,2
Old King's Scholars,Old Alleynians AFC III,3,7,10,3.0,2
Old King's Scholars,Old Amplefordians,29,25,54,3.8,10
Old King's Scholars,Old Ardinians,1,10,11,1.0,2
Old King's Scholars,Old Ardinians II,7,8,15,5.0,2
Old King's Scholars,Old Bancroftians AFC,4,7,11,3.25,4
Old King's Scholars,Old Berkhamstedians II,10,11,21,3.1666666666666665,6
Old King's Scholars,Old Blues II,2,0,2,2.0,1
Old King's Scholars,Old Bradfieldians,3,16,19,2.0,4
Old King's Scholars,Old Brentwoods II,7,14,21,3.5,4
Old King's Scholars,Old Brentwoods III,10,18,28,2.0,4
Old King's Scholars,Old Brentwoods IV,5,4,9,3.6666666666666665,3
Old King's Scholars,Old Carthusians,0,5,5,0.0,1
Old King's Scholars,Old Carthusians II,1,4,5,2.0,1
Old King's Scholars,Old Carthusians III,3,7,10,2.0,1
Old King's Scholars,Old Chigwellians II,2,2,4,4.5,2
Old King's Scholars,Old Cholmeleians II,2,5,7,3.3333333333333335,3
Old King's Scholars,Old Citizens,0,5,5,0.0,1
Old King's Scholars,Old Columbans,0,5,5,0.0,1
Old King's Scholars,Old Eastbournians,4,5,9,4.5,2
Old King's Scholars,Old Epsomians,4,3,7,4.0,1
Old King's Scholars,Old Epsomians II,0,3,3,2.0,1
Old King's Scholars,Old Etonians II,0,3,3,2.5,2
Old King's Scholars,Old Finchleians,2,7,9,2.5,2
Old King's Scholars,Old Foresters,1,0,1,3.0,1
Old King's Scholars,Old Foresters II,7,7,14,5.5,2
Old King's Scholars,Old Haberdashers,9,11,20,2.5,4
Old King's Scholars,Old Haileyburians,8,12,20,3.5,4
Old King's Scholars,Old Harrovians III,20,24,44,3.1,10
Old King's Scholars,Old Johnians II,3,0,3,2.0,1
Old King's Scholars,Old Kimboltonians,4,10,14,3.0,3
Old King's Scholars,Old Kingstonians,5,6,11,5.0,2
Old King's Scholars,Old Kingstonians KGS,8,7,15,3.0,2
Old King's Scholars,Old Lyonians,3,4,7,4.0,1
Old King's Scholars,Old Malvernians,2,6,8,3.0,2
Old King's Scholars,Old Meadonians IV,0,1,1,3.0,1
Old King's Scholars,Old Minchendenians,0,1,1,3.0,1
Old King's Scholars,Old Parkonians,6,10,16,1.0,2
Old King's Scholars,Old Radleians,7,13,20,2.25,4
Old King's Scholars,Old Reptonians,1,13,14,1.3333333333333333,3
Old King's Scholars,Old Salopians,1,7,8,2.0,2
Old King's Scholars,Old Salopians II,4,2,6,3.0,1
Old King's Scholars,Old Shirburnians,17,22,39,3.5833333333333335,12
Old King's Scholars,Old Stoics,14,16,30,3.3333333333333335,6
Old King's Scholars,Old Suttonians,3,2,5,4.0,1
Old King's Scholars,Old Tonbridgians,1,12,13,0.5,2
Old King's Scholars,Old Tonbridgians II,10,11,21,4.0,4
Old King's Scholars,Old Wellingtonians,18,16,34,2.6666666666666665,9
Old King's Scholars,Old Westminsters,8,15,23,3.0,4
Old King's Scholars,Old Westminsters II,17,40,57,2.2,10
Old King's Scholars,Old Wilsonians,4,3,7,4.0,1
Old King's Scholars,Old Wykehamists,6,14,20,2.25,4
Old King's Scholars,Old Wykehamists II,10,7,17,2.25,4
Old King's Scholars,Southgate County,6,1,7,0.0,1
Old King's Scholars,"The King's School, Canterbury",5,11,16,2.5,2
Old King's Scholars,UCL Academicals V,4,0,4,1.0,1
Old King's Scholars,Wood Green Old Boys,1,0,1,3.0,1
Old Kingsburians,Old Brentwoods II,3,1,4,3.0,1
Old Kingsburians,Old Carthusians III,2,2,4,5.0,1
Old Kingsburians,Old Cholmeleians II,2,4,6,3.0,1
Old Kingsburians,Old Columbans,0,3,3,2.0,1
Old Kingsburians,Old Foresters,1,7,8,0.0,1
Old Kingstonians,Kingston Grammar School 1st XI,6,4,10,4.0,2
Old Kingstonians,Lancing Old Boys II,15,5,20,3.0,2
Old Kingstonians,Old Albanians SA,0,3,3,2.0,1
Old Kingstonians,Old Aldenhamians,1,5,6,2.0,1
Old Kingstonians,Old Amplefordians,7,14,21,3.4,5
Old Kingstonians,Old Ardinians,0,4,4,1.0,1
Old Kingstonians,Old Ardinians II,4,5,9,4.5,2
Old Kingstonians,Old Berkhamstedians II,3,18,21,1.5,4
Old Kingstonians,Old Bradfieldians,0,8,8,0.0,1
Old Kingstonians,Old Brentwoods III,5,5,10,4.0,2
Old Kingstonians,Old Brentwoods IV,3,4,7,3.5,2
Old Kingstonians,Old Canfordians,7,7,14,3.5,2
Old Kingstonians,Old Carthusians II,2,0,2,2.0,1
Old Kingstonians,Old Cheltonians,7,4,11,2.3333333333333335,3
Old Kingstonians,Old Cranleighans,2,2,4,4.0,2
Old Kingstonians,Old Eastbournians,8,10,18,2.75,4
Old Kingstonians,Old Felstedians,9,0,9,0.0,1
Old Kingstonians,Old Harrovians III,3,8,11,3.0,2
Old Kingstonians,Old King's Scholars,6,5,11,5.0,2
Old Kingstonians,Old Oundelians,12,4,16,3.0,4
Old Kingstonians,Old Salopians II,19,16,35,1.6666666666666667,6
Old Kingstonians,Old Stoics,13,3,16,2.5,2
Old Kingstonians,Old Tonbridgians II,3,5,8,4.0,2
Old Kingstonians,Old Wellingtonians,9,8,17,3.6666666666666665,3
Old Kingstonians,Old Westminsters II,14,14,28,2.6666666666666665,6
Old Kingstonians,Old Wykehamists II,7,4,11,2.3333333333333335,3
Old Kingstonians,St Edwards OSE,0,2,2,2.0,1
Old Kingstonians KGS,Kingston Grammar School 1st XI,6,6,12,3.5,2
Old Kingstonians KGS,Lancing Old Boys,1,5,6,3.0,2
Old Kingstonians KGS,Old Alleynians AFC III,3,10,13,2.0,2
Old Kingstonians KGS,Old Amplefordians,19,12,31,3.0,5
Old Kingstonians KGS,Old Ardinians,2,5,7,3.3333333333333335,3
Old Kingstonians KGS,Old Berkhamstedians II,12,13,25,2.8,5
Old Kingstonians KGS,Old Carthusians,0,9,9,0.0,1
Old Kingstonians KGS,Old Cholmeleians II,1,6,7,0.0,1
Old Kingstonians KGS,Old Dorkinians,6,0,6,0.0,1
Old Kingstonians KGS,Old Eastbournians,7,7,14,3.6666666666666665,3
Old Kingstonians KGS,Old Gregorians,3,5,8,4.0,1
Old Kingstonians KGS,Old Harrovians III,2,4,6,3.0,1
Old Kingstonians KGS,Old King's Scholars,7,8,15,3.0,2
Old Kingstonians KGS,Old Pauline,5,0,5,0.0,1
Old Kingstonians KGS,Old Reptonians,0,3,3,2.0,1
Old Kingstonians KGS,Old Salopians II,5,1,6,2.0,1
Old Kingstonians KGS,Old Shirburnians,10,11,21,5.0,3
Old Kingstonians KGS,Old Stoics,0,6,6,0.0,1
Old Kingstonians KGS,Old Westminsters II,14,22,36,2.7142857142857144,7
Old Kingstonians KGS,Old Wokingians,5,0,5,0.0,1
Old Kingstonians KGS,Old Wykehamists II,8,12,20,3.25,4
Old Kingstonians KGS,South Bank Cuaco,2,2,4,5.0,1
Old Lyonians,Kings College Wimbledon II,3,9,12,0.0,1
Old Lyonians,Old Chigwellians,3,2,5,4.0,1
Old Lyonians,Old Chigwellians Vets,0,4,4,1.0,1
Old Lyonians,Old Cholmeleians,1,7,8,0.0,1
Old Lyonians,Old Etonians,2,4,6,3.0,1
Old Lyonians,Old Haileyburians Vets,1,3,4,3.0,1
Old Lyonians,Old King's Scholars,4,3,7,4.0,1
Old Magdalenians,Old Aldenhamians,1,4,5,2.0,1
Old Magdalenians,Old Reptonians,0,8,8,0.0,1
Old Malvernians,Fulham Compton Old Boys,0,5,5,0.0,1
Old Malvernians,IB Albion,1,8,9,0.0,1
Old Malvernians,KCS Old Boys,0,5,5,0.0,1
Old Malvernians,Lancing Old Boys,11,23,34,3.125,8
Old Malvernians,Latymer Old Boys,2,8,10,0.0,1
Old Malvernians,London Welsh F.C.,1,3,4,3.0,1
Old Malvernians,Malvern College 1st XI,10,6,16,3.6666666666666665,6
Old Malvernians,Mickleham Old Boxhillians FC,4,4,8,6.0,1
Old Malvernians,Old Aldenhamians,38,30,68,3.0,15
Old Malvernians,Old Alleynians AFC,7,15,22,3.2,5
Old Malvernians,Old Alleynians II,6,4,10,4.0,2
Old Malvernians,Old Berkhamstedians,16,22,38,3.2,10
Old Malvernians,Old Bradfieldians,27,33,60,3.1,10
Old Malvernians,Old Brentwoods,12,32,44,2.75,8
Old Malvernians,Old Carthusians,2,11,13,1.0,2
Old Malvernians,Old Carthusians II,0,5,5,0.0,1
Old Malvernians,Old Chigwellians,9,40,49,1.8888888888888888,9
Old Malvernians,Old Chigwellians II,6,4,10,4.0,2
Old Malvernians,Old Cholmeleians,16,36,52,3.230769230769231,13
Old Malvernians,Old Cholmeleians II,6,6,12,4.0,2
Old Malvernians,Old Citizens,1,0,1,3.0,1
Old Malvernians,Old Epsomians,6,2,8,2.0,1
Old Malvernians,Old Etonians,4,11,15,2.6666666666666665,3
Old Malvernians,Old Etonians II,2,10,12,1.0,2
Old Malvernians,Old Foresters,2,24,26,0.0,3
Old Malvernians,Old Haileyburians,8,15,23,3.5,6
Old Malvernians,Old Harrovians,19,36,55,2.727272727272727,11
Old Malvernians,Old Harrovians II,5,7,12,4.5,2
Old Malvernians,Old Johnians,6,13,19,2.5,2
Old Malvernians,Old Kimboltonians,8,12,20,4.25,4
Old Malvernians,Old King's Scholars,6,2,8,3.0,2
Old Malvernians,Old Marlburians,19,27,46,3.25,12
Old Malvernians,Old Merchant Taylors,3,2,5,4.0,1
Old Malvernians,Old Millfieldians,1,6,7,2.0,2
Old Malvernians,Old Radleians,52,45,97,3.7222222222222223,18
Old Malvernians,Old Reptonians,29,38,67,2.533333333333333,15
Old Malvernians,Old Rugbeians,8,20,28,2.1666666666666665,6
Old Malvernians,Old Salopians,15,33,48,2.9,10
Old Malvernians,Old Sennockians,5,2,7,3.0,2
Old Malvernians,Old Strand Academicals,2,1,3,4.0,1
Old Malvernians,Old Tiffinians,5,2,7,2.0,1
Old Malvernians,Old Tollingtonians,2,5,7,2.0,1
Old Malvernians,Old Tonbridgians,4,15,19,2.5,4
Old Malvernians,Old Tonbridgians II,5,4,9,5.0,1
Old Malvernians,Old Uffingtonians FC,4,6,10,3.0,2
Old Malvernians,Old Wellingtonians,15,14,29,2.8333333333333335,6
Old Malvernians,Old Westminsters,21,37,58,3.0,11
Old Malvernians,Old Wykehamists,25,36,61,3.0833333333333335,12
Old Malvernians,Spaniards,3,3,6,5.0,1
Old Malvernians,TBC,2,1,3,4.0,1
Old Malvernians,University of Hertfordshire,5,3,8,4.0,1
Old Malvernians,Wood Green Old Boys,6,0,6,0.0,1
Old Malvernians II,Kings College Wimbledon II,8,6,14,2.3333333333333335,3
Old Malvernians II,Kings College Wimbledon III,4,7,11,3.5,2
Old Malvernians II,Malvern College 2nd XI,3,3,6,3.5,2
Old Malvernians II,Old Aldenhamians II,1,2,3,4.0,1
Old Malvernians II,Old Alleynians AFC II,6,9,15,1.0,2
Old Malvernians II,Old Amplefordians,4,14,18,2.5,4
Old Malvernians II,Old Bancroftians AFC,3,2,5,4.0,2
Old Malvernians II,Old Berkhamstedians,2,5,7,2.0,1
Old Malvernians II,Old Brentwoods II,0,8,8,1.0,2
Old Malvernians II,Old Brentwoods III,12,4,16,2.0,4
Old Malvernians II,Old Brentwoods IV,7,2,9,2.5,2
Old Malvernians II,Old Chigwellians III,5,4,9,4.5,2
Old Malvernians II,Old Chigwellians IV,10,1,11,1.5,2
Old Malvernians II,Old Cholmeleians IV,12,1,13,1.0,1
Old Malvernians II,Old Citizens,12,12,24,3.8333333333333335,6
Old Malvernians II,Old Eastbournians,6,2,8,2.5,2
Old Malvernians II,Old Epsomians,5,7,12,4.0,1
Old Malvernians II,Old Foresters III,11,3,14,2.0,2
Old Malvernians II,Old Foresters IV,9,0,9,0.0,1
Old Malvernians II,Old Harrovians II,0,5,5,0.0,1
Old Malvernians II,Old Harrovians III,2,5,7,3.0,2
Old Malvernians II,Old Johnians FC,5,6,11,3.5,2
Old Malvernians II,Old Merchant Taylors II,2,10,12,2.0,2
Old Malvernians II,Old Millfieldians,4,8,12,3.5,2
Old Malvernians II,Old Oundelians,2,5,7,3.5,2
Old Malvernians II,Old Rugbeians,7,12,19,3.25,4
Old Malvernians II,Old Salopians II,2,9,11,2.0,2
Old Malvernians II,Old Stoics,2,9,11,2.3333333333333335,3
Old Malvernians II,Old Tonbridgians II,2,6,8,2.5,2
Old Malvernians II,Old Westminsters II,12,13,25,3.8333333333333335,6
Old Malvernians II,Old Wykehamists II,0,3,3,2.0,1
Old Malvernians II,TBC,0,5,5,0.0,1
Old Malvernians Vets,KCS Old Boys Vets,1,2,3,4.0,1
Old Malvernians Vets,Lancing Old Boys Vets,5,6,11,3.5,2
Old Malvernians Vets,Old Bradfieldians Vets,7,5,12,4.5,2
Old Malvernians Vets,Old Brentwoods Vets,5,4,9,3.6666666666666665,3
Old Malvernians Vets,Old Carthusians Vets,5,2,7,2.0,1
Old Malvernians Vets,Old Chigwellians Vets,3,1,4,3.0,1
Old Malvernians Vets,Old Etonians Vets,5,4,9,4.0,3
Old Malvernians Vets,Old Foresters Vets,10,17,27,2.75,4
Old Malvernians Vets,Old Harrovians Vets,17,10,27,3.0,4
Old Malvernians Vets,Old Reptonians Vets,6,2,8,2.5,2
Old Malvernians Vets,Old Salopians Vets,0,8,8,1.0,2
Old Malvernians Vets,Old Tonbridgians Vets,10,7,17,0.6666666666666666,3
Old Malvernians Vets,Old Westminsters Vets,1,2,3,4.0,1
Old Malvernians Vets,Old Wykehamists Vets,5,0,5,2.0,2
Old Manorians,Old Aldenhamians II,2,3,5,4.0,1
Old Manorians,Old Carthusians II,3,2,5,4.0,1
Old Manorians,Old Cholmeleians II,2,5,7,2.0,1
Old Manorians,Old Foresters,3,2,5,4.0,1
Old Manorians,Old Foresters II,5,3,8,4.0,1
Old Marlburians,KCS Old Boys,6,11,17,3.3333333333333335,6
Old Marlburians,Kings College Wimbledon II,6,8,14,1.0,2
Old Marlburians,Lancing Old Boys,40,29,69,2.857142857142857,14
Old Marlburians,Lancing Old Boys II,7,3,10,3.3333333333333335,3
Old Marlburians,Marlborough College 1st XI,27,9,36,2.4,5
Old Marlburians,Old Aldenhamians,14,8,22,3.25,4
Old Marlburians,Old Aldenhamians II,20,8,28,2.5,4
Old Marlburians,Old Alleynians AFC,6,13,19,3.25,4
Old Marlburians,Old Ardinians,6,3,9,3.0,2
Old Marlburians,Old Bancroftians AFC,2,1,3,4.0,1
Old Marlburians,Old Berkhamstedians,32,19,51,2.5555555555555554,9
Old Marlburians,Old Bradfieldians,7,1,8,2.0,2
Old Marlburians,Old Brentwoods,15,26,41,2.1666666666666665,6
Old Marlburians,Old Brentwoods II,9,3,12,2.5,2
Old Marlburians,Old Carthusians,7,29,36,1.8571428571428572,7
Old Marlburians,Old Carthusians II,9,6,15,3.8,5
Old Marlburians,Old Carthusians III,6,4,10,3.0,2
Old Marlburians,Old Chigwellians,25,34,59,2.75,12
Old Marlburians,Old Chigwellians II,12,5,17,2.6666666666666665,3
Old Marlburians,Old Cholmeleians,9,17,26,2.5714285714285716,7
Old Marlburians,Old Cholmeleians II,9,4,13,2.5,2
Old Marlburians,Old Etonians,8,17,25,2.6666666666666665,6
Old Marlburians,Old Etonians II,9,4,13,2.5,2
Old Marlburians,Old Foresters,5,27,32,2.5,10
Old Marlburians,Old Foresters II,6,2,8,3.3333333333333335,3
Old Marlburians,Old Haberdashers,9,1,10,2.0,2
Old Marlburians,Old Haileyburians,15,2,17,1.5,2
Old Marlburians,Old Harrovians,30,31,61,2.5384615384615383,13
Old Marlburians,Old Harrovians II,6,2,8,3.0,2
Old Marlburians,Old Johnians,7,11,18,3.5,4
Old Marlburians,Old Kimboltonians,1,3,4,3.0,1
Old Marlburians,Old Malvernians,27,19,46,3.25,12
Old Marlburians,Old Millfieldians,4,3,7,4.0,1
Old Marlburians,Old Radleians,21,16,37,3.7777777777777777,9
Old Marlburians,Old Reptonians,35,27,62,2.3333333333333335,12
Old Marlburians,Old Rugbeians,26,14,40,2.625,8
Old Marlburians,Old Salopians,27,35,62,2.8666666666666667,15
Old Marlburians,Old Salopians II,7,2,9,2.5,2
Old Marlburians,Old Tonbridgians,11,29,40,2.875,8
Old Marlburians,Old Wellingtonians,7,2,9,1.5,2
Old Marlburians,Old Westminsters,28,23,51,3.6666666666666665,12
Old Marlburians,Old Wykehamists,20,24,44,1.8888888888888888,9
Old Marlburians,Old Wykehamists II,9,1,10,1.0,2
Old Meadonians,Kings College Wimbledon II,6,1,7,0.0,1
Old Meadonians,Old Alleynians,2,3,5,4.0,1
Old Meadonians,Old Brentwoods II,5,3,8,4.0,1
Old Meadonians,Old Carthusians,1,3,4,3.0,1
Old Meadonians,Old Carthusians II,2,1,3,4.0,1
Old Meadonians,Old Carthusians III,0,1,1,3.0,1
Old Meadonians,Old Eastbournians,2,2,4,3.5,2
Old Meadonians,Old Etonians,3,2,5,4.0,1
Old Meadonians,Old Foresters,6,4,10,4.0,2
Old Meadonians,Old Rugbeians,3,5,8,4.0,1
Old Meadonians,Old Sennockians,6,5,11,5.0,1
Old Meadonians,Old Tonbridgians II,4,5,9,5.0,1
Old Meadonians IV,Old King's Scholars,1,0,1,3.0,1
Old Meadonians VI,Old Haberdashers,4,8,12,2.0,1
Old Merchant Taylors,East Barnet Old Grammarians,1,1,2,4.0,1
Old Merchant Taylors,Enfield Old Grammarians III,0,5,5,0.0,1
Old Merchant Taylors,KCS Old Boys II,3,1,4,3.5,2
Old Merchant Taylors,Kings College Wimbledon II,9,10,19,2.6,5
Old Merchant Taylors,Lancing Old Boys,3,5,8,1.0,2
Old Merchant Taylors,Lancing Old Boys II,4,4,8,4.0,2
Old Merchant Taylors,Merchant Taylors School 1st XI,0,2,2,2.0,1
Old Merchant Taylors,Old Albanians,6,8,14,2.0,2
Old Merchant Taylors,Old Aldenhamians,15,15,30,2.1666666666666665,6
Old Merchant Taylors,Old Aldenhamians II,11,3,14,2.0,3
Old Merchant Taylors,Old Alleynians AFC,5,9,14,3.0,3
Old Merchant Taylors,Old Alleynians II,2,2,4,5.0,1
Old Merchant Taylors,Old Alleynians III,12,5,17,2.75,4
Old Merchant Taylors,Old Amplefordians,3,0,3,2.0,1
Old Merchant Taylors,Old Ardinians,2,4,6,4.0,2
Old Merchant Taylors,Old Bancroftians AFC,12,15,27,3.625,8
Old Merchant Taylors,Old Berkhamstedians,4,6,10,2.0,2
Old Merchant Taylors,Old Brentwoods II,12,9,21,2.857142857142857,7
Old Merchant Taylors,Old Brentwoods III,8,1,9,1.5,2
Old Merchant Taylors,Old Brentwoods IV,4,2,6,3.0,1
Old Merchant Taylors,Old Carthusians,1,9,10,2.0,2
Old Merchant Taylors,Old Carthusians II,8,22,30,2.875,8
Old Merchant Taylors,Old Chigwellians,3,7,10,2.0,2
Old Merchant Taylors,Old Chigwellians II,11,11,22,2.7142857142857144,7
Old Merchant Taylors,Old Chigwellians III,3,1,4,3.0,1
Old Merchant Taylors,Old Cholmeleians,2,3,5,4.0,1
Old Merchant Taylors,Old Cholmeleians II,15,10,25,2.6666666666666665,6
Old Merchant Taylors,Old Cholmeleians III,6,1,7,2.5,2
Old Merchant Taylors,Old Cholmeleians IV,17,8,25,3.25,4
Old Merchant Taylors,Old Citizens,6,10,16,3.25,4
Old Merchant Taylors,Old Columbans,2,6,8,2.0,1
Old Merchant Taylors,Old Eastbournians,5,2,7,3.0,2
Old Merchant Taylors,Old Epsomians,22,9,31,2.75,8
Old Merchant Taylors,Old Etonians,0,7,7,0.0,1
Old Merchant Taylors,Old Etonians II,5,17,22,2.857142857142857,7
Old Merchant Taylors,Old Finchleians,5,3,8,4.0,1
Old Merchant Taylors,Old Foresters II,11,5,16,3.0,4
Old Merchant Taylors,Old Foresters III,18,7,25,2.8,5
Old Merchant Taylors,Old Haberdashers,24,10,34,2.8333333333333335,6
Old Merchant Taylors,Old Harrovians II,19,24,43,3.2222222222222223,9
Old Merchant Taylors,Old Harrovians III,10,5,15,3.0,4
Old Merchant Taylors,Old Ignatian II,2,1,3,4.0,1
Old Merchant Taylors,Old Johnians FC,6,4,10,4.0,2
Old Merchant Taylors,Old Kimboltonians,0,5,5,0.0,1
Old Merchant Taylors,Old Malvernians,2,3,5,4.0,1
Old Merchant Taylors,Old Millhillians,4,2,6,3.0,1
Old Merchant Taylors,Old Oundelians,6,3,9,3.0,1
Old Merchant Taylors,Old Parkonians,1,6,7,0.0,1
Old Merchant Taylors,Old Radleians,6,15,21,3.0,4
Old Merchant Taylors,Old Rugbeians,4,6,10,4.0,2
Old Merchant Taylors,Old Salopians II,3,4,7,4.0,2
Old Merchant Taylors,Old Sennockians,8,14,22,2.8333333333333335,6
Old Merchant Taylors,Old Shirburnians,13,9,22,2.75,4
Old Merchant Taylors,Old Stoics,6,5,11,4.0,3
Old Merchant Taylors,Old Suttonians SV,5,1,6,2.5,2
Old Merchant Taylors,Old Tenisonians,1,2,3,4.0,1
Old Merchant Taylors,Old Tonbridgians II,13,12,25,3.3333333333333335,6
Old Merchant Taylors,Old Westminsters,4,15,19,2.5,4
Old Merchant Taylors,Old Wilsonians,3,0,3,2.0,1
Old Merchant Taylors,Old Woodhouseians II,1,3,4,3.0,1
Old Merchant Taylors,Old Wykehamists II,6,2,8,3.0,2
Old Merchant Taylors,Southgate County II,2,5,7,2.0,1
Old Merchant Taylors II,Bealonians VII,5,4,9,5.0,1
Old Merchant Taylors II,Bealonians VIII,9,3,12,0.0,1
Old Merchant Taylors II,East Barnet Old Grammarians,1,1,2,4.0,1
Old Merchant Taylors II,Lancing Old Boys II,7,0,7,0.0,1
Old Merchant Taylors II,Merchant Taylors School 2nd XI,5,0,5,0.0,1
Old Merchant Taylors II,Old Albanians SA,8,12,20,3.75,4
Old Merchant Taylors II,Old Alleynians AFC,1,7,8,0.0,1
Old Merchant Taylors II,Old Alleynians AFC II,2,9,11,2.3333333333333335,3
Old Merchant Taylors II,Old Ardinians,2,4,6,3.0,1
Old Merchant Taylors II,Old Bancroftians AFC,9,10,19,3.75,4
Old Merchant Taylors II,Old Brentwoods II,9,5,14,3.0,4
Old Merchant Taylors II,Old Brentwoods III,19,15,34,3.142857142857143,7
Old Merchant Taylors II,Old Canfordians,1,9,10,0.0,1
Old Merchant Taylors II,Old Cheltonians,4,5,9,5.0,1
Old Merchant Taylors II,Old Chigwellians II,2,5,7,3.0,2
Old Merchant Taylors II,Old Chigwellians III,11,19,30,2.8333333333333335,6
Old Merchant Taylors II,Old Cholmeleians II,5,18,23,1.75,4
Old Merchant Taylors II,Old Cholmeleians III,11,2,13,2.0,2
Old Merchant Taylors II,Old Eastbournians,4,2,6,3.0,1
Old Merchant Taylors II,Old Foresters III,13,12,25,2.8,5
Old Merchant Taylors II,Old Haberdashers,12,14,26,2.2,5
Old Merchant Taylors II,Old Harrovians III,0,0,0,4.0,1
Old Merchant Taylors II,Old Johnians FC,6,9,15,3.6666666666666665,3
Old Merchant Taylors II,Old Kimboltonians,2,9,11,1.0,2
Old Merchant Taylors II,Old Malvernians II,10,2,12,2.0,2
Old Merchant Taylors II,Old Minchendenians,4,2,6,3.0,1
Old Merchant Taylors II,Old Oundelians,2,5,7,2.0,1
Old Merchant Taylors II,Old Parkonians III,2,5,7,2.0,1
Old Merchant Taylors II,Old Parkonians IV,7,1,8,0.0,1
Old Merchant Taylors II,Old Parmiterians IX,3,1,4,3.0,1
Old Merchant Taylors II,Old Parmiterians VIII,2,3,5,4.0,1
Old Merchant Taylors II,Old Rugbeians,2,5,7,3.5,2
Old Merchant Taylors II,Old Stoics,1,8,9,2.0,2
Old Merchant Taylors II,Old Suttonians SV,2,7,9,2.5,2
Old Merchant Taylors II,Old Tonbridgians II,6,10,16,4.0,2
Old Merchant Taylors II,Old Westminsters II,2,1,3,4.0,1
Old Merchant Taylors II,Old Wykehamists II,13,7,20,2.0,3
Old Merchant Taylors',Bealonians,0,8,8,0.0,1
Old Merchant Taylors',Merchant Taylors School 1st XI,0,5,5,0.0,1
Old Merchant Taylors',Old Aldenhamians,3,6,9,2.5,2
Old Merchant Taylors',Old Alleynians II,2,19,21,0.5,2
Old Merchant Taylors',Old Ardinians,0,5,5,0.0,1
Old Merchant Taylors',Old Brentwoods III,4,3,7,4.0,1
Old Merchant Taylors',Old Carthusians II,3,5,8,4.0,2
Old Merchant Taylors',Old Chigwellians II,4,5,9,4.5,2
Old Merchant Taylors',Old Etonians II,1,10,11,1.0,2
Old Merchant Taylors',Old Harrovians II,2,4,6,3.0,2
Old Merchant Taylors',Old Johnians,2,4,6,1.5,2
Old Merchant Taylors',Old Radleians,8,5,13,1.5,2
Old Merchant Taylors',Old Sennockians,5,9,14,1.5,2
Old Merchant Taylors',Old Shirburnians,1,2,3,4.0,1
Old Merchant Taylors' II,Old Albanians SA,0,10,10,0.5,2
Old Merchant Taylors' II,Old Barryians,2,2,4,5.0,1
Old Merchant Taylors' II,Old Brentwoods III,3,11,14,1.5,2
Old Merchant Taylors' II,Old Brentwoods IV,6,1,7,0.0,1
Old Merchant Taylors' II,Old Eastbournians,3,2,5,4.0,1
Old Merchant Taylors' II,Old Haberdashers,3,5,8,3.0,2
Old Merchant Taylors' II,Old Shirburnians,1,3,4,3.0,1
Old Merchant Taylors' II,Old Westminsters II,1,2,3,4.0,1
Old Millfieldians,Hale End Athletic,1,2,3,4.0,1
Old Millfieldians,Kings College Wimbledon II,9,2,11,2.6666666666666665,3
Old Millfieldians,Lancing Old Boys II,8,9,17,4.333333333333333,3
Old Millfieldians,London Welsh F.C.,1,2,3,4.0,1
Old Millfieldians,Millfield School 1st XI,6,1,7,2.5,2
Old Millfieldians,Old Aldenhamians,10,8,18,1.0,3
Old Millfieldians,Old Aldenhamians II,15,1,16,1.5,2
Old Millfieldians,Old Alleynians AFC,3,3,6,3.5,2
Old Millfieldians,Old Amplefordians,15,1,16,0.0,2
Old Millfieldians,Old Bancroftians AFC,3,1,4,3.0,1
Old Millfieldians,Old Barryians,5,3,8,4.0,1
Old Millfieldians,Old Berkhamstedians,8,6,14,3.8,5
Old Millfieldians,Old Bradfieldians,7,6,13,0.0,2
Old Millfieldians,Old Brentwoods II,4,6,10,0.5,2
Old Millfieldians,Old Brentwoods III,6,4,10,4.0,1
Old Millfieldians,Old Carthusians II,7,6,13,3.0,3
Old Millfieldians,Old Carthusians III,4,11,15,2.0,2
Old Millfieldians,Old Chigwellians,1,6,7,2.0,2
Old Millfieldians,Old Chigwellians II,12,1,13,1.0,2
Old Millfieldians,Old Cholmeleians,1,3,4,3.0,2
Old Millfieldians,Old Cholmeleians II,4,3,7,4.0,1
Old Millfieldians,Old Citizens,4,1,5,3.0,2
Old Millfieldians,Old Epsomians,5,3,8,4.0,2
Old Millfieldians,Old Etonians II,9,4,13,3.0,3
Old Millfieldians,Old Foresters II,14,10,24,4.0,3
Old Millfieldians,Old Harrovians II,19,6,25,2.5,4
Old Millfieldians,Old Isleworthians,3,5,8,4.0,1
Old Millfieldians,Old Malvernians,6,1,7,2.0,2
Old Millfieldians,Old Malvernians II,8,4,12,3.5,2
Old Millfieldians,Old Marlburians,3,4,7,4.0,1
Old Millfieldians,Old Radleians,12,6,18,3.0,2
Old Millfieldians,Old Reptonians,5,6,11,3.0,4
Old Millfieldians,Old Salopians II,8,0,8,1.0,2
Old Millfieldians,Old Tonbridgians,1,5,6,2.0,1
Old Millfieldians,Old Wellingtonians,4,7,11,3.5,2
Old Millfieldians,Old Westminsters,4,4,8,5.0,2
Old Millfieldians,Old Wykehamists,4,7,11,3.5,2
Old Millhillians,Kings College Wimbledon III,3,3,6,5.0,1
Old Millhillians,Old Aldenhamians,3,4,7,4.0,1
Old Millhillians,Old Aldenhamians II,2,6,8,2.5,2
Old Millhillians,Old Alleynians AFC,14,22,36,3.6666666666666665,6
Old Millhillians,Old Amplefordians,9,9,18,4.0,2
Old Millhillians,Old Bancroftians AFC,0,2,2,2.0,1
Old Millhillians,Old Brentwoods III,3,4,7,4.0,1
Old Millhillians,Old Brentwoods IV,5,3,8,3.3333333333333335,3
Old Millhillians,Old Carthusians II,2,3,5,4.0,1
Old Millhillians,Old Challoners,6,6,12,6.0,1
Old Millhillians,Old Chigwellians III,9,5,14,3.5,2
Old Millhillians,Old Cholmeleians II,0,15,15,1.0,1
Old Millhillians,Old Cholmeleians III,8,4,12,3.5,2
Old Millhillians,Old Cholmeleians IV,14,11,25,4.0,3
Old Millhillians,Old Foresters III,12,5,17,2.0,3
Old Millhillians,Old Harrovians III,6,7,13,5.0,2
Old Millhillians,Old Merchant Taylors,2,4,6,3.0,1
Old Millhillians,Old Oundelians,4,2,6,4.0,2
Old Millhillians,Old Rugbeians,3,2,5,4.0,1
Old Millhillians,Old Sennockians,10,4,14,2.6666666666666665,3
Old Millhillians,Old Stoics,9,6,15,2.3333333333333335,3
Old Millhillians,Old Tonbridgians II,13,3,16,2.0,3
Old Millhillians,Old Westminsters II,10,2,12,2.6666666666666665,3
Old Millhillians,Old Wykehamists II,8,2,10,2.0,2
Old Millhillians,UCL Academicals IV,3,6,9,3.0,1
Old Minchendenians,Kings College Wimbledon II,9,7,16,4.5,2
Old Minchendenians,Old Aldenhamians II,6,1,7,0.0,1
Old Minchendenians,Old Brentwoods II,2,4,6,3.0,1
Old Minchendenians,Old Carthusians,2,9,11,2.3333333333333335,3
Old Minchendenians,Old Carthusians II,2,3,5,4.0,1
Old Minchendenians,Old Etonians,8,5,13,4.0,2
Old Minchendenians,Old Harrovians II,4,3,7,4.0,1
Old Minchendenians,Old King's Scholars,1,0,1,3.0,1
Old Minchendenians,Old Merchant Taylors II,2,4,6,3.0,1
Old Minchendenians,Old Salopians II,9,2,11,0.0,1
Old Minchendenians II,Old Etonians II,1,3,4,3.0,1
Old Minchendenians IV,Old Alleynians III,0,3,3,2.0,1
Old Minchendenians IV,Old Chigwellians III,6,0,6,0.0,1
Old Oundelians,Lancing Old Boys II,11,7,18,4.0,3
Old Oundelians,Old Alleynians AFC,5,9,14,3.3333333333333335,3
Old Oundelians,Old Amplefordians,13,1,14,1.0,2
Old Oundelians,Old Bancroftians AFC,5,2,7,2.0,1
Old Oundelians,Old Brentwoods III,4,0,4,1.0,1
Old Oundelians,Old Brentwoods IV,4,20,24,1.0,4
Old Oundelians,Old Canfordians,4,4,8,4.0,2
Old Oundelians,Old Carthusians III,2,6,8,2.0,1
Old Oundelians,Old Cheltonians,3,27,30,1.4,5
Old Oundelians,Old Cholmeleians III,5,0,5,0.0,1
Old Oundelians,Old Cholmeleians IV,4,1,5,2.0,1
Old Oundelians,Old Citizens,2,2,4,5.0,1
Old Oundelians,Old Cranleighans,1,1,2,4.0,1
Old Oundelians,Old Eastbournians,2,5,7,3.5,2
Old Oundelians,Old Haberdashers,5,4,9,5.0,1
Old Oundelians,Old Harrovians III,10,5,15,3.0,2
Old Oundelians,Old Johnians II,1,7,8,2.0,2
Old Oundelians,Old Kimboltonians,8,2,10,0.0,1
Old Oundelians,Old Kingstonians,4,12,16,3.0,4
Old Oundelians,Old Malvernians II,5,2,7,3.5,2
Old Oundelians,Old Merchant Taylors,3,6,9,3.0,1
Old Oundelians,Old Merchant Taylors II,5,2,7,2.0,1
Old Oundelians,Old Millhillians,2,4,6,4.0,2
Old Oundelians,Old Rugbeians,7,7,14,4.5,2
Old Oundelians,Old Salopians II,7,29,36,1.4,5
Old Oundelians,Old Sennockians,3,1,4,3.0,1
Old Oundelians,Old Stoics,8,11,19,3.2,5
Old Oundelians,Old Tonbridgians,1,4,5,2.0,1
Old Oundelians,Old Tonbridgians II,11,3,14,2.8,5
Old Oundelians,Old Wellingtonians,3,7,10,2.0,1
Old Oundelians,Old Westminsters II,24,30,54,2.888888888888889,9
Old Oundelians,Old Wykehamists II,7,10,17,2.0,3
Old Oundelians,Oundle School 1st XI,6,4,10,4.0,2
Old Owens,Old Aldenhamians,4,1,5,2.0,1
Old Owens,Old Brentwoods II,3,2,5,4.0,1
Old Owens,Old Carthusians,6,11,17,2.3333333333333335,3
Old Owens,Old Carthusians II,0,2,2,2.0,1
Old Owens,Old Carthusians III,1,3,4,3.0,1
Old Owens,Old Cholmeleians,5,1,6,2.0,1
Old Owens,Old Cholmeleians II,3,4,7,4.0,1
Old Owens,Old Etonians,3,2,5,4.0,1
Old Owens,Old Etonians II,4,6,10,3.0,2
Old Owens,Old Foresters,3,1,4,3.0,1
Old Owens,Old Foresters Vets,1,6,7,0.0,1
Old Owens II,Old Etonians II,4,1,5,2.0,1
Old Parkonians,Kings College Wimbledon II,3,1,4,3.0,1
Old Parkonians,Old Brentwoods,5,6,11,3.5,2
Old Parkonians,Old Brentwoods II,2,2,4,5.0,1
Old Parkonians,Old Brentwoods III,5,0,5,2.0,2
Old Parkonians,Old Brentwoods IV,1,0,1,3.0,1
Old Parkonians,Old Carthusians,11,14,25,2.75,4
Old Parkonians,Old Chigwellians,4,1,5,3.0,2
Old Parkonians,Old Chigwellians III,4,0,4,1.0,1
Old Parkonians,Old Foresters,5,7,12,3.0,2
Old Parkonians,Old Foresters III,13,0,13,1.0,1
Old Parkonians,Old Haberdashers,1,6,7,0.0,1
Old Parkonians,Old Harrovians II,2,1,3,4.0,1
Old Parkonians,Old King's Scholars,10,6,16,1.0,2
Old Parkonians,Old Merchant Taylors,6,1,7,0.0,1
Old Parkonians III,Old Merchant Taylors II,5,2,7,2.0,1
Old Parkonians IV,Old Brentwoods III,4,1,5,2.0,1
Old Parkonians IV,Old Merchant Taylors II,1,7,8,0.0,1
Old Parkonians VI,Old Brentwoods IV,4,5,9,5.0,1
Old Parmiterians,KCS Old Boys,1,3,4,3.0,1
Old Parmiterians,Old Aldenhamians II,9,8,17,2.5,2
Old Parmiterians,Old Ardinians,3,0,3,2.0,1
Old Parmiterians,Old Bancroftians AFC,1,7,8,0.0,1
Old Parmiterians,Old Brentwoods,1,2,3,4.0,1
Old Parmiterians,Old Carthusians II,2,4,6,3.0,1
Old Parmiterians,Old Chigwellians II,0,0,0,4.0,1
Old Parmiterians,Old Cholmeleians II,6,2,8,2.0,1
Old Parmiterians,Old Cholmeleians III,2,0,2,2.0,1
Old Parmiterians,Old Columbans,1,6,7,0.0,1
Old Parmiterians,Old Etonians,3,6,9,1.5,2
Old Parmiterians,Old Etonians II,2,0,2,2.0,1
Old Parmiterians,Old Tonbridgians,6,1,7,0.0,1
Old Parmiterians II,Old Chigwellians II,3,2,5,4.0,1
Old Parmiterians IV,Old Alleynians III,0,0,0,4.0,1
Old Parmiterians IX,Old Merchant Taylors II,1,3,4,3.0,1
Old Parmiterians VII,Old Brentwoods IV,2,7,9,0.0,1
Old Parmiterians VIII,Old Merchant Taylors II,3,2,5,4.0,1
Old Pauline,Kings College Wimbledon II,0,3,3,2.0,1
Old Pauline,Old Brentwoods,0,2,2,2.0,1
Old Pauline,Old Carthusians Vets,2,0,2,2.0,1
Old Pauline,Old Chigwellians II,6,5,11,5.0,1
Old Pauline,Old Etonians,0,5,5,0.0,1
Old Pauline,Old Kingstonians KGS,0,5,5,0.0,1
Old Pauline,Old Rugbeians,7,4,11,3.0,2
Old Pegasonians F.C.,Old Aldenhamians,3,6,9,3.5,2
Old Radleians,KCS Old Boys,5,6,11,3.6666666666666665,3
Old Radleians,Kings College Wimbledon II,3,2,5,4.0,2
Old Radleians,Lancing Old Boys,5,12,17,3.0,4
Old Radleians,Lancing Old Boys II,10,0,10,0.5,2
Old Radleians,Old Aldenhamians,37,36,73,2.5,16
Old Radleians,Old Alleynians AFC,8,11,19,3.75,4
Old Radleians,Old Alleynians II,6,9,15,3.75,4
Old Radleians,Old Amplefordians,5,4,9,5.0,1
Old Radleians,Old Ardinians,5,4,9,5.0,1
Old Radleians,Old Berkhamstedians,11,11,22,4.2,5
Old Radleians,Old Bradfieldians,23,26,49,3.9,10
Old Radleians,Old Brentwoods,5,24,29,1.5,4
Old Radleians,Old Carthusians,1,16,17,0.0,2
Old Radleians,Old Carthusians II,14,13,27,4.2,5
Old Radleians,Old Carthusians III,12,2,14,1.5,2
Old Radleians,Old Chigwellians,5,21,26,2.2,5
Old Radleians,Old Chigwellians II,13,8,21,2.6,5
Old Radleians,Old Cholmeleians,13,20,33,3.7142857142857144,7
Old Radleians,Old Cholmeleians II,4,4,8,3.5,2
Old Radleians,Old Citizens,2,7,9,0.0,1
Old Radleians,Old Columbans,1,1,2,4.0,1
Old Radleians,Old Epsomians,11,2,13,1.0,1
Old Radleians,Old Etonians,0,7,7,1.5,2
Old Radleians,Old Etonians II,23,28,51,2.7777777777777777,9
Old Radleians,Old Foresters,1,4,5,2.0,1
Old Radleians,Old Foresters II,2,6,8,3.0,2
Old Radleians,Old Haileyburians,25,19,44,2.75,8
Old Radleians,Old Harrovians,15,14,29,3.375,8
Old Radleians,Old Harrovians II,23,14,37,3.625,8
Old Radleians,Old Johnians,4,17,21,2.5,4
Old Radleians,Old Kimboltonians,11,10,21,3.0,4
Old Radleians,Old King's Scholars,13,7,20,2.25,4
Old Radleians,Old Malvernians,45,52,97,3.7222222222222223,18
Old Radleians,Old Marlburians,16,21,37,3.7777777777777777,9
Old Radleians,Old Merchant Taylors,15,6,21,3.0,4
Old Radleians,Old Merchant Taylors',5,8,13,1.5,2
Old Radleians,Old Millfieldians,6,12,18,3.0,2
Old Radleians,Old Reptonians,34,39,73,2.923076923076923,13
Old Radleians,Old Rugbeians,5,4,9,4.5,2
Old Radleians,Old Salopians,11,9,20,3.2,5
Old Radleians,Old Sennockians,16,5,21,2.25,4
Old Radleians,Old Tonbridgians,9,17,26,3.6,5
Old Radleians,Old Tonbridgians II,3,4,7,4.0,1
Old Radleians,Old Wellingtonians,14,10,24,3.2,5
Old Radleians,Old Westminsters,29,31,60,2.6666666666666665,12
Old Radleians,Old Wykehamists,37,45,82,2.9375,16
Old Radleians,Radley College 1st XI,24,16,40,4.0,6
Old Reptonians,Brent,5,0,5,0.0,1
Old Reptonians,Citigroup,3,1,4,3.0,1
Old Reptonians,Globe Rangers,3,1,4,3.0,1
Old Reptonians,Hale End Athletic,0,1,1,3.0,1
Old Reptonians,IB Albion,2,1,3,4.0,1
Old Reptonians,KCS Old Boys,39,30,69,2.6,15
Old Reptonians,Lancing Old Boys,12,17,29,2.2857142857142856,7
Old Reptonians,Lancing Old Boys II,4,1,5,3.0,2
Old Reptonians,Mill Hill Village,1,4,5,2.0,1
Old Reptonians,NUFC Oilers,3,2,5,4.0,1
Old Reptonians,Old Aldenhamians,52,23,75,1.9285714285714286,14
Old Reptonians,Old Alleynians,19,21,40,3.375,8
Old Reptonians,Old Alleynians AFC,7,16,23,1.0,3
Old Reptonians,Old Amplefordians,4,0,4,1.0,1
Old Reptonians,Old Bancroftians AFC,4,1,5,2.0,1
Old Reptonians,Old Berkhamstedians,39,25,64,2.3333333333333335,12
Old Reptonians,Old Bradfieldians,43,34,77,3.0,17
Old Reptonians,Old Brentwoods,16,34,50,2.6666666666666665,12
Old Reptonians,Old Carthusians,4,16,20,3.1,10
Old Reptonians,Old Carthusians II,6,1,7,2.0,2
Old Reptonians,Old Carthusians III,4,5,9,4.5,2
Old Reptonians,Old Chigwellians,26,29,55,3.25,12
Old Reptonians,Old Chigwellians II,7,2,9,2.0,2
Old Reptonians,Old Cholmeleians,47,20,67,2.6666666666666665,15
Old Reptonians,Old Cholmeleians II,10,2,12,1.5,2
Old Reptonians,Old Eastbournians,8,0,8,0.0,1
Old Reptonians,Old Etonians,27,7,34,1.6666666666666667,6
Old Reptonians,Old Foresters,10,10,20,3.8,5
Old Reptonians,Old Foresters II,1,2,3,4.0,1
Old Reptonians,Old Haberdashers,9,6,15,4.0,2
Old Reptonians,Old Haileyburians,18,10,28,3.0,7
Old Reptonians,Old Harrovians,17,15,32,2.5,8
Old Reptonians,Old Johnians,2,0,2,2.0,1
Old Reptonians,Old Kimboltonians,3,2,5,4.0,2
Old Reptonians,Old King's Scholars,13,1,14,1.3333333333333333,3
Old Reptonians,Old Kingstonians KGS,3,0,3,2.0,1
Old Reptonians,Old Magdalenians,8,0,8,0.0,1
Old Reptonians,Old Malvernians,38,29,67,2.533333333333333,15
Old Reptonians,Old Marlburians,27,35,62,2.3333333333333335,12
Old Reptonians,Old Millfieldians,6,5,11,3.0,4
Old Reptonians,Old Radleians,39,34,73,2.923076923076923,13
Old Reptonians,Old Rugbeians,6,3,9,3.6666666666666665,3
Old Reptonians,Old Salopians,14,8,22,2.8,5
Old Reptonians,Old Salopians II,5,6,11,4.5,2
Old Reptonians,Old Sennockians,9,1,10,0.0,1
Old Reptonians,Old Shirburnians,3,1,4,3.0,1
Old Reptonians,Old Suttonians SV,5,1,6,2.0,1
Old Reptonians,Old Tollingtonians,3,2,5,4.0,1
Old Reptonians,Old Tonbridgians,12,12,24,3.875,8
Old Reptonians,Old Uffingtonians FC,2,3,5,4.0,1
Old Reptonians,Old Vaughanians,2,4,6,3.0,1
Old Reptonians,Old Wellingtonians,17,12,29,3.625,8
Old Reptonians,Old Westminsters,25,12,37,3.5,12
Old Reptonians,Old Wokingians,0,4,4,1.0,1
Old Reptonians,Old Wykehamists,30,21,51,2.923076923076923,13
Old Reptonians,Repton School 1st XI,5,3,8,4.0,6
Old Reptonians,Sinjun Grammarians,3,4,7,4.0,1
Old Reptonians,Southgate County,6,3,9,3.0,1
Old Reptonians,Spaniards,0,1,1,3.0,1
Old Reptonians,UCL Academicals,7,2,9,0.0,1
Old Reptonians,Vauxhall Invitational XI,3,1,4,3.0,1
Old Reptonians,Witan,0,5,5,0.0,1
Old Reptonians Vets,KCS Old Boys Vets,2,2,4,5.0,1
Old Reptonians Vets,Lancing Old Boys Vets,2,8,10,0.0,1
Old Reptonians Vets,Old Bradfieldians Vets,0,2,2,2.0,1
Old Reptonians Vets,Old Brentwoods Vets,4,4,8,3.0,2
Old Reptonians Vets,Old Carthusians Vets,4,12,16,1.5,2
Old Reptonians Vets,Old Chigwellians Vets,4,6,10,4.0,1
Old Reptonians Vets,Old Cholmeleians Vets,6,11,17,3.3333333333333335,3
Old Reptonians Vets,Old Etonians Vets,5,5,10,0.0,2
Old Reptonians Vets,Old Harrovians Vets,12,16,28,3.5,4
Old Reptonians Vets,Old Malvernians Vets,2,6,8,2.5,2
Old Reptonians Vets,Old Salopians Vets,2,6,8,2.0,1
Old Reptonians Vets,Old Tonbridgians Vets,3,1,4,3.0,1
Old Reptonians Vets,Old Wellingtonians Vets,1,5,6,2.0,1
Old Reptonians Vets,Old Westminsters Vets,2,2,4,5.0,1
Old Rugbeians,Alleyn Old Boys,1,3,4,3.0,1
Old Rugbeians,Clissold Park Rangers,2,1,3,4.0,1
Old Rugbeians,Jersey Royals,4,0,4,1.0,1
Old Rugbeians,KCS Old Boys,1,2,3,4.0,1
Old Rugbeians,Kings College Wimbledon III,7,6,13,3.0,3
Old Rugbeians,Kings Old Boys,1,0,1,3.0,1
Old Rugbeians,Lancing Old Boys,10,6,16,3.4,5
Old Rugbeians,Old Albanians SA,3,2,5,4.0,1
Old Rugbeians,Old Aldenhamians,12,7,19,2.3333333333333335,3
Old Rugbeians,Old Aldenhamians II,7,2,9,2.5,2
Old Rugbeians,Old Alleynians,1,8,9,0.0,1
Old Rugbeians,Old Alleynians AFC,1,2,3,4.0,1
Old Rugbeians,Old Alleynians AFC II,14,9,23,2.4,5
Old Rugbeians,Old Aloysians,2,1,3,4.0,1
Old Rugbeians,Old Amplefordians,8,7,15,4.0,4
Old Rugbeians,Old Ardinians,5,9,14,3.5,2
Old Rugbeians,Old Bancroftians AFC,15,1,16,1.3333333333333333,3
Old Rugbeians,Old Berkhamstedians,16,9,25,3.6,5
Old Rugbeians,Old Bradfieldians,1,5,6,2.0,1
Old Rugbeians,Old Brentwoods,3,6,9,3.0,1
Old Rugbeians,Old Carthusians,0,4,4,1.0,1
Old Rugbeians,Old Carthusians II,1,10,11,1.0,2
Old Rugbeians,Old Carthusians III,14,11,25,2.0,5
Old Rugbeians,Old Chigwellians,16,19,35,3.4,5
Old Rugbeians,Old Chigwellians II,1,2,3,4.0,1
Old Rugbeians,Old Chigwellians III,5,3,8,4.0,1
Old Rugbeians,Old Cholmeleians,6,17,23,2.5,4
Old Rugbeians,Old Cholmeleians II,2,0,2,2.0,1
Old Rugbeians,Old Columbans,7,5,12,4.0,2
Old Rugbeians,Old Dorkinians,5,3,8,4.0,1
Old Rugbeians,Old Epsomians,14,7,21,2.25,4
Old Rugbeians,Old Epsomians II,4,1,5,2.0,1
Old Rugbeians,Old Esthameians,1,4,5,2.0,1
Old Rugbeians,Old Etonians II,4,2,6,3.6666666666666665,3
Old Rugbeians,Old Foresters,3,8,11,3.0,3
Old Rugbeians,Old Foresters II,9,2,11,2.0,2
Old Rugbeians,Old Foresters III,9,1,10,2.0,2
Old Rugbeians,Old Harrovians,17,19,36,4.2,5
Old Rugbeians,Old Harrovians II,4,4,8,3.0,2
Old Rugbeians,Old Harrovians III,11,5,16,2.3333333333333335,3
Old Rugbeians,Old Johnians,8,11,19,2.75,4
Old Rugbeians,Old Johnians FC,10,20,30,3.25,8
Old Rugbeians,Old Kimboltonians,6,5,11,5.0,2
Old Rugbeians,Old Malvernians,20,8,28,2.1666666666666665,6
Old Rugbeians,Old Malvernians II,12,7,19,3.25,4
Old Rugbeians,Old Marlburians,14,26,40,2.625,8
Old Rugbeians,Old Meadonians,5,3,8,4.0,1
Old Rugbeians,Old Merchant Taylors,6,4,10,4.0,2
Old Rugbeians,Old Merchant Taylors II,5,2,7,3.5,2
Old Rugbeians,Old Millhillians,2,3,5,4.0,1
Old Rugbeians,Old Oundelians,7,7,14,4.5,2
Old Rugbeians,Old Pauline,4,7,11,3.0,2
Old Rugbeians,Old Radleians,4,5,9,4.5,2
Old Rugbeians,Old Reptonians,3,6,9,3.6666666666666665,3
Old Rugbeians,Old Salopians,16,17,33,3.3333333333333335,9
Old Rugbeians,Old Salopians II,11,2,13,1.0,2
Old Rugbeians,Old Sedcopians,3,1,4,3.0,1
Old Rugbeians,Old Sennockians,4,4,8,2.6666666666666665,3
Old Rugbeians,Old Shirburnians,1,0,1,3.0,1
Old Rugbeians,Old Stoics,15,2,17,1.0,3
Old Rugbeians,Old Strand Academicals,4,1,5,2.0,1
Old Rugbeians,Old Suttonians SV,11,10,21,3.75,4
Old Rugbeians,Old Thorntonians,12,2,14,1.0,1
Old Rugbeians,Old Tonbridgians,2,8,10,2.0,2
Old Rugbeians,Old Tonbridgians II,13,21,34,2.857142857142857,7
Old Rugbeians,Old Wellingtonians,5,4,9,4.5,2
Old Rugbeians,Old Westminsters,18,21,39,3.2,10
Old Rugbeians,Old Westminsters II,16,5,21,1.75,4
Old Rugbeians,Old Wykehamists,4,6,10,3.3333333333333335,3
Old Rugbeians,Old Wykehamists II,5,8,13,2.6666666666666665,3
Old Rugbeians,Rugby School,7,1,8,2.3333333333333335,3
Old Rugbeians,Shene Old Grammarians,4,4,8,6.0,1
Old Rugbeians,Sinjun Grammarians,3,0,3,2.0,1
Old Rugbeians II,Old Berkhamstedians II,2,5,7,2.0,1
Old Rugbeians II,Old Harrovians II,0,9,9,0.0,1
Old Salesians,Kings College Wimbledon II,2,1,3,4.0,1
Old Salesians,Old Foresters,2,0,2,2.0,1
Old Salopians,Albanian FC,1,2,3,4.0,1
Old Salopians,Alleyn Old Boys,1,3,4,3.0,1
Old Salopians,Broomfield FC,2,4,6,3.0,1
Old Salopians,Ibis Eagles,2,1,3,4.0,1
Old Salopians,KCS Old Boys,29,31,60,2.857142857142857,14
Old Salopians,Lancing Old Boys,50,47,97,2.8947368421052633,19
Old Salopians,NUFC Oilers,0,3,3,2.5,2
Old Salopians,Old Aldenhamians,9,2,11,1.5,2
Old Salopians,Old Alleynians AFC,3,5,8,2.75,4
Old Salopians,Old Amplefordians,2,1,3,4.0,1
Old Salopians,Old Ardinians,3,12,15,2.0,3
Old Salopians,Old Berkhamstedians,17,11,28,3.1666666666666665,6
Old Salopians,Old Bradfieldians,10,14,24,3.857142857142857,7
Old Salopians,Old Brentwoods,20,12,32,2.8181818181818183,11
Old Salopians,Old Carthusians,18,59,77,2.6,15
Old Salopians,Old Chigwellians,33,39,72,2.9375,16
Old Salopians,Old Cholmeleians,22,16,38,3.1,10
Old Salopians,Old Eastbournians,5,0,5,0.0,1
Old Salopians,Old Etonians,23,24,47,3.5,16
Old Salopians,Old Foresters,19,44,63,3.176470588235294,17
Old Salopians,Old Haileyburians,11,1,12,1.0,2
Old Salopians,Old Harrovians,38,20,58,3.2857142857142856,14
Old Salopians,Old Ignatians,2,2,4,5.0,1
Old Salopians,Old Johnians,8,13,21,2.25,4
Old Salopians,Old Kimboltonians,14,5,19,2.75,4
Old Salopians,Old King's Scholars,7,1,8,2.0,2
Old Salopians,Old Malvernians,33,15,48,2.9,10
Old Salopians,Old Marlburians,35,27,62,2.8666666666666667,15
Old Salopians,Old Radleians,9,11,20,3.2,5
Old Salopians,Old Reptonians,8,14,22,2.8,5
Old Salopians,Old Rugbeians,17,16,33,3.3333333333333335,9
Old Salopians,Old Sennockians,4,1,5,2.0,1
Old Salopians,Old Shirburnians,4,0,4,1.0,1
Old Salopians,Old Tonbridgians,27,43,70,2.5294117647058822,17
Old Salopians,Old Westminsters,27,21,48,2.4,10
Old Salopians,Old Wokingians I,1,3,4,3.0,1
Old Salopians,Old Wykehamists,18,17,35,3.2222222222222223,9
Old Salopians,Shrewsbury School 1st XI,11,4,15,3.0,8
Old Salopians,South Bank Cuaco,3,0,3,2.0,1
Old Salopians,Southgate County,2,3,5,4.0,1
Old Salopians II,AFC Oldsmiths,2,1,3,4.0,1
Old Salopians II,Alexandra Park FC,2,3,5,4.0,1
Old Salopians II,Economicals,2,1,3,4.0,1
Old Salopians II,Kings College Wimbledon II,12,9,21,3.25,4
Old Salopians II,Lancing Old Boys II,7,11,18,3.1666666666666665,6
Old Salopians II,Latymer Old Boys,1,4,5,2.0,1
Old Salopians II,Old Aldenhamians II,21,12,33,2.888888888888889,9
Old Salopians II,Old Alleynians AFC,4,11,15,2.0,2
Old Salopians II,Old Alleynians AFC II,3,8,11,0.0,1
Old Salopians II,Old Amplefordians,5,14,19,1.6666666666666667,3
Old Salopians II,Old Ardinians,0,4,4,2.5,2
Old Salopians II,Old Ardinians II,1,6,7,2.0,2
Old Salopians II,Old Bancroftians AFC,3,2,5,4.0,2
Old Salopians II,Old Berkhamstedians,2,7,9,3.0,2
Old Salopians II,Old Berkhamstedians II,9,11,20,3.75,4
Old Salopians II,Old Brentwoods II,8,15,23,3.5,6
Old Salopians II,Old Brentwoods IV,10,18,28,1.0,5
Old Salopians II,Old Canfordians,11,10,21,2.0,3
Old Salopians II,Old Carthusians II,4,10,14,3.25,4
Old Salopians II,Old Carthusians III,8,17,25,2.3333333333333335,6
Old Salopians II,Old Cheltonians,17,20,37,3.5,6
Old Salopians II,Old Chigwellians II,11,23,34,2.0,8
Old Salopians II,Old Cholmeleians II,4,13,17,2.5,4
Old Salopians II,Old Citizens,13,27,40,3.0,8
Old Salopians II,Old Cranleighans,1,1,2,4.0,1
Old Salopians II,Old Eastbournians,25,16,41,3.7,10
Old Salopians II,Old Epsomians,12,27,39,3.2,10
Old Salopians II,Old Etonians II,2,9,11,1.5,2
Old Salopians II,Old Haberdashers,26,20,46,3.0,9
Old Salopians II,Old Harrovians II,5,14,19,2.8333333333333335,6
Old Salopians II,Old Harrovians III,3,7,10,3.0,2
Old Salopians II,Old Johnians FC,4,6,10,3.0,2
Old Salopians II,Old Johnians II,2,8,10,2.0,2
Old Salopians II,Old Kimboltonians,1,3,4,2.5,2
Old Salopians II,Old King's Scholars,2,4,6,3.0,1
Old Salopians II,Old Kingstonians,16,19,35,1.6666666666666667,6
Old Salopians II,Old Kingstonians KGS,1,5,6,2.0,1
Old Salopians II,Old Malvernians II,9,2,11,2.0,2
Old Salopians II,Old Marlburians,2,7,9,2.5,2
Old Salopians II,Old Merchant Taylors,4,3,7,4.0,2
Old Salopians II,Old Millfieldians,0,8,8,1.0,2
Old Salopians II,Old Minchendenians,2,9,11,0.0,1
Old Salopians II,Old Oundelians,29,7,36,1.4,5
Old Salopians II,Old Reptonians,6,5,11,4.5,2
Old Salopians II,Old Rugbeians,2,11,13,1.0,2
Old Salopians II,Old Sennockians,7,14,21,1.8333333333333333,6
Old Salopians II,Old Shirburnians,0,2,2,3.0,2
Old Salopians II,Old Stoics,14,22,36,3.1666666666666665,6
Old Salopians II,Old Tonbridgians II,8,14,22,3.8,5
Old Salopians II,Old Wellingtonians,15,14,29,2.8333333333333335,6
Old Salopians II,Old Westminster Citizens,1,3,4,3.0,1
Old Salopians II,Old Westminsters II,7,22,29,1.75,4
Old Salopians II,Old Woodhouseians,1,5,6,2.0,1
Old Salopians II,Old Wykehamists II,16,14,30,3.5,8
Old Salopians II,Shene Old Grammarians,0,1,1,3.0,1
Old Salopians II,Shrewsbury School 2nd XI,14,11,25,3.0,7
Old Salopians II,South Bank Cuaco,0,4,4,1.0,1
Old Salopians Vets,KCS Old Boys Vets,2,4,6,3.0,1
Old Salopians Vets,Lancing Old Boys Vets,6,0,6,0.0,1
Old Salopians Vets,Old Aldenhamians Vets,7,4,11,3.5,2
Old Salopians Vets,Old Bradfieldians Vets,16,12,28,3.4,5
Old Salopians Vets,Old Brentwoods Vets,2,9,11,2.3333333333333335,3
Old Salopians Vets,Old Carthusians Vets,2,9,11,0.0,1
Old Salopians Vets,Old Chigwellians Vets,7,11,18,3.3333333333333335,3
Old Salopians Vets,Old Foresters Vets,4,4,8,1.0,2
Old Salopians Vets,Old Harrovians Vets,5,14,19,2.6666666666666665,3
Old Salopians Vets,Old Malvernians Vets,8,0,8,1.0,2
Old Salopians Vets,Old Reptonians Vets,6,2,8,2.0,1
Old Salopians Vets,Old Tonbridgians Vets,3,7,10,1.6666666666666667,3
Old Salopians Vets,Old Wellingtonians Vets,3,3,6,5.0,1
Old Salopians Vets,Old Westminsters Vets,3,6,9,3.0,1
Old Salopians Vets,Old Wykehamists Vets,10,3,13,1.5,2
Old Salvatorians,Old Bancroftians AFC,5,0,5,0.0,1
Old Salvatorians,Old Brentwoods Vets,3,2,5,4.0,1
Old Salvatorians,Old Carthusians,0,5,5,0.0,1
Old Salvatorians,Old Carthusians III,1,3,4,3.0,1
Old Salvatorians,Old Cholmeleians II,5,1,6,2.0,1
Old Salvatorians,Old Foresters II,1,3,4,3.0,1
Old Sedcopians,Lancing Old Boys,4,1,5,2.0,1
Old Sedcopians,Old Aldenhamians,1,2,3,4.0,1
Old Sedcopians,Old Berkhamstedians,4,0,4,1.0,1
Old Sedcopians,Old Brentwoods,2,4,6,3.0,1
Old Sedcopians,Old Carthusians II,2,7,9,0.0,1
Old Sedcopians,Old Cholmeleians,4,6,10,4.0,2
Old Sedcopians,Old Cholmeleians II,2,1,3,4.0,1
Old Sedcopians,Old Rugbeians,1,3,4,3.0,1
Old Sennockians,Glyn Old Boys,0,2,2,2.0,1
Old Sennockians,KCS Old Boys II,3,2,5,3.0,2
Old Sennockians,Kings College Wimbledon II,5,4,9,3.0,4
Old Sennockians,Lancing Old Boys,1,6,7,0.0,1
Old Sennockians,Lancing Old Boys II,1,5,6,2.6666666666666665,3
Old Sennockians,National Westminster Bank,3,0,3,2.0,1
Old Sennockians,Old Albanians,4,0,4,1.0,1
Old Sennockians,Old Aldenhamians,17,20,37,3.0,7
Old Sennockians,Old Aldenhamians II,8,6,14,3.25,4
Old Sennockians,Old Alleynians AFC,0,10,10,1.3333333333333333,3
Old Sennockians,Old Alleynians II,7,14,21,2.75,4
Old Sennockians,Old Alleynians III,6,8,14,3.25,4
Old Sennockians,Old Amplefordians,21,7,28,2.0,5
Old Sennockians,Old Ardinians,5,1,6,2.0,1
Old Sennockians,Old Berkhamstedians,8,8,16,4.0,3
Old Sennockians,Old Berkhamstedians II,5,7,12,4.0,2
Old Sennockians,Old Brentwoods,0,5,5,0.0,1
Old Sennockians,Old Brentwoods II,7,13,20,3.4,5
Old Sennockians,Old Brentwoods III,20,5,25,1.8,5
Old Sennockians,Old Brentwoods IV,7,7,14,4.5,2
Old Sennockians,Old Carthusians II,16,27,43,3.1,10
Old Sennockians,Old Carthusians III,9,16,25,2.5,4
Old Sennockians,Old Challoners,0,0,0,4.0,1
Old Sennockians,Old Chigwellians,3,10,13,2.0,2
Old Sennockians,Old Chigwellians II,16,10,26,3.3,10
Old Sennockians,Old Chigwellians III,5,3,8,2.6666666666666665,3
Old Sennockians,Old Cholmeleians,2,1,3,4.0,1
Old Sennockians,Old Cholmeleians II,3,3,6,4.0,2
Old Sennockians,Old Cholmeleians III,8,6,14,3.0,2
Old Sennockians,Old Cholmeleians IV,10,6,16,4.0,2
Old Sennockians,Old Citizens,8,14,22,2.5,4
Old Sennockians,Old Columbans,4,4,8,3.5,2
Old Sennockians,Old Eastbournians,17,8,25,3.5,6
Old Sennockians,Old Epsomians,21,16,37,2.7777777777777777,9
Old Sennockians,Old Etonians II,11,24,35,2.7777777777777777,9
Old Sennockians,Old Foresters II,7,4,11,2.3333333333333335,3
Old Sennockians,Old Foresters III,13,3,16,2.0,3
Old Sennockians,Old Haberdashers,23,12,35,2.7142857142857144,7
Old Sennockians,Old Haileyburians,8,1,9,2.0,2
Old Sennockians,Old Hamptonians,3,1,4,3.0,1
Old Sennockians,Old Harrovians II,20,30,50,3.4166666666666665,12
Old Sennockians,Old Harrovians III,16,7,23,0.25,4
Old Sennockians,Old Johnians,3,10,13,2.5,4
Old Sennockians,Old Johnians FC,2,2,4,3.5,2
Old Sennockians,Old Kimboltonians,4,10,14,3.0,3
Old Sennockians,Old Malvernians,2,5,7,3.0,2
Old Sennockians,Old Meadonians,5,6,11,5.0,1
Old Sennockians,Old Merchant Taylors,14,8,22,2.8333333333333335,6
Old Sennockians,Old Merchant Taylors',9,5,14,1.5,2
Old Sennockians,Old Millhillians,4,10,14,2.6666666666666665,3
Old Sennockians,Old Oundelians,1,3,4,3.0,1
Old Sennockians,Old Radleians,5,16,21,2.25,4
Old Sennockians,Old Reptonians,1,9,10,0.0,1
Old Sennockians,Old Rugbeians,4,4,8,2.6666666666666665,3
Old Sennockians,Old Salopians,1,4,5,2.0,1
Old Sennockians,Old Salopians II,14,7,21,1.8333333333333333,6
Old Sennockians,Old Shirburnians,20,7,27,2.25,4
Old Sennockians,Old Stoics,8,7,15,3.5,4
Old Sennockians,Old Tonbridgians,0,6,6,0.0,1
Old Sennockians,Old Tonbridgians II,6,6,12,3.6,5
Old Sennockians,Old Wellingtonians,5,8,13,1.0,2
Old Sennockians,Old Westminsters,3,4,7,3.5,2
Old Sennockians,Old Westminsters II,14,7,21,3.0,4
Old Sennockians,Old Wilsonians,5,0,5,0.0,1
Old Sennockians,Old Wykehamists,3,3,6,4.0,2
Old Sennockians,Old Wykehamists II,9,4,13,3.0,2
Old Sennockians,Sevenoaks School 1st XI,1,3,4,3.0,2
Old Sennockians,Shene Old Grammarians,6,2,8,2.0,1
Old Sennockians,Somerville Old Boys,4,7,11,3.0,1
Old Sennockians,St Lawrence,1,3,4,3.5,2
Old Sennockians,TBC,2,1,3,4.0,1
Old Sennockians,The Warren First,3,4,7,4.0,1
Old Shirburnians,KCS Old Boys,2,4,6,3.0,1
Old Shirburnians,KCS Old Boys II,9,19,28,3.5,4
Old Shirburnians,Kings College Wimbledon II,6,4,10,3.3333333333333335,3
Old Shirburnians,Kings College Wimbledon III,11,2,13,1.0,2
Old Shirburnians,Lancing Old Boys II,10,3,13,2.0,2
Old Shirburnians,Old Albanians,5,4,9,3.0,2
Old Shirburnians,Old Albanians SA,6,6,12,3.6666666666666665,3
Old Shirburnians,Old Alleynians AFC II,3,18,21,1.3333333333333333,3
Old Shirburnians,Old Alleynians II,1,5,6,2.0,1
Old Shirburnians,Old Alleynians III,8,11,19,2.75,4
Old Shirburnians,Old Amplefordians,11,4,15,3.0,4
Old Shirburnians,Old Ardinians,5,3,8,2.6666666666666665,3
Old Shirburnians,Old Bancroftians AFC,9,2,11,1.0,2
Old Shirburnians,Old Berkhamstedians II,5,4,9,2.5,2
Old Shirburnians,Old Bradfieldians,1,7,8,2.0,2
Old Shirburnians,Old Brentwoods II,8,16,24,2.5,6
Old Shirburnians,Old Brentwoods III,1,3,4,3.0,1
Old Shirburnians,Old Brentwoods IV,10,6,16,3.3333333333333335,3
Old Shirburnians,Old Carthusians II,11,14,25,1.5,4
Old Shirburnians,Old Chigwellians III,4,1,5,2.0,1
Old Shirburnians,Old Cholmeleians II,0,3,3,2.0,1
Old Shirburnians,Old Cholmeleians III,5,0,5,0.0,1
Old Shirburnians,Old Citizens,4,2,6,3.0,1
Old Shirburnians,Old Columbans,4,4,8,2.0,2
Old Shirburnians,Old Eastbournians,2,1,3,4.0,1
Old Shirburnians,Old Epsomians,9,12,21,3.6666666666666665,6
Old Shirburnians,Old Epsomians II,7,6,13,1.3333333333333333,3
Old Shirburnians,Old Etonians II,2,4,6,3.0,1
Old Shirburnians,Old Haberdashers,6,8,14,3.6666666666666665,3
Old Shirburnians,Old Harrovians,5,1,6,2.0,1
Old Shirburnians,Old Harrovians II,5,8,13,3.0,2
Old Shirburnians,Old Harrovians III,17,17,34,3.111111111111111,9
Old Shirburnians,Old Johnians II,2,1,3,4.0,1
Old Shirburnians,Old Kimboltonians,9,12,21,2.4,5
Old Shirburnians,Old King's Scholars,22,17,39,3.5833333333333335,12
Old Shirburnians,Old Kingstonians KGS,11,10,21,5.0,3
Old Shirburnians,Old Merchant Taylors,9,13,22,2.75,4
Old Shirburnians,Old Merchant Taylors',2,1,3,4.0,1
Old Shirburnians,Old Merchant Taylors' II,3,1,4,3.0,1
Old Shirburnians,Old Reptonians,1,3,4,3.0,1
Old Shirburnians,Old Rugbeians,0,1,1,3.0,1
Old Shirburnians,Old Salopians,0,4,4,1.0,1
Old Shirburnians,Old Salopians II,2,0,2,3.0,2
Old Shirburnians,Old Sennockians,7,20,27,2.25,4
Old Shirburnians,Old Stoics,15,3,18,2.2,5
Old Shirburnians,Old Suttonians SV,4,1,5,2.0,1
Old Shirburnians,Old Tonbridgians II,8,10,18,1.5,4
Old Shirburnians,Old Wellingtonians,22,7,29,1.75,4
Old Shirburnians,Old Westminsters,2,3,5,4.0,1
Old Shirburnians,Old Westminsters II,22,8,30,2.25,4
Old Shirburnians,Old Wykehamists II,9,2,11,1.5,2
Old Shirburnians,Sherborne School 1st XI,4,10,14,1.3333333333333333,3
Old St Marys,Old Aldenhamians,0,2,2,2.0,1
Old Stationers,Old Carthusians,1,2,3,4.0,1
Old Stationers,Old Chigwellians,2,3,5,4.0,1
Old Stoics,Kings College Wimbledon II,1,2,3,4.0,1
Old Stoics,Kings College Wimbledon III,2,1,3,4.0,1
Old Stoics,Lancing Old Boys II,11,5,16,3.0,4
Old Stoics,Old Albanians SA,4,11,15,2.5,4
Old Stoics,Old Aldenhamians II,4,4,8,4.333333333333333,3
Old Stoics,Old Alleynians AFC,4,17,21,1.3333333333333333,3
Old Stoics,Old Alleynians AFC II,21,26,47,3.75,8
Old Stoics,Old Alleynians AFC III,3,3,6,2.5,2
Old Stoics,Old Amplefordians,19,25,44,3.0,7
Old Stoics,Old Ardinians,5,10,15,2.0,4
Old Stoics,Old Ardinians II,1,5,6,2.0,1
Old Stoics,Old Bancroftians AFC,21,17,38,3.0,10
Old Stoics,Old Berkhamstedians,1,4,5,2.0,1
Old Stoics,Old Berkhamstedians II,5,5,10,3.6666666666666665,3
Old Stoics,Old Brentwoods II,10,9,19,2.25,4
Old Stoics,Old Brentwoods III,16,15,31,2.2857142857142856,7
Old Stoics,Old Brentwoods IV,4,6,10,3.3333333333333335,3
Old Stoics,Old Canfordians,11,9,20,3.0,4
Old Stoics,Old Cheltonians,1,2,3,4.0,1
Old Stoics,Old Chigwellians III,8,15,23,2.1666666666666665,6
Old Stoics,Old Cholmeleians II,10,9,19,4.0,3
Old Stoics,Old Cholmeleians III,3,7,10,3.0,4
Old Stoics,Old Citizens,3,5,8,3.5,2
Old Stoics,Old Columbans,6,9,15,3.0,3
Old Stoics,Old Cranleighans,0,1,1,3.0,1
Old Stoics,Old Eastbournians,21,19,40,3.6666666666666665,6
Old Stoics,Old Epsomians,3,2,5,4.0,1
Old Stoics,Old Haberdashers,18,17,35,2.857142857142857,7
Old Stoics,Old Harrovians,3,13,16,1.0,2
Old Stoics,Old Harrovians II,2,8,10,2.0,2
Old Stoics,Old Harrovians III,26,26,52,2.8181818181818183,11
Old Stoics,Old Johnians FC,0,5,5,2.0,2
Old Stoics,Old Johnians II,3,4,7,4.5,2
Old Stoics,Old Kimboltonians,5,12,17,1.5,2
Old Stoics,Old King's Scholars,16,14,30,3.3333333333333335,6
Old Stoics,Old Kingstonians,3,13,16,2.5,2
Old Stoics,Old Kingstonians KGS,6,0,6,0.0,1
Old Stoics,Old Malvernians II,9,2,11,2.3333333333333335,3
Old Stoics,Old Merchant Taylors,5,6,11,4.0,3
Old Stoics,Old Merchant Taylors II,8,1,9,2.0,2
Old Stoics,Old Millhillians,6,9,15,2.3333333333333335,3
Old Stoics,Old Oundelians,11,8,19,3.2,5
Old Stoics,Old Rugbeians,2,15,17,1.0,3
Old Stoics,Old Salopians II,22,14,36,3.1666666666666665,6
Old Stoics,Old Sennockians,7,8,15,3.5,4
Old Stoics,Old Shirburnians,3,15,18,2.2,5
Old Stoics,Old Suttonians SV,19,21,40,3.1666666666666665,6
Old Stoics,Old Tonbridgians II,5,6,11,4.5,2
Old Stoics,Old Uppinghamians,5,1,6,2.0,1
Old Stoics,Old Wellingtonians,15,16,31,2.8,5
Old Stoics,Old Westminsters,1,6,7,0.0,1
Old Stoics,Old Westminsters II,3,4,7,3.5,2
Old Stoics,Old Wimbledonians,1,7,8,0.0,1
Old Stoics,Old Wykehamists II,29,26,55,3.3,10
Old Stoics,Stowe School,11,17,28,3.25,4
Old Strand Academicals,Old Aldenhamians,8,9,17,3.6666666666666665,3
Old Strand Academicals,Old Alleynians AFC,0,3,3,2.0,1
Old Strand Academicals,Old Malvernians,1,2,3,4.0,1
Old Strand Academicals,Old Rugbeians,1,4,5,2.0,1
Old Strand Academicals,Old Suttonians SV,7,6,13,5.0,1
Old Suttonians,Old Alleynians,4,3,7,4.0,1
Old Suttonians,Old Bancroftians AFC,0,1,1,3.0,1
Old Suttonians,Old Berkhamstedians,3,2,5,4.0,1
Old Suttonians,Old Bradfieldians,3,9,12,0.0,1
Old Suttonians,Old Brentwoods,8,4,12,3.5,2
Old Suttonians,Old Carthusians,0,4,4,2.5,2
Old Suttonians,Old Carthusians III,5,2,7,2.0,1
Old Suttonians,Old Cholmeleians,8,0,8,0.0,1
Old Suttonians,Old Etonians II,0,1,1,3.0,1
Old Suttonians,Old Foresters,3,2,5,4.0,1
Old Suttonians,Old Foresters II,5,0,5,0.0,1
Old Suttonians,Old King's Scholars,2,3,5,4.0,1
Old Suttonians II,Old Alleynians II,1,2,3,4.0,1
Old Suttonians II,Old Etonians II,2,0,2,2.0,1
Old Suttonians IV,Old Epsomians,3,0,3,2.0,1
Old Suttonians SV,Kings College Wimbledon II,6,8,14,3.5,4
Old Suttonians SV,Lancing Old Boys II,6,2,8,3.0,2
Old Suttonians SV,Old Alleynians AFC II,13,15,28,3.6,5
Old Suttonians SV,Old Alleynians II,0,6,6,0.0,1
Old Suttonians SV,Old Amplefordians,8,8,16,2.5,2
Old Suttonians SV,Old Ardinians,3,0,3,2.0,1
Old Suttonians SV,Old Bancroftians AFC,16,13,29,2.8333333333333335,6
Old Suttonians SV,Old Berkhamstedians,3,12,15,0.5,2
Old Suttonians SV,Old Brentwoods II,8,6,14,2.0,3
Old Suttonians SV,Old Carthusians III,15,6,21,3.0,3
Old Suttonians SV,Old Chigwellians III,4,3,7,4.0,1
Old Suttonians SV,Old Cholmeleians II,20,14,34,3.75,4
Old Suttonians SV,Old Columbans,9,10,19,3.25,4
Old Suttonians SV,Old Eastbournians,15,7,22,2.0,3
Old Suttonians SV,Old Epsomians,8,5,13,1.5,2
Old Suttonians SV,Old Foresters II,2,2,4,5.0,1
Old Suttonians SV,Old Haberdashers,26,28,54,3.2857142857142856,7
Old Suttonians SV,Old Harrovians II,1,5,6,2.0,1
Old Suttonians SV,Old Harrovians III,8,5,13,2.0,3
Old Suttonians SV,Old Johnians FC,4,10,14,3.25,4
Old Suttonians SV,Old Merchant Taylors,1,5,6,2.5,2
Old Suttonians SV,Old Merchant Taylors II,7,2,9,2.5,2
Old Suttonians SV,Old Reptonians,1,5,6,2.0,1
Old Suttonians SV,Old Rugbeians,10,11,21,3.75,4
Old Suttonians SV,Old Shirburnians,1,4,5,2.0,1
Old Suttonians SV,Old Stoics,21,19,40,3.1666666666666665,6
Old Suttonians SV,Old Strand Academicals,6,7,13,5.0,1
Old Suttonians SV,Old Tonbridgians II,18,14,32,3.6666666666666665,6
Old Suttonians SV,Old Wellingtonians,4,5,9,3.5,2
Old Suttonians SV,Old Westminsters,9,10,19,2.5,2
Old Suttonians SV,Old Wykehamists II,22,8,30,2.5,4
Old Tenisonians,Old Carthusians,1,2,3,4.0,1
Old Tenisonians,Old Chigwellians II,2,1,3,4.0,1
Old Tenisonians,Old Etonians II,0,4,4,2.5,2
Old Tenisonians,Old Merchant Taylors,2,1,3,4.0,1
Old Tenisonians II,KCS Old Boys II,0,2,2,2.0,1
Old Tenisonians II,Kings College Wimbledon II,7,0,7,0.0,1
Old Tenisonians II,Old Alleynians II,1,2,3,4.0,1
Old Tenisonians IV,Old Alleynians III,1,9,10,0.0,1
Old Thorntonians,Old Aldenhamians II,5,0,5,0.0,1
Old Thorntonians,Old Carthusians,2,8,10,2.0,2
Old Thorntonians,Old Carthusians II,5,1,6,2.0,1
Old Thorntonians,Old Etonians,2,0,2,2.0,1
Old Thorntonians,Old Rugbeians,2,12,14,1.0,1
Old Thorntonians III,Old Carthusians II,2,1,3,4.0,1
Old Thorntonians IV,Kings College Wimbledon II,1,5,6,2.0,1
Old Tiffinians,KCS Old Boys,1,9,10,0.0,1
Old Tiffinians,Old Aldenhamians II,3,7,10,2.0,1
Old Tiffinians,Old Cholmeleians,1,2,3,4.0,1
Old Tiffinians,Old Malvernians,2,5,7,2.0,1
Old Tollingtonians,Old Cholmeleians,1,3,4,3.0,1
Old Tollingtonians,Old Malvernians,5,2,7,2.0,1
Old Tollingtonians,Old Reptonians,2,3,5,4.0,1
Old Tollingtonians,Old Westminsters,2,1,3,4.0,1
Old Tonbridgians,KCS Old Boys,39,47,86,3.0454545454545454,22
Old Tonbridgians,Lancing Old Boys,26,25,51,3.0,10
Old Tonbridgians,Old Aldenhamians,13,6,19,1.75,4
Old Tonbridgians,Old Alleynians,14,33,47,2.5555555555555554,9
Old Tonbridgians,Old Alleynians AFC,6,9,15,3.5,4
Old Tonbridgians,Old Ardinians,3,2,5,4.0,1
Old Tonbridgians,Old Berkhamstedians,2,0,2,2.0,1
Old Tonbridgians,Old Bradfieldians,29,24,53,3.2142857142857144,14
Old Tonbridgians,Old Brentwoods,36,37,73,2.857142857142857,14
Old Tonbridgians,Old Carthusians,40,91,131,2.5833333333333335,24
Old Tonbridgians,Old Chigwellians,38,21,59,2.9166666666666665,12
Old Tonbridgians,Old Cholmeleians,16,23,39,3.4444444444444446,9
Old Tonbridgians,Old Epsomians,5,1,6,2.0,1
Old Tonbridgians,Old Etonians,44,46,90,3.130434782608696,23
Old Tonbridgians,Old Foresters,33,38,71,3.0,19
Old Tonbridgians,Old Haileyburians,6,5,11,4.5,2
Old Tonbridgians,Old Harrovians,36,26,62,3.0714285714285716,14
Old Tonbridgians,Old Ignatians,1,6,7,0.0,1
Old Tonbridgians,Old Johnians,3,5,8,3.6666666666666665,3
Old Tonbridgians,Old Kimboltonians,2,1,3,4.0,1
Old Tonbridgians,Old King's Scholars,12,1,13,0.5,2
Old Tonbridgians,Old Malvernians,15,4,19,2.5,4
Old Tonbridgians,Old Marlburians,29,11,40,2.875,8
Old Tonbridgians,Old Millfieldians,5,1,6,2.0,1
Old Tonbridgians,Old Oundelians,4,1,5,2.0,1
Old Tonbridgians,Old Parmiterians,1,6,7,0.0,1
Old Tonbridgians,Old Radleians,17,9,26,3.6,5
Old Tonbridgians,Old Reptonians,12,12,24,3.875,8
Old Tonbridgians,Old Rugbeians,8,2,10,2.0,2
Old Tonbridgians,Old Salopians,43,27,70,2.5294117647058822,17
Old Tonbridgians,Old Sennockians,6,0,6,0.0,1
Old Tonbridgians,Old Westminsters,18,10,28,3.5,6
Old Tonbridgians,Old Wykehamists,34,24,58,2.8461538461538463,13
Old Tonbridgians,Tonbridge School 1st XI,3,1,4,3.0,1
Old Tonbridgians II,KCS Old Boys II,1,4,5,2.0,1
Old Tonbridgians II,Kings College Wimbledon II,13,9,22,2.4285714285714284,7
Old Tonbridgians II,Lancing Old Boys II,8,7,15,0.0,2
Old Tonbridgians II,Old Albanians,3,9,12,2.5,2
Old Tonbridgians II,Old Aldenhamians,2,9,11,2.0,2
Old Tonbridgians II,Old Aldenhamians II,22,5,27,1.5,4
Old Tonbridgians II,Old Alleynians AFC,9,13,22,3.0,6
Old Tonbridgians II,Old Alleynians AFC II,4,3,7,4.0,2
Old Tonbridgians II,Old Alleynians II,0,11,11,1.5,2
Old Tonbridgians II,Old Alleynians III,10,16,26,3.25,4
Old Tonbridgians II,Old Amplefordians,11,11,22,3.1666666666666665,6
Old Tonbridgians II,Old Ardinians,1,10,11,1.0,2
Old Tonbridgians II,Old Bancroftians AFC,16,8,24,2.75,8
Old Tonbridgians II,Old Berkhamstedians,3,2,5,4.0,1
Old Tonbridgians II,Old Berkhamstedians II,2,4,6,3.5,2
Old Tonbridgians II,Old Brentwoods II,18,11,29,2.8333333333333335,6
Old Tonbridgians II,Old Brentwoods III,7,5,12,3.0,2
Old Tonbridgians II,Old Brentwoods IV,2,0,2,2.0,1
Old Tonbridgians II,Old Carthusians II,8,10,18,3.75,4
Old Tonbridgians II,Old Carthusians III,18,9,27,3.6,5
Old Tonbridgians II,Old Cheltonians,2,0,2,2.0,1
Old Tonbridgians II,Old Chigwellians II,1,4,5,3.0,2
Old Tonbridgians II,Old Cholmeleians II,9,11,20,2.0,5
Old Tonbridgians II,Old Cholmeleians IV,14,2,16,1.5,2
Old Tonbridgians II,Old Citizens,1,11,12,2.0,2
Old Tonbridgians II,Old Columbans,5,7,12,4.5,2
Old Tonbridgians II,Old Dorkinians,5,1,6,2.0,1
Old Tonbridgians II,Old Eastbournians,8,2,10,2.6666666666666665,3
Old Tonbridgians II,Old Epsomians,21,21,42,3.3636363636363638,11
Old Tonbridgians II,Old Epsomians II,2,0,2,2.0,1
Old Tonbridgians II,Old Etonians II,3,6,9,3.5,2
Old Tonbridgians II,Old Foresters II,2,2,4,3.5,2
Old Tonbridgians II,Old Haberdashers,11,11,22,2.75,4
Old Tonbridgians II,Old Harrovians III,8,7,15,3.25,4
Old Tonbridgians II,Old Johnians FC,7,14,21,2.5,4
Old Tonbridgians II,Old Johnians II,5,0,5,2.0,2
Old Tonbridgians II,Old Kimboltonians,4,21,25,2.0,4
Old Tonbridgians II,Old King's Scholars,11,10,21,4.0,4
Old Tonbridgians II,Old Kingstonians,5,3,8,4.0,2
Old Tonbridgians II,Old Malvernians,4,5,9,5.0,1
Old Tonbridgians II,Old Malvernians II,6,2,8,2.5,2
Old Tonbridgians II,Old Meadonians,5,4,9,5.0,1
Old Tonbridgians II,Old Merchant Taylors,12,13,25,3.3333333333333335,6
Old Tonbridgians II,Old Merchant Taylors II,10,6,16,4.0,2
Old Tonbridgians II,Old Millhillians,3,13,16,2.0,3
Old Tonbridgians II,Old Oundelians,3,11,14,2.8,5
Old Tonbridgians II,Old Radleians,4,3,7,4.0,1
Old Tonbridgians II,Old Rugbeians,21,13,34,2.857142857142857,7
Old Tonbridgians II,Old Salopians II,14,8,22,3.8,5
Old Tonbridgians II,Old Sennockians,6,6,12,3.6,5
Old Tonbridgians II,Old Shirburnians,10,8,18,1.5,4
Old Tonbridgians II,Old Stoics,6,5,11,4.5,2
Old Tonbridgians II,Old Suttonians SV,14,18,32,3.6666666666666665,6
Old Tonbridgians II,Old Wellingtonians,13,10,23,4.0,5
Old Tonbridgians II,Old Westminsters II,31,15,46,3.2222222222222223,9
Old Tonbridgians II,Old Wykehamists II,12,3,15,1.5,2
Old Tonbridgians II,Tonbridge School 2nd XI,5,0,5,0.0,1
Old Tonbridgians II,UCL Academicals IV,1,11,12,0.0,1
Old Tonbridgians Vets,Lancing Old Boys Vets,3,14,17,1.6666666666666667,3
Old Tonbridgians Vets,Old Brentwoods Vets,4,4,8,3.0,2
Old Tonbridgians Vets,Old Carthusians Vets,4,9,13,3.0,4
Old Tonbridgians Vets,Old Chigwellians Vets,1,2,3,4.0,1
Old Tonbridgians Vets,Old Etonians Vets,3,5,8,3.5,2
Old Tonbridgians Vets,Old Harrovians Vets,1,2,3,4.0,2
Old Tonbridgians Vets,Old Malvernians Vets,7,10,17,0.6666666666666666,3
Old Tonbridgians Vets,Old Reptonians Vets,1,3,4,3.0,1
Old Tonbridgians Vets,Old Salopians Vets,7,3,10,1.6666666666666667,3
Old Tonbridgians Vets,Old Wellingtonians Vets,7,3,10,3.0,2
Old Tonbridgians Vets,Old Westminsters Vets,2,17,19,0.0,2
Old Tonbridgians Vets,Old Wykehamists Vets,10,4,14,2.5,2
Old Uffingtonians FC,Old Malvernians,6,4,10,3.0,2
Old Uffingtonians FC,Old Reptonians,3,2,5,4.0,1
Old Uppinghamians,Old Stoics,1,5,6,2.0,1
Old Vaughanians,Old Aldenhamians II,0,3,3,2.0,1
Old Vaughanians,Old Cholmeleians,3,0,3,2.0,1
Old Vaughanians,Old Haberdashers,3,7,10,2.0,1
Old Vaughanians,Old Reptonians,4,2,6,3.0,1
Old Wellingburians,Lancing Old Boys II,2,3,5,4.0,1
Old Wellingburians,Old Aldenhamians II,4,4,8,6.0,1
Old Wellingburians,Old Brentwoods II,0,8,8,0.0,1
Old Wellingburians,Old Kimboltonians,7,9,16,1.3333333333333333,3
Old Wellingtonians,Kings College Wimbledon II,1,1,2,3.0,2
Old Wellingtonians,Lancing Old Boys II,38,17,55,2.8181818181818183,11
Old Wellingtonians,Old Albanians SA,6,15,21,2.6666666666666665,3
Old Wellingtonians,Old Aldenhamians,10,14,24,3.0,6
Old Wellingtonians,Old Aldenhamians II,19,10,29,2.0,4
Old Wellingtonians,Old Alleynians AFC III,4,3,7,4.0,1
Old Wellingtonians,Old Amplefordians,13,12,25,2.25,4
Old Wellingtonians,Old Ardinians,3,8,11,1.3333333333333333,3
Old Wellingtonians,Old Ardinians II,14,5,19,1.5,2
Old Wellingtonians,Old Berkhamstedians,2,8,10,2.0,2
Old Wellingtonians,Old Berkhamstedians II,9,27,36,2.4,5
Old Wellingtonians,Old Bradfieldians,13,22,35,2.8333333333333335,6
Old Wellingtonians,Old Brentwoods,5,14,19,2.75,4
Old Wellingtonians,Old Brentwoods III,8,8,16,3.0,3
Old Wellingtonians,Old Canfordians,1,5,6,2.5,2
Old Wellingtonians,Old Carthusians II,3,20,23,2.2857142857142856,7
Old Wellingtonians,Old Carthusians III,17,26,43,3.6,10
Old Wellingtonians,Old Cheltonians,3,1,4,3.0,1
Old Wellingtonians,Old Chigwellians,3,8,11,3.3333333333333335,3
Old Wellingtonians,Old Chigwellians II,10,12,22,3.3333333333333335,6
Old Wellingtonians,Old Cholmeleians,8,17,25,2.25,4
Old Wellingtonians,Old Cholmeleians II,26,24,50,3.5555555555555554,9
Old Wellingtonians,Old Columbans,5,8,13,4.0,2
Old Wellingtonians,Old Cranleighans,3,1,4,3.0,1
Old Wellingtonians,Old Eastbournians,2,1,3,4.0,1
Old Wellingtonians,Old Epsomians,9,9,18,3.5,4
Old Wellingtonians,Old Etonians II,1,5,6,1.5,2
Old Wellingtonians,Old Foresters II,3,1,4,3.5,2
Old Wellingtonians,Old Haberdashers,21,28,49,2.5,8
Old Wellingtonians,Old Haileyburians,16,2,18,1.0,2
Old Wellingtonians,Old Harrovians,1,16,17,1.5,4
Old Wellingtonians,Old Harrovians III,12,21,33,3.5714285714285716,7
Old Wellingtonians,Old Johnians FC,7,13,20,3.0,4
Old Wellingtonians,Old Johnians II,4,4,8,4.0,2
Old Wellingtonians,Old King's Scholars,16,18,34,2.6666666666666665,9
Old Wellingtonians,Old Kingstonians,8,9,17,3.6666666666666665,3
Old Wellingtonians,Old Malvernians,14,15,29,2.8333333333333335,6
Old Wellingtonians,Old Marlburians,2,7,9,1.5,2
Old Wellingtonians,Old Millfieldians,7,4,11,3.5,2
Old Wellingtonians,Old Oundelians,7,3,10,2.0,1
Old Wellingtonians,Old Radleians,10,14,24,3.2,5
Old Wellingtonians,Old Reptonians,12,17,29,3.625,8
Old Wellingtonians,Old Rugbeians,4,5,9,4.5,2
Old Wellingtonians,Old Salopians II,14,15,29,2.8333333333333335,6
Old Wellingtonians,Old Sennockians,8,5,13,1.0,2
Old Wellingtonians,Old Shirburnians,7,22,29,1.75,4
Old Wellingtonians,Old Stoics,16,15,31,2.8,5
Old Wellingtonians,Old Suttonians SV,5,4,9,3.5,2
Old Wellingtonians,Old Tonbridgians II,10,13,23,4.0,5
Old Wellingtonians,Old Wellingtonians Select XI,1,1,2,4.0,1
Old Wellingtonians,Old Westminsters II,5,8,13,4.0,2
Old Wellingtonians,Old Wykehamists,8,7,15,3.5,4
Old Wellingtonians,Old Wykehamists II,5,5,10,3.0,4
Old Wellingtonians,Wellington College 1st XI,1,1,2,4.0,1
Old Wellingtonians Select XI,Old Wellingtonians,1,1,2,4.0,1
Old Wellingtonians Vets,KCS Old Boys Vets,4,4,8,3.0,2
Old Wellingtonians Vets,Lancing Old Boys Vets,2,2,4,4.0,2
Old Wellingtonians Vets,Old Aldenhamians Vets,6,4,10,4.0,2
Old Wellingtonians Vets,Old Berkhamstedians Vets,7,1,8,2.0,2
Old Wellingtonians Vets,Old Bradfieldians Vets,9,12,21,2.6666666666666665,3
Old Wellingtonians Vets,Old Carthusians Vets,4,1,5,2.0,1
Old Wellingtonians Vets,Old Chigwellians Vets Blues,3,5,8,4.0,1
Old Wellingtonians Vets,Old Haileyburians Vets,8,8,16,0.0,2
Old Wellingtonians Vets,Old Reptonians Vets,5,1,6,2.0,1
Old Wellingtonians Vets,Old Salopians Vets,3,3,6,5.0,1
Old Wellingtonians Vets,Old Tonbridgians Vets,3,7,10,3.0,2
Old Westminster Citizens,Old Salopians II,3,1,4,3.0,1
Old Westminster Citizens Vets,Old Brentwoods Vets,4,3,7,4.0,1
Old Westminsters,Carshalton,2,0,2,2.0,1
Old Westminsters,Forest Green,7,4,11,3.0,1
Old Westminsters,KCS Old Boys,1,5,6,2.5,2
Old Westminsters,Kings College Wimbledon II,19,15,34,2.857142857142857,7
Old Westminsters,Lancing Old Boys,32,16,48,3.25,8
Old Westminsters,Lancing Old Boys II,26,21,47,2.125,8
Old Westminsters,New College Old Boys,9,4,13,2.5,2
Old Westminsters,Old Aldenhamians,23,8,31,2.5714285714285716,7
Old Westminsters,Old Alleynians AFC,3,4,7,4.0,2
Old Westminsters,Old Alleynians II,0,4,4,1.0,1
Old Westminsters,Old Ardinians,1,2,3,4.0,1
Old Westminsters,Old Berkhamstedians,38,35,73,3.2,15
Old Westminsters,Old Bradfieldians,15,26,41,2.875,8
Old Westminsters,Old Brentwoods,11,13,24,2.5,4
Old Westminsters,Old Brentwoods II,0,1,1,3.0,1
Old Westminsters,Old Carthusians,0,5,5,0.0,1
Old Westminsters,Old Carthusians II,21,21,42,3.0,9
Old Westminsters,Old Carthusians III,15,26,41,3.625,8
Old Westminsters,Old Chigwellians,18,23,41,2.25,8
Old Westminsters,Old Chigwellians II,16,3,19,1.5,4
Old Westminsters,Old Cholmeleians,5,8,13,3.75,4
Old Westminsters,Old Cholmeleians II,13,7,20,3.0,2
Old Westminsters,Old Citizens,9,5,14,3.6666666666666665,3
Old Westminsters,Old Columbans,4,2,6,3.0,1
Old Westminsters,Old Eastbournians,17,2,19,1.3333333333333333,3
Old Westminsters,Old Epsomians,9,1,10,0.0,1
Old Westminsters,Old Etonians,2,3,5,4.0,1
Old Westminsters,Old Etonians II,35,19,54,3.5454545454545454,11
Old Westminsters,Old Foresters,2,5,7,3.0,2
Old Westminsters,Old Foresters II,18,18,36,3.6666666666666665,9
Old Westminsters,Old Haileyburians,28,14,42,2.4444444444444446,9
Old Westminsters,Old Harrovians,9,9,18,2.6,5
Old Westminsters,Old Harrovians II,16,4,20,2.2,5
Old Westminsters,Old Harrovians III,2,2,4,5.0,1
Old Westminsters,Old Isleworthians,4,1,5,2.0,1
Old Westminsters,Old Johnians,8,9,17,2.75,4
Old Westminsters,Old King's Scholars,15,8,23,3.0,4
Old Westminsters,Old Malvernians,37,21,58,3.0,11
Old Westminsters,Old Marlburians,23,28,51,3.6666666666666665,12
Old Westminsters,Old Merchant Taylors,15,4,19,2.5,4
Old Westminsters,Old Millfieldians,4,4,8,5.0,2
Old Westminsters,Old Radleians,31,29,60,2.6666666666666665,12
Old Westminsters,Old Reptonians,12,25,37,3.5,12
Old Westminsters,Old Rugbeians,21,18,39,3.2,10
Old Westminsters,Old Salopians,21,27,48,2.4,10
Old Westminsters,Old Sennockians,4,3,7,3.5,2
Old Westminsters,Old Shirburnians,3,2,5,4.0,1
Old Westminsters,Old Stoics,6,1,7,0.0,1
Old Westminsters,Old Suttonians SV,10,9,19,2.5,2
Old Westminsters,Old Tollingtonians,1,2,3,4.0,1
Old Westminsters,Old Tonbridgians,10,18,28,3.5,6
Old Westminsters,Old Woodhouseians,1,3,4,3.0,1
Old Westminsters,Old Wykehamists,18,22,40,3.9,10
Old Westminsters,Putney Saint-Germain,3,9,12,2.5,2
Old Westminsters,Rob Roy Rovers,1,4,5,2.0,1
Old Westminsters,Royal Bank of Scotland,3,2,5,4.0,1
Old Westminsters,Shene FC,4,4,8,6.0,1
Old Westminsters,Weirside Rangers,3,2,5,4.0,1
Old Westminsters,Westminster School 1st XI,13,10,23,3.875,8
Old Westminsters II,Civil Service III,0,7,7,0.0,1
Old Westminsters II,Egbertian FC,1,0,1,3.0,1
Old Westminsters II,Hale End Athletic,1,7,8,0.0,1
Old Westminsters II,KCS Old Boys II,4,2,6,3.0,1
Old Westminsters II,Kings College Wimbledon III,9,6,15,3.0,4
Old Westminsters II,Lancing Old Boys II,9,3,12,2.0,2
Old Westminsters II,Old Albanians SA,4,4,8,5.0,2
Old Westminsters II,Old Alleynians AFC,8,20,28,3.0,5
Old Westminsters II,Old Alleynians AFC II,5,9,14,3.0,2
Old Westminsters II,Old Alleynians AFC III,4,7,11,3.5,2
Old Westminsters II,Old Alleynians III,3,3,6,5.0,1
Old Westminsters II,Old Amplefordians,48,46,94,2.857142857142857,21
Old Westminsters II,Old Ardinians,6,4,10,2.6666666666666665,3
Old Westminsters II,Old Ardinians II,5,6,11,4.5,2
Old Westminsters II,Old Bancroftians AFC,3,2,5,4.0,2
Old Westminsters II,Old Berkhamstedians,2,5,7,3.5,2
Old Westminsters II,Old Berkhamstedians II,22,21,43,3.111111111111111,9
Old Westminsters II,Old Brentwoods III,11,22,33,2.4,5
Old Westminsters II,Old Brentwoods IV,12,4,16,2.6666666666666665,3
Old Westminsters II,Old Cheltonians,7,4,11,3.6666666666666665,3
Old Westminsters II,Old Chigwellians III,4,9,13,3.0,4
Old Westminsters II,Old Cholmeleians III,7,7,14,2.0,2
Old Westminsters II,Old Citizens,4,13,17,2.6666666666666665,3
Old Westminsters II,Old Columbans,0,5,5,0.0,1
Old Westminsters II,Old Eastbournians,27,12,39,3.25,12
Old Westminsters II,Old Epsomians,8,4,12,3.6666666666666665,3
Old Westminsters II,Old Epsomians II,6,2,8,2.0,2
Old Westminsters II,Old Foresters III,7,5,12,3.3333333333333335,3
Old Westminsters II,Old Haberdashers,5,4,9,3.0,3
Old Westminsters II,Old Harrovians II,5,13,18,2.6666666666666665,3
Old Westminsters II,Old Harrovians III,31,19,50,3.3,10
Old Westminsters II,Old Johnians FC,3,9,12,2.3333333333333335,3
Old Westminsters II,Old Johnians II,4,1,5,2.0,1
Old Westminsters II,Old Kimboltonians,0,5,5,0.0,1
Old Westminsters II,Old King's Scholars,40,17,57,2.2,10
Old Westminsters II,Old Kingstonians,14,14,28,2.6666666666666665,6
Old Westminsters II,Old Kingstonians KGS,22,14,36,2.7142857142857144,7
Old Westminsters II,Old Malvernians II,13,12,25,3.8333333333333335,6
Old Westminsters II,Old Merchant Taylors II,1,2,3,4.0,1
Old Westminsters II,Old Merchant Taylors' II,2,1,3,4.0,1
Old Westminsters II,Old Millhillians,2,10,12,2.6666666666666665,3
Old Westminsters II,Old Oundelians,30,24,54,2.888888888888889,9
Old Westminsters II,Old Rugbeians,5,16,21,1.75,4
Old Westminsters II,Old Salopians II,22,7,29,1.75,4
Old Westminsters II,Old Sennockians,7,14,21,3.0,4
Old Westminsters II,Old Shirburnians,8,22,30,2.25,4
Old Westminsters II,Old Stoics,4,3,7,3.5,2
Old Westminsters II,Old Tonbridgians II,15,31,46,3.2222222222222223,9
Old Westminsters II,Old Wellingtonians,8,5,13,4.0,2
Old Westminsters II,Old Wokingians,2,7,9,0.0,1
Old Westminsters II,Old Wykehamists II,23,13,36,3.0,8
Old Westminsters II,South Bank Cuaco,2,6,8,2.0,1
Old Westminsters II,Steuerman Select Work XI,2,1,3,4.0,1
Old Westminsters II,Westminster School 2nd XI,19,10,29,3.0,8
Old Westminsters Vets,KCS Old Boys Vets,5,2,7,2.0,1
Old Westminsters Vets,Lancing Old Boys Vets,13,15,28,4.0,2
Old Westminsters Vets,Old Berkhamstedians Vets,1,2,3,4.0,1
Old Westminsters Vets,Old Bradfieldians Vets,2,4,6,2.5,2
Old Westminsters Vets,Old Carthusians Vets,1,7,8,2.0,2
Old Westminsters Vets,Old Chigwellians Vets,2,4,6,3.0,1
Old Westminsters Vets,Old Cholmeleians Vets,3,5,8,3.5,2
Old Westminsters Vets,Old Foresters Vets,1,4,5,2.0,1
Old Westminsters Vets,Old Haileyburians Vets,3,5,8,4.0,1
Old Westminsters Vets,Old Harrovians Vets,3,5,8,4.0,2
Old Westminsters Vets,Old Kimboltonians Vets,1,2,3,4.0,1
Old Westminsters Vets,Old Malvernians Vets,2,1,3,4.0,1
Old Westminsters Vets,Old Reptonians Vets,2,2,4,5.0,1
Old Westminsters Vets,Old Salopians Vets,6,3,9,3.0,1
Old Westminsters Vets,Old Tonbridgians Vets,17,2,19,0.0,2
Old Westminsters Vets,Old Wykehamists Veterans,2,1,3,4.0,1
Old Westminsters Vets,Old Wykehamists Vets,16,2,18,1.3333333333333333,3
Old Whitgiftians,Old Carthusians III,0,3,3,2.0,1
Old Whitgiftians,Old Epsomians,0,0,0,4.0,1
Old Wilsonians,Old Brentwoods,1,2,3,4.0,1
Old Wilsonians,Old Brentwoods III,5,1,6,2.0,1
Old Wilsonians,Old Carthusians,8,8,16,3.5,6
Old Wilsonians,Old Chigwellians,2,1,3,4.0,1
Old Wilsonians,Old Cholmeleians,3,1,4,3.0,1
Old Wilsonians,Old Etonians,0,4,4,2.5,2
Old Wilsonians,Old Etonians II,4,1,5,2.0,1
Old Wilsonians,Old King's Scholars,3,4,7,4.0,1
Old Wilsonians,Old Merchant Taylors,0,3,3,2.0,1
Old Wilsonians,Old Sennockians,0,5,5,0.0,1
Old Wilsonians IV,Old Alleynians III,1,2,3,4.0,1
Old Wilsonians V,Lancing Old Boys II,1,0,1,3.0,1
Old Wilsonians Vets,Old Chigwellians Vets,4,0,4,1.0,1
Old Wimbledonians,Old Stoics,7,1,8,0.0,1
Old Wokingians,Old Carthusians,2,0,2,2.0,1
Old Wokingians,Old Carthusians II,1,3,4,3.0,2
Old Wokingians,Old Carthusians III,1,4,5,3.0,2
Old Wokingians,Old Foresters,1,2,3,4.0,1
Old Wokingians,Old Johnians FC,1,2,3,4.0,1
Old Wokingians,Old Kingstonians KGS,0,5,5,0.0,1
Old Wokingians,Old Reptonians,4,0,4,1.0,1
Old Wokingians,Old Westminsters II,7,2,9,0.0,1
Old Wokingians I,Old Salopians,3,1,4,3.0,1
Old Woodhouseians,Lancing Old Boys,5,0,5,0.0,1
Old Woodhouseians,Old Carthusians,1,9,10,0.0,1
Old Woodhouseians,Old Cholmeleians,3,1,4,3.0,1
Old Woodhouseians,Old Salopians II,5,1,6,2.0,1
Old Woodhouseians,Old Westminsters,3,1,4,3.0,1
Old Woodhouseians II,Old Alleynians II,1,0,1,3.0,1
Old Woodhouseians II,Old Brentwoods II,6,4,10,4.0,1
Old Woodhouseians II,Old Merchant Taylors,3,1,4,3.0,1
Old Wykehamists,KCS Old Boys,27,38,65,2.5,14
Old Wykehamists,Lancing Old Boys,12,17,29,2.3333333333333335,6
Old Wykehamists,London Welsh F.C.,3,1,4,3.0,1
Old Wykehamists,New College Old Boys,8,1,9,0.0,1
Old Wykehamists,Old Aldenhamians,24,22,46,3.0,10
Old Wykehamists,Old Alleynians,11,24,35,2.5,6
Old Wykehamists,Old Ardinians,0,3,3,2.0,1
Old Wykehamists,Old Barryians,0,1,1,3.0,1
Old Wykehamists,Old Berkhamstedians,11,7,18,2.5,4
Old Wykehamists,Old Bradfieldians,34,52,86,2.9411764705882355,17
Old Wykehamists,Old Brentwoods,36,40,76,2.9166666666666665,12
Old Wykehamists,Old Carthusians,11,46,57,2.3333333333333335,12
Old Wykehamists,Old Chigwellians,15,26,41,2.3,10
Old Wykehamists,Old Cholmeleians,18,13,31,3.2857142857142856,7
Old Wykehamists,Old Eastbournians,6,2,8,2.0,1
Old Wykehamists,Old Etonians,20,24,44,3.5454545454545454,11
Old Wykehamists,Old Foresters,12,18,30,3.0,9
Old Wykehamists,Old Haileyburians,27,13,40,2.75,8
Old Wykehamists,Old Harrovians,34,20,54,2.4444444444444446,9
Old Wykehamists,Old Johnians,5,6,11,4.5,2
Old Wykehamists,Old Kimboltonians,3,2,5,4.0,1
Old Wykehamists,Old King's Scholars,14,6,20,2.25,4
Old Wykehamists,Old Malvernians,36,25,61,3.0833333333333335,12
Old Wykehamists,Old Marlburians,24,20,44,1.8888888888888888,9
Old Wykehamists,Old Millfieldians,7,4,11,3.5,2
Old Wykehamists,Old Radleians,45,37,82,2.9375,16
Old Wykehamists,Old Reptonians,21,30,51,2.923076923076923,13
Old Wykehamists,Old Rugbeians,6,4,10,3.3333333333333335,3
Old Wykehamists,Old Salopians,17,18,35,3.2222222222222223,9
Old Wykehamists,Old Sennockians,3,3,6,4.0,2
Old Wykehamists,Old Tonbridgians,24,34,58,2.8461538461538463,13
Old Wykehamists,Old Wellingtonians,7,8,15,3.5,4
Old Wykehamists,Old Westminsters,22,18,40,3.9,10
Old Wykehamists,Old Wykehamists Select,7,6,13,5.0,1
Old Wykehamists,Queen Mary College Old Boys,5,7,12,4.0,1
Old Wykehamists,Rob Roy Rovers,2,1,3,4.0,1
Old Wykehamists,Winchester College 1st XI,24,10,34,3.111111111111111,9
Old Wykehamists II,Kings College Wimbledon II,6,16,22,2.75,4
Old Wykehamists II,Kings College Wimbledon III,10,7,17,3.3333333333333335,3
Old Wykehamists II,Lancing Old Boys II,2,7,9,2.0,2
Old Wykehamists II,Old Albanians SA,6,1,7,0.0,1
Old Wykehamists II,Old Aldenhamians II,11,12,23,3.25,4
Old Wykehamists II,Old Alleynians AFC,3,7,10,2.0,2
Old Wykehamists II,Old Alleynians AFC II,5,7,12,1.0,2
Old Wykehamists II,Old Alleynians AFC III,2,6,8,2.0,2
Old Wykehamists II,Old Amplefordians,18,24,42,3.7777777777777777,9
Old Wykehamists II,Old Ardinians,5,5,10,4.0,2
Old Wykehamists II,Old Ardinians II,6,6,12,2.0,2
Old Wykehamists II,Old Bancroftians AFC,8,12,20,3.75,4
Old Wykehamists II,Old Berkhamstedians,6,5,11,5.0,2
Old Wykehamists II,Old Berkhamstedians II,19,25,44,3.5,8
Old Wykehamists II,Old Brentwoods II,9,15,24,3.0,5
Old Wykehamists II,Old Brentwoods III,11,1,12,0.0,1
Old Wykehamists II,Old Brentwoods IV,2,4,6,3.0,1
Old Wykehamists II,Old Canfordians,5,3,8,4.0,2
Old Wykehamists II,Old Cheltonians,4,3,7,4.0,1
Old Wykehamists II,Old Chigwellians II,2,7,9,0.0,1
Old Wykehamists II,Old Chigwellians III,6,4,10,3.25,4
Old Wykehamists II,Old Cholmeleians II,11,4,15,3.25,4
Old Wykehamists II,Old Cholmeleians III,19,11,30,3.1666666666666665,6
Old Wykehamists II,Old Citizens,2,4,6,3.0,1
Old Wykehamists II,Old Eastbournians,27,18,45,2.6666666666666665,9
Old Wykehamists II,Old Epsomians,6,6,12,3.0,2
Old Wykehamists II,Old Epsomians II,1,6,7,0.0,1
Old Wykehamists II,Old Etonians II,4,13,17,2.5,4
Old Wykehamists II,Old Foresters II,6,12,18,3.8,5
Old Wykehamists II,Old Haberdashers,5,5,10,2.0,2
Old Wykehamists II,Old Harrovians II,8,11,19,3.25,4
Old Wykehamists II,Old Johnians FC,2,12,14,1.0,2
Old Wykehamists II,Old Kimboltonians,0,6,6,0.0,1
Old Wykehamists II,Old King's Scholars,7,10,17,2.25,4
Old Wykehamists II,Old Kingstonians,4,7,11,2.3333333333333335,3
Old Wykehamists II,Old Kingstonians KGS,12,8,20,3.25,4
Old Wykehamists II,Old Malvernians II,3,0,3,2.0,1
Old Wykehamists II,Old Marlburians,1,9,10,1.0,2
Old Wykehamists II,Old Merchant Taylors,2,6,8,3.0,2
Old Wykehamists II,Old Merchant Taylors II,7,13,20,2.0,3
Old Wykehamists II,Old Millhillians,2,8,10,2.0,2
Old Wykehamists II,Old Oundelians,10,7,17,2.0,3
Old Wykehamists II,Old Rugbeians,8,5,13,2.6666666666666665,3
Old Wykehamists II,Old Salopians II,14,16,30,3.5,8
Old Wykehamists II,Old Sennockians,4,9,13,3.0,2
Old Wykehamists II,Old Shirburnians,2,9,11,1.5,2
Old Wykehamists II,Old Stoics,26,29,55,3.3,10
Old Wykehamists II,Old Suttonians SV,8,22,30,2.5,4
Old Wykehamists II,Old Tonbridgians II,3,12,15,1.5,2
Old Wykehamists II,Old Wellingtonians,5,5,10,3.0,4
Old Wykehamists II,Old Westminsters II,13,23,36,3.0,8
Old Wykehamists II,Old Wykehamists Select,7,5,12,4.0,1
Old Wykehamists II,TBC,3,2,5,4.0,1
Old Wykehamists II,Winchester College 2nd XI,15,8,23,2.8333333333333335,6
Old Wykehamists Select,Old Wykehamists,6,7,13,5.0,1
Old Wykehamists Select,Old Wykehamists II,5,7,12,4.0,1
Old Wykehamists Veterans,Old Bradfieldians Vets,0,6,6,0.0,1
Old Wykehamists Veterans,Old Haileyburians Vets,3,3,6,4.0,2
Old Wykehamists Veterans,Old Westminsters Vets,1,2,3,4.0,1
Old Wykehamists Vets,KCS Old Boys Vets,7,8,15,3.0,2
Old Wykehamists Vets,Lancing Old Boys Vets,4,4,8,4.5,2
Old Wykehamists Vets,Old Brentwoods Vets,0,4,4,2.0,2
Old Wykehamists Vets,Old Carthusians Vets,4,7,11,2.0,3
Old Wykehamists Vets,Old Chigwellians Vets,10,11,21,1.0,3
Old Wykehamists Vets,Old Etonians Vets,3,15,18,1.75,4
Old Wykehamists Vets,Old Foresters Vets,1,0,1,3.0,1
Old Wykehamists Vets,Old Harrovians Vets,9,8,17,4.0,3
Old Wykehamists Vets,Old Malvernians Vets,0,5,5,2.0,2
Old Wykehamists Vets,Old Salopians Vets,3,10,13,1.5,2
Old Wykehamists Vets,Old Tonbridgians Vets,4,10,14,2.5,2
Old Wykehamists Vets,Old Westminsters Vets,2,16,18,1.3333333333333333,3
Oundle School 1st XI,Old Oundelians,4,6,10,4.0,2
Oxford University Football Club,Arthurian League Representative Team,3,2,5,4.0,1
PWC Select XI,Old Etonians,4,5,9,4.5,2
Park View,Old Carthusians,0,3,3,2.0,1
Park View,Old Cholmeleians,3,4,7,4.0,1
Parkfield,Old Cholmeleians II,0,11,11,0.0,1
Parklife FC,Old Alleynians AFC,2,2,4,5.0,1
Pembroke Old Boys,Old Haberdashers,0,7,7,0.0,1
Phoenix Old Boys,KCS Old Boys,5,4,9,5.0,1
Polytechnic,Old Brentwoods,3,2,5,4.0,1
Polytechnic,Old Carthusians,9,2,11,2.6666666666666665,3
Polytechnic,Old Cholmeleians,3,1,4,3.0,1
Polytechnic,Old Cholmeleians II,6,2,8,2.0,1
Polytechnic,Old Foresters,3,1,4,3.0,1
Polytechnic 2s,Old Haberdashers,4,0,4,1.0,1
Polytechnic 3s,Old Carthusians III,1,3,4,3.0,1
Polytechnic Vets,Old Chigwellians Vets Blues,0,3,3,2.0,1
Putney Ferrets,Old Haileyburians,1,3,4,3.0,1
Putney Saint-Germain,Old Cholmeleians,0,2,2,2.0,1
Putney Saint-Germain,Old Westminsters,9,3,12,2.5,2
Queen Mary College Old Boys,KCS Old Boys,3,3,6,5.0,1
Queen Mary College Old Boys,Old Aldenhamians,5,2,7,2.0,1
Queen Mary College Old Boys,Old Brentwoods III,5,5,10,6.0,1
Queen Mary College Old Boys,Old Etonians,2,0,2,2.0,1
Queen Mary College Old Boys,Old Etonians Vets,5,0,5,0.0,1
Queen Mary College Old Boys,Old Wykehamists,7,5,12,4.0,1
Radley College 1st XI,Old Radleians,16,24,40,4.0,6
Rapid Chingford,Kings College Wimbledon II,5,1,6,2.0,1
Reigatians,Old Alleynians,1,5,6,2.0,1
Reigatians,Old Carthusians II,1,4,5,2.0,1
Reigatians,Old Carthusians III,0,3,3,2.0,1
Reigatians II,Old Aldenhamians,3,2,5,4.0,1
Repton School 1st XI,Old Reptonians,3,5,8,4.0,6
Richmond & Kew SAL,Lancing Old Boys,4,3,7,3.0,2
Richmond & Kew SAL,Old Carthusians,0,4,4,1.0,1
Richmond & Kew SSEC,Old Chigwellians,5,3,8,4.0,1
Rob Roy Rovers,Old Carthusians,0,3,3,2.0,1
Rob Roy Rovers,Old Westminsters,4,1,5,2.0,1
Rob Roy Rovers,Old Wykehamists,1,2,3,4.0,1
Royal Bank of Scotland,Old Brentwoods II,4,0,4,1.0,1
Royal Bank of Scotland,Old Carthusians II,3,3,6,5.0,1
Royal Bank of Scotland,Old Haberdashers,6,4,10,4.0,1
Royal Bank of Scotland,Old Westminsters,2,3,5,4.0,1
Royal Bank of Scotland II,Old Cholmeleians II,10,0,10,0.0,1
Royal Navy Development XI,Arthurian League Representative Team,4,8,12,3.3333333333333335,3
Rugby School,Old Rugbeians,1,7,8,2.3333333333333335,3
SAL Representative Team,Arthurian League Representative Team,2,7,9,3.0,3
Sevenoaks School 1st XI,Old Sennockians,3,1,4,3.0,2
Shene FC,Old Westminsters,4,4,8,6.0,1
Shene Old Grammarians,Old Cholmeleians,2,1,3,4.0,1
Shene Old Grammarians,Old Eastbournians,7,1,8,2.0,2
Shene Old Grammarians,Old Johnians,2,1,3,4.0,1
Shene Old Grammarians,Old Rugbeians,4,4,8,6.0,1
Shene Old Grammarians,Old Salopians II,1,0,1,3.0,1
Shene Old Grammarians,Old Sennockians,2,6,8,2.0,1
Sherborne School 1st XI,Old Shirburnians,10,4,14,1.3333333333333333,3
Shrewsbury School 1st XI,Old Salopians,4,11,15,3.0,8
Shrewsbury School 2nd XI,Old Salopians II,11,14,25,3.0,7
Sinjun Grammarians,Lancing Old Boys,3,2,5,4.0,1
Sinjun Grammarians,Old Brentwoods II,3,1,4,3.0,1
Sinjun Grammarians,Old Reptonians,4,3,7,4.0,1
Sinjun Grammarians,Old Rugbeians,0,3,3,2.0,1
Somerville Old Boys,Old Bancroftians AFC,1,0,1,3.0,1
Somerville Old Boys,Old Cholmeleians,1,4,5,2.0,1
Somerville Old Boys,Old Columbans,2,3,5,4.0,1
Somerville Old Boys,Old Sennockians,7,4,11,3.0,1
South Bank Cuaco,Old Alleynians,2,2,4,5.0,1
South Bank Cuaco,Old Brentwoods IV,2,3,5,4.0,1
South Bank Cuaco,Old Carthusians,2,3,5,4.0,1
South Bank Cuaco,Old Cholmeleians II,2,4,6,3.0,1
South Bank Cuaco,Old Kingstonians KGS,2,2,4,5.0,1
South Bank Cuaco,Old Salopians,0,3,3,2.0,1
South Bank Cuaco,Old Salopians II,4,0,4,1.0,1
South Bank Cuaco,Old Westminsters II,6,2,8,2.0,1
Southern Amateur League Rep XI,Arthurian League Representative Team,7,6,13,3.0,4
Southgate County,Old Aldenhamians,0,7,7,1.0,2
Southgate County,Old Cholmeleians II,1,7,8,2.0,2
Southgate County,Old Cholmeleians III,2,4,6,3.0,1
Southgate County,Old Foresters,0,1,1,3.0,1
Southgate County,Old King's Scholars,1,6,7,0.0,1
Southgate County,Old Reptonians,3,6,9,3.0,1
Southgate County,Old Salopians,3,2,5,4.0,1
Southgate County II,Old Etonians II,6,8,14,4.0,1
Southgate County II,Old Merchant Taylors,5,2,7,2.0,1
Southgate County III,Old Brentwoods II,4,1,5,2.0,1
Southgate Olympic,Old Aldenhamians II,2,1,3,4.0,1
Spaniards,Old Berkhamstedians,4,4,8,6.0,1
Spaniards,Old Chigwellians,0,4,4,1.0,1
Spaniards,Old Cholmeleians,3,2,5,3.0,2
Spaniards,Old Foresters,0,6,6,0.0,1
Spaniards,Old Malvernians,3,3,6,5.0,1
Spaniards,Old Reptonians,1,0,1,3.0,1
St Albans School 1st XI,Old Albanians SA,3,4,7,4.0,1
St Edwards OSE,Old Kingstonians,2,0,2,2.0,1
St Lawrence,Old Sennockians,3,1,4,3.5,2
St. James' Old Boys,Old Alleynians II,1,4,5,2.0,1
St. James' Old Boys,Old Bancroftians AFC,5,2,7,2.0,1
St. James' Old Boys IV,Old Brentwoods IV,0,8,8,0.0,1
St. John's School,Old Johnians FC,0,0,0,4.0,1
Steuerman Select Work XI,Old Westminsters II,1,2,3,4.0,1
Stowe School,Old Stoics,17,11,28,3.25,4
TBC,Old Gregorians,3,3,6,5.0,1
TBC,Old Malvernians,1,2,3,4.0,1
TBC,Old Malvernians II,5,0,5,0.0,1
TBC,Old Sennockians,1,2,3,4.0,1
TBC,Old Wykehamists II,2,3,5,4.0,1
"The King's School, Canterbury",Old King's Scholars,11,5,16,2.5,2
The Warren First,Old Sennockians,4,3,7,4.0,1
Toby Football Club,Old Foresters,4,1,5,2.0,1
Tonbridge School 1st XI,Old Tonbridgians,1,3,4,3.0,1
Tonbridge School 2nd XI,Old Tonbridgians II,0,5,5,0.0,1
UCC Diaspora 1st XI,Old Epsomians,2,1,3,4.0,1
UCL Academicals,KCS Old Boys,1,5,6,2.0,1
UCL Academicals,Old Brentwoods,3,0,3,2.0,1
UCL Academicals,Old Brentwoods II,5,6,11,5.0,1
UCL Academicals,Old Reptonians,2,7,9,0.0,1
UCL Academicals II,Old Brentwoods II,4,0,4,1.0,1
UCL Academicals III,Old Brentwoods II,4,3,7,4.0,1
UCL Academicals III,Old Cholmeleians II,3,0,3,2.0,1
UCL Academicals III,Old Cholmeleians III,5,1,6,2.0,1
UCL Academicals IV,Old Bancroftians AFC,2,0,2,2.0,1
UCL Academicals IV,Old Foresters III,9,1,10,0.0,1
UCL Academicals IV,Old Millhillians,6,3,9,3.0,1
UCL Academicals IV,Old Tonbridgians II,11,1,12,0.0,1
UCL Academicals V,Old Bancroftians AFC,0,1,1,3.0,1
UCL Academicals V,Old King's Scholars,0,4,4,1.0,1
University of Hertfordshire,Old Aldenhamians,1,7,8,0.0,1
University of Hertfordshire,Old Malvernians,3,5,8,4.0,1
Vauxhall Invitational XI,Old Reptonians,1,3,4,3.0,1
Wake Green Amateur,Old Aldenhamians II,5,1,6,2.0,1
Wake Green Amateur,Old Foresters,0,7,7,0.0,1
Waltham Abbey,Old Foresters,3,0,3,2.0,1
Wandsworth Borough,Old Aldenhamians,4,0,4,1.0,1
Wandsworth Borough,Old Carthusians III,1,6,7,0.0,1
Wandsworth Borough,Old Cholmeleians II,1,8,9,0.0,1
Weirside Rangers,Old Alleynians AFC,2,3,5,4.0,1
Weirside Rangers,Old Ardinians,2,3,5,4.0,1
Weirside Rangers,Old Brentwoods,1,3,4,3.0,1
Weirside Rangers,Old Carthusians III,0,5,5,0.0,1
Weirside Rangers,Old Cholmeleians III,4,0,4,1.0,1
Weirside Rangers,Old Westminsters,2,3,5,4.0,1
Wellington College 1st XI,Old Wellingtonians,1,1,2,4.0,1
West Fulham,KCS Old Boys,2,4,6,3.0,1
West Wickham,Old Alleynians AFC,0,0,0,4.0,1
West Wickham,Old Brentwoods,6,1,7,0.0,1
West Wickham,Old Brentwoods II,2,3,5,4.0,1
West Wickham,Old Carthusians,3,3,6,4.5,2
West Wickham,Old Carthusians II,0,3,3,2.0,1
West Wickham,Old Haberdashers,3,3,6,5.0,1
West Wickham III,Old Alleynians III,0,0,0,4.0,1
Westminster School 1st XI,Old Westminsters,10,13,23,3.875,8
Westminster School 2nd XI,Old Westminsters II,10,19,29,3.0,8
Winchester College 1st XI,Old Wykehamists,10,24,34,3.111111111111111,9
Winchester College 2nd XI,Old Wykehamists II,8,15,23,2.8333333333333335,6
Winchmore Hill,Old Aldenhamians,3,0,3,2.0,1
Winchmore Hill,Old Brentwoods,1,0,1,3.0,1
Winchmore Hill,Old Carthusians,1,8,9,1.6666666666666667,3
Winchmore Hill,Old Carthusians III,3,2,5,4.0,1
Winchmore Hill,Old Chigwellians,5,0,5,2.0,2
Witan,Old Berkhamstedians,2,3,5,4.0,1
Witan,Old Reptonians,5,0,5,0.0,1
Wood Green Old Boys,Old Brentwoods II,1,7,8,0.0,1
Wood Green Old Boys,Old Carthusians II,1,7,8,0.0,1
Wood Green Old Boys,Old King's Scholars,0,1,1,3.0,1
Wood Green Old Boys,Old Malvernians,0,6,6,0.0,1
Worcester College Old Boys,Kings College Wimbledon II,1,3,4,3.0,1
Worcester College Old Boys,Lancing Old Boys,4,2,6,3.0,1
Worcester College Old Boys,Old Aldenhamians,2,0,2,2.0,1
Worcester College Old Boys,Old Cholmeleians,2,3,5,4.0,1
Worcester College Old Boys,Old Foresters,1,4,5,2.0,1
Wormley Rovers Vets FC,Old Chigwellians Vets,1,3,4,3.0,1
Yorxeter FC,Old Alleynians,1,2,3,4.0,1
