Fixture_ID,Team_1,Team_2,Team_1_goals,Team_2_goals,ALFIE_rating,Total_goals
12649002,Old Brentwoods IV,Old Foresters IV,8,4,2.0,12
12649001,Old Brentwoods IV,Old Brentwoods III,5,3,4.0,8
12637620,Lancing Old Boys,KCS Old Boys,1,1,4.0,2
12639446,Old Etonians,Old Chigwellians,4,0,1.0,4
12639447,Old Malvernians,Old Haileyburians,1,3,3.0,4
12631497,Old Cholmeleians II,Lancing Old Boys II,4,1,2.0,5
12639448,Old Wykehamists II,Old Marlburians,1,6,0.0,7
12643281,Old Brentwoods IV,Old Foresters III,2,0,2.0,2
12632423,Old Foresters IV,Old Citizens,1,6,0.0,7
12641287,Old Brentwoods,Old Carthusians,2,6,2.0,8
12614177,KCS Old Boys,Old Etonians,1,5,2.0,6
12631463,Old Carthusians,Old Brentwoods,5,3,4.0,8
12636819,Old Westminsters,Old Haileyburians,0,0,4.0,0
12636926,Old Wykehamists,Old King's Scholars,7,1,0.0,8
12631499,Old Carthusians III,Old Carthusians II,0,0,4.0,0
12631496,Old Cholmeleians II,Old Chigwellians II,4,1,2.0,5
12631503,Old Marlburians,Kings College Wimbledon II,1,7,0.0,8
12632422,Old Brentwoods IV,Old Citizens,3,6,3.0,9
12633239,Old Foresters III,Old Brentwoods III,2,1,4.0,3
12631493,Old Cholmeleians II,Old Carthusians III,1,1,4.0,2
12636584,Old Etonians,Old Harrovians,1,1,4.0,2
12636588,Lancing Old Boys,Old Salopians,3,1,3.0,4
12631466,Lancing Old Boys,Old Cholmeleians,2,0,2.0,2
12621535,Old Cholmeleians,Lancing Old Boys,0,2,2.0,2
12621536,Old Etonians,Old Foresters,1,4,2.0,5
12621537,Old Harrovians,KCS Old Boys,3,2,4.0,5
12636925,Old Malvernians,Old Bradfieldians,3,1,3.0,4
12617658,Old Wellingtonians,Old Haberdashers,1,2,4.0,3
12629953,Lancing Old Boys II,Old Chigwellians II,0,1,3.0,1
12631507,Old Marlburians,Old Harrovians II,3,1,3.0,4
12631514,Old Amplefordians,Old Epsomians,2,3,4.0,5
12631515,Old Cholmeleians III,Old Berkhamstedians,0,1,3.0,1
12632421,Old Brentwoods III,Old Citizens,0,6,0.0,6
12626282,Old Cholmeleians IV,Old Brentwoods IV,3,1,3.0,4
12632424,Old Foresters IV,Old Foresters III,2,2,5.0,4
12634427,Old Millhillians,Old Sennockians,4,1,2.0,5
12614180,KCS Old Boys,Old Foresters,4,4,6.0,8
12614179,Old Chigwellians,Old Harrovians,0,1,3.0,1
12631451,Old Cholmeleians,Old Brentwoods,2,4,3.0,6
12617649,Old Malvernians,Old King's Scholars,4,1,2.0,5
12617650,Old Salopians,Old Bradfieldians,2,2,5.0,4
12617657,Old Wellingtonians,Old Chigwellians II,2,3,4.0,5
12623384,Old Harrovians II,Kings College Wimbledon II,1,0,3.0,1
12631111,Old Wykehamists II,Old Etonians II,0,6,0.0,6
12626278,Old Eastbournians,Old Chigwellians III,0,2,2.0,2
12631513,Old Amplefordians,Old Cholmeleians III,0,3,2.0,3
12626281,Old Cholmeleians IV,Old Brentwoods III,2,3,4.0,5
12624797,Old Carthusians,Old Wykehamists,4,0,1.0,4
12624787,Lancing Old Boys II,Old Carthusians III,0,1,3.0,1
12629939,Old Citizens,Old Westminsters II,1,2,4.0,3
12634426,Old Millhillians,Old Stoics,1,1,4.0,2
12614178,Lancing Old Boys,Old Carthusians,0,1,3.0,1
12614174,Old Brentwoods,Old Tonbridgians,4,1,2.0,5
12614175,Old Cholmeleians,Old Harrovians,6,4,4.0,10
12614176,Old Foresters,Old Chigwellians,0,2,2.0,2
12617646,Old Aldenhamians,Old Bradfieldians,2,5,2.0,7
12617647,Old King's Scholars,Old Westminsters,3,2,4.0,5
12617648,Old Malvernians,Old Wykehamists,1,4,2.0,5
12617654,Old Cholmeleians II,Old Reptonians,1,3,3.0,4
12617656,Old Salopians II,Old Haberdashers,4,1,2.0,5
12623381,Old Brentwoods II,Kings College Wimbledon II,4,2,3.0,6
12623383,Old Wykehamists II,Old Harrovians II,3,1,3.0,4
12623382,Old Marlburians,Old Aldenhamians II,2,1,4.0,3
12626270,Old Amplefordians,Old Berkhamstedians,3,7,2.0,10
12626271,Old Epsomians,Old Westminsters II,1,3,3.0,4
12626279,Old Brentwoods III,Old Chigwellians IV,5,1,2.0,6
12624883,Old Cholmeleians III,Old Citizens,2,3,4.0,5
12624884,Old Epsomians,Old Westminsters II,1,3,3.0,4
12621777,Old Wellingtonians,Old Carthusians III,3,2,4.0,5
12614172,KCS Old Boys,Old Chigwellians,0,1,3.0,1
12614169,Old Brentwoods,Old Etonians,0,1,3.0,1
12614170,Old Cholmeleians,Old Carthusians,1,2,4.0,3
12614171,Old Foresters,Lancing Old Boys,0,0,4.0,0
12614173,Old Tonbridgians,Old Harrovians,3,1,3.0,4
12617643,Old King's Scholars,Old Aldenhamians,0,3,2.0,3
12617644,Old Malvernians,Old Radleians,3,2,4.0,5
12617645,Old Wykehamists,Old Bradfieldians,1,4,2.0,5
12617652,Old Chigwellians II,Old Reptonians,1,6,0.0,7
12617653,Old Cholmeleians II,Old Salopians II,4,1,2.0,5
12623380,Old Wykehamists II,Old Brentwoods II,1,2,4.0,3
12626998,Old Eastbournians,Old Epsomians,1,4,2.0,5
12626943,Old Malvernians II,Old Chigwellians IV,3,1,3.0,4
12622332,Old Etonians II,Old Carthusians III,0,5,0.0,5
12622331,Old Marlburians,Lancing Old Boys II,1,1,4.0,2
12622193,Old Sennockians,Old Stoics,2,4,3.0,6
12612289,Old Etonians,Old Harrovians,1,4,2.0,5
12612290,Old Foresters,Old Tonbridgians,4,2,3.0,6
12622606,Old Salopians II,Old Reptonians,4,3,4.0,7
12612291,Old Brentwoods,KCS Old Boys,4,0,1.0,4
12612292,Old Carthusians,Old Harrovians,7,0,0.0,7
12612293,Old Tonbridgians,Old Foresters,1,3,3.0,4
12622546,Old Aldenhamians,Old Wykehamists,3,1,3.0,4
12622547,Old Malvernians,Old Salopians,0,6,0.0,6
12622607,Old Reptonians,Old Carthusians II,5,0,0.0,5
12622665,Old Brentwoods II,Old Etonians II,2,4,3.0,6
12612294,Old Brentwoods,Old Cholmeleians,1,1,4.0,2
12612295,Old Carthusians,KCS Old Boys,3,0,2.0,3
12612296,Old Chigwellians,Old Tonbridgians,2,1,4.0,3
12612297,Old Etonians,Lancing Old Boys,0,2,2.0,2
12622548,Old Malvernians,Old Aldenhamians,4,2,3.0,6
12622549,Old Radleians,Old King's Scholars,3,1,3.0,4
12622666,Old Aldenhamians II,Old Brentwoods II,3,2,4.0,5
12622746,Old Citizens,Old Cholmeleians IV,7,1,0.0,8
12612298,Old Chigwellians,Old Brentwoods,3,0,2.0,3
12612299,Old Cholmeleians,KCS Old Boys,2,3,4.0,5
12622550,Old Aldenhamians,Old King's Scholars,5,0,0.0,5
12622551,Old Haileyburians,Old Westminsters,1,4,2.0,5
12622552,Old Radleians,Old Bradfieldians,2,3,4.0,5
12622553,Old Wykehamists,Old Salopians,1,2,4.0,3
12622610,Lancing Old Boys II,Old Carthusians II,1,0,3.0,1
12622608,Old Chigwellians II,Old Salopians II,2,0,2.0,2
12622609,Old Haberdashers,Old Cholmeleians II,1,0,3.0,1
12622611,Old Wellingtonians,Old Reptonians,1,1,4.0,2
12622667,Old Foresters II,Old Harrovians II,4,0,1.0,4
12622712,Old Westminsters II,Old Amplefordians,4,1,2.0,5
12622747,Old Brentwoods III,Old Foresters IV,2,0,2.0,2
12622748,Old Foresters III,Old Brentwoods IV,2,4,3.0,6
12612304,KCS Old Boys,Old Tonbridgians,2,2,5.0,4
12612300,Old Brentwoods,Lancing Old Boys,0,2,2.0,2
12612301,Old Cholmeleians,Old Foresters,3,0,2.0,3
12612302,Old Etonians,Old Carthusians,1,3,3.0,4
12612303,Old Harrovians,Old Chigwellians,5,4,5.0,9
12622554,Old Bradfieldians,Old Salopians,1,1,4.0,2
12622555,Old Radleians,Old Haileyburians,7,2,0.0,9
12622556,Old Wykehamists,Old Malvernians,1,2,4.0,3
12622668,Old Foresters II,Kings College Wimbledon II,3,1,3.0,4
12622713,Old Epsomians,Old Cholmeleians III,3,2,4.0,5
12622714,Old Westminsters II,Old Berkhamstedians,1,3,3.0,4
12622749,Old Foresters IV,Old Chigwellians IV,3,1,3.0,4
12612306,KCS Old Boys,Old Brentwoods,6,2,2.0,8
12612307,Lancing Old Boys,Old Chigwellians,1,0,3.0,1
12612305,Old Carthusians,Old Foresters,3,0,2.0,3
12612308,Old Tonbridgians,Old Cholmeleians,0,4,1.0,4
12622557,Old Aldenhamians,Old Radleians,4,1,2.0,5
12622558,Old King's Scholars,Old Bradfieldians,0,4,1.0,4
12622559,Old Malvernians,Old Westminsters,3,1,3.0,4
12622560,Old Wykehamists,Old Haileyburians,2,2,5.0,4
12622612,Old Chigwellians II,Old Carthusians III,4,5,5.0,9
12622613,Old Haberdashers,Old Reptonians,2,5,2.0,7
12622614,Old Salopians II,Old Carthusians II,0,2,2.0,2
12622615,Old Wellingtonians,Old Cholmeleians II,3,2,4.0,5
12622669,Old Foresters II,Old Etonians II,1,1,4.0,2
12622670,Old Harrovians II,Old Aldenhamians II,0,3,2.0,3
12622671,Old Wykehamists II,Kings College Wimbledon II,2,2,5.0,4
12622715,Old Eastbournians,Old Westminsters II,1,1,4.0,2
12622716,Old Epsomians,Old Berkhamstedians,1,2,4.0,3
12622750,Old Foresters IV,Old Cholmeleians IV,3,1,3.0,4
12622751,Old Malvernians II,Old Citizens,2,1,4.0,3
12612309,Old Chigwellians,KCS Old Boys,4,0,1.0,4
12612310,Old Etonians,Old Tonbridgians,3,3,5.0,6
12612311,Old Harrovians,Lancing Old Boys,2,5,2.0,7
12622561,Old Bradfieldians,Old Westminsters,3,3,5.0,6
12622562,Old Haileyburians,Old Malvernians,2,3,4.0,5
12622563,Old Wykehamists,Old Radleians,1,0,3.0,1
12622617,Lancing Old Boys II,Old Reptonians,1,1,4.0,2
12622616,Old Carthusians II,Old Haberdashers,2,5,2.0,7
12622618,Old Wellingtonians,Old Salopians II,1,1,4.0,2
12622672,Old Aldenhamians II,Kings College Wimbledon II,5,0,0.0,5
12622717,Old Amplefordians,Old Chigwellians III,1,3,3.0,4
12622718,Old Cholmeleians III,Old Eastbournians,0,1,3.0,1
12622752,Old Cholmeleians IV,Old Chigwellians IV,1,0,3.0,1
12612314,Lancing Old Boys,Old Brentwoods,5,1,2.0,6
12612312,Old Carthusians,Old Chigwellians,2,1,4.0,3
12612313,Old Cholmeleians,Old Etonians,3,2,4.0,5
12622564,Old Aldenhamians,Old Westminsters,1,0,3.0,1
12622565,Old King's Scholars,Old Radleians,1,4,2.0,5
12622619,Lancing Old Boys II,Old Salopians II,1,1,4.0,2
12622566,Old Salopians,Old Haileyburians,4,1,2.0,5
12622567,Old Westminsters,Old King's Scholars,3,0,2.0,3
12622673,Old Marlburians,Old Wykehamists II,3,0,2.0,3
12622719,Old Westminsters II,Old Chigwellians III,1,3,3.0,4
12622753,Old Malvernians II,Old Foresters III,6,2,2.0,8
12612316,Lancing Old Boys,Old Tonbridgians,5,2,2.0,7
12612315,Old Harrovians,Old Carthusians,3,4,4.0,7
12622568,Old Bradfieldians,Old Haileyburians,3,2,4.0,5
12622569,Old Radleians,Old Westminsters,1,3,3.0,4
12622622,Lancing Old Boys II,Old Cholmeleians II,1,0,3.0,1
12622620,Old Carthusians III,Old Chigwellians II,1,0,3.0,1
12622621,Old Haberdashers,Old Salopians II,2,4,3.0,6
12622623,Old Wellingtonians,Old Carthusians II,1,3,3.0,4
12622674,Old Etonians II,Old Marlburians,2,4,3.0,6
12622675,Old Foresters II,Old Aldenhamians II,0,0,4.0,0
12622720,Old Berkhamstedians,Old Epsomians,2,3,4.0,5
12622721,Old Chigwellians III,Old Cholmeleians III,0,1,3.0,1
12622754,Old Foresters III,Old Chigwellians IV,5,0,0.0,5
12612317,Old Chigwellians,Old Carthusians,0,1,3.0,1
12612318,Old Harrovians,Old Brentwoods,3,0,2.0,3
12612319,Old Tonbridgians,Old Etonians,1,2,4.0,3
12622570,Old King's Scholars,Old Salopians,1,4,2.0,5
12622571,Old Radleians,Old Aldenhamians,2,1,4.0,3
12622572,Old Westminsters,Old Bradfieldians,0,4,1.0,4
12622624,Old Carthusians II,Old Salopians II,3,1,3.0,4
12622625,Old Reptonians,Old Haberdashers,4,4,6.0,8
12622626,Old Wellingtonians,Lancing Old Boys II,1,0,3.0,1
12622678,Kings College Wimbledon II,Old Harrovians II,2,1,4.0,3
12622676,Old Etonians II,Old Brentwoods II,2,1,4.0,3
12622677,Old Foresters II,Old Marlburians,1,3,3.0,4
12622679,Old Wykehamists II,Old Aldenhamians II,3,4,4.0,7
12622722,Old Chigwellians III,Old Epsomians,3,1,3.0,4
12622723,Old Westminsters II,Old Eastbournians,5,2,2.0,7
12622755,Old Brentwoods IV,Old Malvernians II,0,3,2.0,3
12622756,Old Chigwellians IV,Old Citizens,1,5,2.0,6
12612320,Old Cholmeleians,Old Chigwellians,1,2,4.0,3
12612321,Old Chigwellians,Old Foresters,2,3,4.0,5
12622573,Old Salopians,Old Radleians,3,2,4.0,5
12622627,Old Carthusians III,Old Haberdashers,3,1,3.0,4
12622628,Old Salopians II,Old Chigwellians II,5,2,2.0,7
12622680,Old Aldenhamians II,Old Harrovians II,7,0,0.0,7
12612322,Old Chigwellians,Lancing Old Boys,0,0,4.0,0
12612323,Old Etonians,Old Cholmeleians,2,3,4.0,5
12622574,Old Westminsters,Old Salopians,0,4,1.0,4
12622630,Lancing Old Boys II,Old Haberdashers,1,2,4.0,3
12622629,Old Carthusians II,Old Chigwellians II,2,2,5.0,4
12622631,Old Salopians II,Old Wellingtonians,6,1,0.0,7
12622724,Old Cholmeleians III,Old Westminsters II,5,2,2.0,7
12612324,Old Foresters,Old Harrovians,4,3,4.0,7
12622575,Old Radleians,Old Malvernians,2,1,4.0,3
12622576,Old Salopians,Old Aldenhamians,5,0,0.0,5
12622577,Old Westminsters,Old Wykehamists,1,1,4.0,2
12622632,Old Carthusians II,Old Carthusians III,1,1,4.0,2
12622633,Old Haberdashers,Old Chigwellians II,2,2,5.0,4
12622634,Old Reptonians,Lancing Old Boys II,3,0,2.0,3
12622635,Old Salopians II,Old Cholmeleians II,2,1,4.0,3
12622681,Old Brentwoods II,Old Foresters II,4,1,2.0,5
12622682,Old Etonians II,Old Wykehamists II,1,1,4.0,2
12622725,Old Amplefordians,Old Eastbournians,3,3,5.0,6
12622726,Old Berkhamstedians,Old Chigwellians III,1,1,4.0,2
12622757,Old Foresters IV,Old Brentwoods III,4,4,6.0,8
12612325,Old Carthusians,Lancing Old Boys,3,3,5.0,6
12612326,Old Harrovians,Old Cholmeleians,1,3,3.0,4
12612327,Old Tonbridgians,KCS Old Boys,4,1,2.0,5
12622578,Old Aldenhamians,Old Haileyburians,2,1,4.0,3
12622579,Old Salopians,Old King's Scholars,3,0,2.0,3
12622683,Old Aldenhamians II,Old Etonians II,3,2,4.0,5
12622684,Old Harrovians II,Old Foresters II,3,2,4.0,5
12612329,KCS Old Boys,Old Harrovians,0,3,2.0,3
12612330,Lancing Old Boys,Old Foresters,1,0,3.0,1
12612328,Old Carthusians,Old Tonbridgians,4,1,2.0,5
12622580,Old Bradfieldians,Old King's Scholars,4,1,2.0,5
12622581,Old Salopians,Old Westminsters,6,0,0.0,6
12622636,Old Chigwellians II,Old Cholmeleians II,0,0,4.0,0
12622637,Old Haberdashers,Old Wellingtonians,9,3,0.0,12
12622638,Old Salopians II,Lancing Old Boys II,2,1,4.0,3
12622685,Old Brentwoods II,Old Harrovians II,2,1,4.0,3
12622727,Old Berkhamstedians,Old Eastbournians,1,4,2.0,5
12622758,Old Chigwellians IV,Old Foresters IV,0,0,4.0,0
12622759,Old Malvernians II,Old Brentwoods III,0,1,3.0,1
12612331,Old Etonians,KCS Old Boys,0,3,2.0,3
12622582,Old King's Scholars,Old Haileyburians,3,3,5.0,6
12622583,Old Radleians,Old Salopians,2,3,4.0,5
12622639,Old Carthusians III,Old Cholmeleians II,3,1,3.0,4
12622640,Old Chigwellians II,Lancing Old Boys II,1,2,4.0,3
12622689,Kings College Wimbledon II,Old Etonians II,1,2,4.0,3
12622686,Old Aldenhamians II,Old Marlburians,2,1,4.0,3
12622687,Old Foresters II,Old Wykehamists II,2,1,4.0,3
12622688,Old Harrovians II,Old Brentwoods II,6,1,0.0,7
12622728,Old Chigwellians III,Old Amplefordians,1,2,4.0,3
12622729,Old Eastbournians,Old Cholmeleians III,0,3,2.0,3
12622760,Old Brentwoods III,Old Malvernians II,0,6,0.0,6
12622761,Old Brentwoods IV,Old Chigwellians IV,2,0,2.0,2
12622762,Old Cholmeleians IV,Old Foresters III,9,1,0.0,10
12622763,Old Citizens,Old Foresters IV,5,1,2.0,6
12612332,Old Foresters,Old Brentwoods,2,5,2.0,7
12612333,Old Harrovians,Old Etonians,0,4,1.0,4
12612334,Old Tonbridgians,Old Chigwellians,1,4,2.0,5
12622584,Old Haileyburians,Old Radleians,1,1,4.0,2
12622585,Old Wykehamists,Old Westminsters,3,1,3.0,4
12622643,Lancing Old Boys II,Old Wellingtonians,2,1,4.0,3
12622641,Old Carthusians II,Old Cholmeleians II,3,1,3.0,4
12622642,Old Chigwellians II,Old Haberdashers,4,2,3.0,6
12622644,Old Salopians II,Old Carthusians III,0,3,2.0,3
12622690,Old Brentwoods II,Old Aldenhamians II,1,2,4.0,3
12622691,Old Etonians II,Kings College Wimbledon II,0,5,0.0,5
12622692,Old Harrovians II,Old Marlburians,1,3,3.0,4
12622693,Old Wykehamists II,Old Foresters II,0,1,3.0,1
12622730,Old Chigwellians III,Old Eastbournians,1,1,4.0,2
12622764,Old Cholmeleians IV,Old Malvernians II,1,12,1.0,13
12622765,Old Citizens,Old Foresters III,9,0,0.0,9
12612335,Old Foresters,KCS Old Boys,1,1,4.0,2
12612336,Old Tonbridgians,Lancing Old Boys,1,4,2.0,5
12622586,Old Aldenhamians,Old Malvernians,3,2,4.0,5
12622646,Lancing Old Boys II,Old Carthusians III,2,4,3.0,6
12622645,Old Cholmeleians II,Old Haberdashers,3,1,3.0,4
12622647,Old Reptonians,Old Wellingtonians,2,3,4.0,5
12622696,Kings College Wimbledon II,Old Brentwoods II,0,3,2.0,3
12622694,Old Aldenhamians II,Old Wykehamists II,4,1,2.0,5
12622695,Old Etonians II,Old Foresters II,9,0,0.0,9
12622766,Old Brentwoods III,Old Foresters III,2,2,5.0,4
12622767,Old Brentwoods IV,Old Cholmeleians IV,1,0,3.0,1
12622768,Old Chigwellians IV,Old Malvernians II,0,7,0.0,7
12612338,Lancing Old Boys,Old Etonians,1,2,4.0,3
12612337,Old Harrovians,Old Foresters,3,0,2.0,3
12612339,Old Tonbridgians,Old Brentwoods,3,4,4.0,7
12622587,Old Haileyburians,Old Aldenhamians,0,2,2.0,2
12622588,Old Westminsters,Old Radleians,2,0,2.0,2
12622648,Old Carthusians II,Lancing Old Boys II,1,0,3.0,1
12622649,Old Reptonians,Old Salopians II,2,2,5.0,4
12622697,Old Harrovians II,Old Etonians II,2,2,5.0,4
12622731,Old Cholmeleians III,Old Chigwellians III,3,2,4.0,5
12622732,Old Westminsters II,Old Epsomians,2,2,5.0,4
12622769,Old Chigwellians IV,Old Foresters III,3,2,4.0,5
12622770,Old Cholmeleians IV,Old Citizens,1,6,0.0,7
12622771,Old Malvernians II,Old Brentwoods IV,4,2,3.0,6
12612343,Lancing Old Boys,Old Harrovians,3,0,2.0,3
12612340,Old Chigwellians,Old Cholmeleians,0,0,4.0,0
12612341,Old Etonians,Old Brentwoods,3,4,4.0,7
12612342,Old Foresters,Old Carthusians,3,3,5.0,6
12622589,Old Bradfieldians,Old Malvernians,0,5,0.0,5
12622590,Old Haileyburians,Old Salopians,0,7,0.0,7
12622591,Old King's Scholars,Old Wykehamists,1,0,3.0,1
12622650,Old Carthusians III,Old Wellingtonians,8,0,0.0,8
12622651,Old Cholmeleians II,Old Carthusians II,1,2,4.0,3
12622652,Old Haberdashers,Lancing Old Boys II,0,6,0.0,6
12622653,Old Reptonians,Old Chigwellians II,1,1,4.0,2
12622700,Kings College Wimbledon II,Old Foresters II,6,3,3.0,9
12622698,Old Etonians II,Old Aldenhamians II,2,1,4.0,3
12622699,Old Harrovians II,Old Wykehamists II,5,2,2.0,7
12622701,Old Marlburians,Old Brentwoods II,3,1,3.0,4
12622733,Old Chigwellians III,Old Berkhamstedians,2,4,3.0,6
12622772,Old Chigwellians IV,Old Brentwoods III,3,2,4.0,5
12622773,Old Citizens,Old Malvernians II,3,3,5.0,6
12622774,Old Foresters IV,Old Brentwoods IV,0,1,3.0,1
12612346,KCS Old Boys,Old Cholmeleians,2,2,5.0,4
12612344,Old Carthusians,Old Etonians,4,1,2.0,5
12612345,Old Harrovians,Old Tonbridgians,8,0,0.0,8
12622592,Old Haileyburians,Old Wykehamists,0,3,2.0,3
12622593,Old Salopians,Old Malvernians,2,3,4.0,5
12622654,Old Carthusians III,Lancing Old Boys II,4,1,2.0,5
12622655,Old Haberdashers,Old Carthusians II,2,5,2.0,7
12622702,Old Etonians II,Old Harrovians II,1,2,4.0,3
12622703,Old Marlburians,Old Foresters II,3,1,3.0,4
12622734,Old Berkhamstedians,Old Amplefordians,1,0,3.0,1
12622735,Old Cholmeleians III,Old Epsomians,1,0,3.0,1
12622775,Old Brentwoods III,Old Cholmeleians IV,7,3,2.0,10
12622776,Old Citizens,Old Brentwoods IV,4,3,4.0,7
12622777,Old Foresters III,Old Malvernians II,1,5,2.0,6
12612348,KCS Old Boys,Lancing Old Boys,0,2,2.0,2
12612347,Old Brentwoods,Old Harrovians,1,3,3.0,4
12612349,Old Tonbridgians,Old Carthusians,1,8,0.0,9
12622594,Old Bradfieldians,Old Radleians,3,6,3.0,9
12622595,Old King's Scholars,Old Malvernians,1,2,4.0,3
12622596,Old Wykehamists,Old Aldenhamians,1,2,4.0,3
12622656,Old Carthusians II,Old Wellingtonians,2,0,2.0,2
12622657,Old Reptonians,Old Carthusians III,2,2,5.0,4
12622705,Kings College Wimbledon II,Old Marlburians,1,5,2.0,6
12622704,Old Foresters II,Old Brentwoods II,6,2,2.0,8
12622736,Old Epsomians,Old Eastbournians,2,1,4.0,3
12622737,Old Westminsters II,Old Cholmeleians III,5,2,2.0,7
12622778,Old Chigwellians IV,Old Brentwoods IV,3,1,3.0,4
12622779,Old Cholmeleians IV,Old Foresters IV,2,3,4.0,5
12622780,Old Foresters III,Old Citizens,1,5,2.0,6
12612353,KCS Old Boys,Old Carthusians,0,1,3.0,1
12612350,Old Brentwoods,Old Foresters,5,1,2.0,6
12612351,Old Chigwellians,Old Etonians,0,0,4.0,0
12612352,Old Cholmeleians,Old Tonbridgians,2,1,4.0,3
12622597,Old Bradfieldians,Old Aldenhamians,4,2,3.0,6
12622598,Old Haileyburians,Old King's Scholars,2,3,4.0,5
12622599,Old Radleians,Old Wykehamists,2,3,4.0,5
12622600,Old Westminsters,Old Malvernians,3,2,4.0,5
12622658,Old Carthusians II,Old Reptonians,1,1,4.0,2
12622659,Old Cholmeleians II,Old Wellingtonians,1,1,4.0,2
12622660,Old Haberdashers,Old Carthusians III,3,6,3.0,9
12622706,Old Aldenhamians II,Old Foresters II,4,2,3.0,6
12622707,Old Brentwoods II,Old Marlburians,2,6,2.0,8
12622738,Old Berkhamstedians,Old Westminsters II,2,1,4.0,3
12622739,Old Epsomians,Old Amplefordians,4,3,4.0,7
12622781,Old Chigwellians IV,Old Cholmeleians IV,2,3,4.0,5
12622782,Old Citizens,Old Brentwoods III,9,0,0.0,9
12622783,Old Foresters IV,Old Malvernians II,0,9,0.0,9
12612354,Old Carthusians,Old Cholmeleians,2,2,5.0,4
12612355,Old Foresters,Old Etonians,3,2,4.0,5
12622601,Old Haileyburians,Old Bradfieldians,2,0,2.0,2
12622602,Old Salopians,Old Wykehamists,2,1,4.0,3
12622603,Old Westminsters,Old Aldenhamians,5,0,0.0,5
12622661,Old Carthusians III,Old Reptonians,3,2,4.0,5
12622662,Old Chigwellians II,Old Carthusians II,1,4,2.0,5
12622708,Kings College Wimbledon II,Old Wykehamists II,3,1,3.0,4
12622709,Old Marlburians,Old Etonians II,5,2,2.0,7
12622740,Old Chigwellians III,Old Westminsters II,4,1,2.0,5
12622741,Old Cholmeleians III,Old Amplefordians,5,1,2.0,6
12622742,Old Eastbournians,Old Berkhamstedians,1,1,4.0,2
12622784,Old Foresters III,Old Cholmeleians IV,3,0,2.0,3
12612356,Old Brentwoods,Old Chigwellians,2,3,4.0,5
12612357,Old Foresters,Old Cholmeleians,2,3,4.0,5
12622604,Old Aldenhamians,Old Salopians,2,4,3.0,6
12622605,Old Bradfieldians,Old Wykehamists,4,4,6.0,8
12622663,Old Chigwellians II,Old Wellingtonians,3,0,2.0,3
12622664,Old Reptonians,Old Cholmeleians II,7,1,0.0,8
12622711,Kings College Wimbledon II,Old Aldenhamians II,3,4,4.0,7
12622710,Old Brentwoods II,Old Wykehamists II,2,1,4.0,3
12622743,Old Berkhamstedians,Old Cholmeleians III,0,1,3.0,1
12622744,Old Eastbournians,Old Amplefordians,5,2,2.0,7
12622745,Old Epsomians,Old Chigwellians III,5,2,2.0,7
12622785,Old Brentwoods III,Old Brentwoods IV,0,4,1.0,4
12622786,Old Foresters III,Old Foresters IV,1,2,4.0,3
13711962,Ampleforth College 1st XI,Old Amplefordians,2,4,3.0,6
13868764,Old Merchant Taylors,Old Cholmeleians II,4,0,1.0,4
13646388,Old Millfieldians,Old Cholmeleians II,4,3,4.0,7
13098821,Old Foresters,Lancing Old Boys,0,3,2.0,3
13098923,Old Wykehamists,Old Haileyburians,3,0,2.0,3
13097280,Old Harrovians III,Old Sennockians,6,1,0.0,7
13098752,Old Brentwoods,Lancing Old Boys,1,4,2.0,5
13098754,Old Cholmeleians,Old Carthusians,3,6,3.0,9
13098866,Old Westminsters,Old Aldenhamians,2,2,5.0,4
13469677,Old Marlburians,Old Carthusians III,4,1,2.0,5
13186732,Old Wellingtonians,Old Aldenhamians II,2,5,2.0,7
13186693,Old Cholmeleians II,Old Chigwellians II,0,8,0.0,8
13097201,Old Wykehamists II,Old Brentwoods II,3,0,2.0,3
13340143,Old Brentwoods IV,Old Amplefordians,7,2,0.0,9
13186723,Old Wellingtonians,Old Carthusians II,1,4,2.0,5
13617599,Old Etonians Vets,Old Harrovians Vets,3,2,4.0,5
13617591,Old Salopians Vets,Old Brentwoods Vets,2,4,3.0,6
13098809,Old Salopians,Lancing Old Boys,1,0,3.0,1
13469475,Old Foresters,Old Etonians,1,0,3.0,1
13098806,Old Cholmeleians,Old Harrovians,4,1,2.0,5
13300466,Old Tonbridgians,Old Radleians,4,0,1.0,4
13098860,Old King's Scholars,Old Westminsters,5,7,4.0,12
13186657,Lancing Old Boys II,Old Marlburians,1,2,4.0,3
13186703,Old Carthusians III,Old Haberdashers,6,1,0.0,7
13186716,Old Salopians II,Old Chigwellians II,2,0,2.0,2
13366107,Old Haberdashers,Old Carthusians III,1,4,2.0,5
13097217,Old Brentwoods II,Old Berkhamstedians,1,2,4.0,3
13097207,Old Cholmeleians III,Old Foresters II,1,1,4.0,2
13097339,Old Eastbournians,Old Stoics,5,3,4.0,8
13325406,Old Citizens,Old Westminsters II,3,2,4.0,5
13470117,Old Sennockians,Old Brentwoods IV,3,2,4.0,5
13418291,Old Cholmeleians IV,Old Foresters III,2,1,4.0,3
13578360,Old Aldenhamians,Queen Mary College Old Boys,2,5,2.0,7
13097266,Old Sennockians,Old Millhillians,2,1,4.0,3
13574448,Old Etonians Vets,Old Cholmeleians Vets,3,1,3.0,4
13597533,Old Brentwoods Vets,Old Kimboltonians Vets,1,0,3.0,1
13098835,Old Cholmeleians,Old Brentwoods,5,2,2.0,7
13469473,Old Malvernians,Lancing Old Boys,2,4,3.0,6
13098831,Old Salopians,Old Harrovians,2,2,5.0,4
13098852,Old Haileyburians,KCS Old Boys,0,3,2.0,3
13098868,Old Radleians,Old Tonbridgians,2,2,5.0,4
13098909,Old Westminsters,Old Reptonians,1,1,4.0,2
13098846,Old Wykehamists,Old Bradfieldians,2,5,2.0,7
13098915,Old King's Scholars,Old Aldenhamians,0,1,3.0,1
13186682,Old Aldenhamians II,Old Salopians II,2,1,4.0,3
13186695,Old Wellingtonians,Old Haberdashers,4,0,1.0,4
13186706,Old Chigwellians II,Old Cholmeleians II,0,1,3.0,1
13471390,Old Cholmeleians III,Old Harrovians II,5,1,2.0,6
13097198,Old Etonians II,Kings College Wimbledon II,2,0,2.0,2
13471385,Old Wykehamists II,Old Epsomians,2,4,3.0,6
13097204,Old Foresters II,Old Berkhamstedians,3,0,2.0,3
13097323,Old Bancroftians AFC,Old Citizens,1,3,3.0,4
13097333,Old Brentwoods III,Old Eastbournians,4,3,4.0,7
13097335,Old Malvernians II,Old Westminsters II,1,0,3.0,1
13097279,Old Amplefordians,Old Brentwoods IV,3,2,4.0,5
13097281,Old Cholmeleians IV,Old Sennockians,3,5,4.0,8
13602722,Old Carthusians,Old Foresters,3,0,2.0,3
13606994,Old Marlburians,Old Carthusians II,2,1,4.0,3
13612305,Old Stoics,Old Oundelians,0,1,3.0,1
13098782,Old Etonians,Old Brentwoods,3,0,2.0,3
13328099,Old Foresters,Old Cholmeleians,2,3,4.0,5
13098824,Lancing Old Boys,Old Carthusians,0,1,3.0,1
13098893,Old Radleians,KCS Old Boys,2,4,3.0,6
13098883,Old Reptonians,Old Haileyburians,3,2,4.0,5
13098891,Old Aldenhamians,Old Bradfieldians,3,1,3.0,4
13098884,Old Westminsters,Old Tonbridgians,0,3,2.0,3
13334851,Old Wykehamists,Old King's Scholars,1,2,4.0,3
13186674,Old Salopians II,Old Carthusians II,2,2,5.0,4
13419686,Old Cholmeleians II,Old Carthusians III,3,1,3.0,4
13186722,Old Haberdashers,Old Chigwellians II,2,1,4.0,3
13186652,Old Marlburians,Old Aldenhamians II,9,1,0.0,10
13186711,Old Wellingtonians,Lancing Old Boys II,1,2,4.0,3
13186662,Old Carthusians III,Old Cholmeleians II,1,3,3.0,4
13097215,Old Etonians II,Old Brentwoods II,1,0,3.0,1
13471386,Old Brentwoods II,Old Etonians II,0,2,2.0,2
13097212,Old Foresters II,Old Epsomians,2,1,4.0,3
13097293,Old Westminsters II,Old Bancroftians AFC,1,1,4.0,2
13097303,Old Malvernians II,Old Brentwoods III,4,0,1.0,4
13097294,Old Citizens,Old Chigwellians III,4,1,2.0,5
13399245,Old Cholmeleians IV,Old Brentwoods IV,0,1,3.0,1
13097268,Old Foresters III,Old Millhillians,1,6,0.0,7
13605355,Old Oundelians,Old Sennockians,3,1,3.0,4
13596451,Old Stoics,Old Amplefordians,5,1,2.0,6
13469472,Old Brentwoods,Old Salopians,1,1,4.0,2
13098787,Old Carthusians,Old Harrovians,3,1,3.0,4
13098785,Old Malvernians,Old Chigwellians,1,2,4.0,3
13098826,Old Chigwellians,Old Malvernians,1,1,4.0,2
13098827,Old Etonians,Old Foresters,2,1,4.0,3
13098874,KCS Old Boys,Old Westminsters,2,0,2.0,2
13098892,Old Haileyburians,Old Wykehamists,3,6,3.0,9
13098896,Old Radleians,Old Reptonians,6,4,4.0,10
13098897,Old Tonbridgians,Old King's Scholars,4,0,1.0,4
13186702,Lancing Old Boys II,Old Aldenhamians II,1,2,4.0,3
13186696,Old Chigwellians II,Old Wellingtonians,1,0,3.0,1
13186718,Old Haberdashers,Old Salopians II,5,1,2.0,6
13186727,Old Wellingtonians,Old Chigwellians II,3,2,4.0,5
13471388,Kings College Wimbledon II,Old Foresters II,1,4,2.0,5
13471389,Old Etonians II,Old Berkhamstedians,0,4,1.0,4
13097182,Old Brentwoods II,Old Cholmeleians III,2,0,2.0,2
13097195,Old Cholmeleians III,Old Brentwoods II,0,1,3.0,1
13097309,Old Brentwoods III,Old Chigwellians III,4,2,3.0,6
13097250,Old Brentwoods IV,Old Millhillians,1,0,3.0,1
13470114,Old Cholmeleians IV,Old Harrovians III,4,1,2.0,5
13597223,Old Carthusians II,Old Carthusians III,3,3,5.0,6
13585163,Old Marlburians,Old Millfieldians,4,3,4.0,7
13596475,Old Sennockians,Old Westminsters II,4,2,3.0,6
13591405,Old Citizens,Old Oundelians,2,2,5.0,4
13429247,Stowe School,Old Stoics,3,3,5.0,6
13098794,Lancing Old Boys,Old Foresters,0,2,2.0,2
13573198,Lancing Old Boys,Old Foresters,0,2,2.0,2
13507808,Old Foresters Vets,Old Harrovians Vets,1,2,4.0,3
13409652,Old Westminsters Vets,Old Kimboltonians Vets,1,2,4.0,3
13559025,Old Wykehamists Vets,Old Salopians Vets,1,3,3.0,4
13469471,Lancing Old Boys,Old Cholmeleians,3,3,5.0,6
13098825,Old Brentwoods,Old Harrovians,0,2,2.0,2
13300421,Old Foresters,Old Malvernians,10,0,0.0,10
13469469,Old Carthusians,Old Salopians,5,0,0.0,5
13098807,Old Etonians,Old Chigwellians,2,0,2.0,2
13098876,Old Tonbridgians,Old Bradfieldians,4,2,3.0,6
13098920,Old Westminsters,Old Wykehamists,3,3,5.0,6
13098857,Old Aldenhamians,Old Reptonians,1,2,4.0,3
13366108,Old Cholmeleians II,Old Marlburians,2,2,5.0,4
13186675,Old Carthusians III,Old Wellingtonians,1,1,4.0,2
13186701,Old Wellingtonians,Old Carthusians III,0,1,3.0,1
13471387,Old Harrovians II,Kings College Wimbledon II,5,2,2.0,7
13471391,Old Foresters II,Old Wykehamists II,5,1,2.0,6
13097172,Old Cholmeleians III,Old Epsomians,2,2,5.0,4
13097338,Old Chigwellians III,Old Bancroftians AFC,0,1,3.0,1
13470116,Old Millhillians,Old Amplefordians,3,5,4.0,8
13470115,Old Brentwoods IV,Old Cholmeleians IV,2,1,4.0,3
13574102,Old Citizens,Old Carthusians II,5,6,5.0,11
13585107,Old Brentwoods III,Old Stoics,0,1,3.0,1
13585110,Old Eastbournians,Old Westminsters II,2,3,4.0,5
13577982,Radley College 1st XI,Old Radleians,1,2,4.0,3
13372324,SAL Representative Team,Arthurian League Representative Team,0,1,3.0,1
13098802,Old Brentwoods,Old Foresters,1,4,2.0,5
13098798,Old Carthusians,Old Chigwellians,3,2,4.0,5
13098784,Old Harrovians,Lancing Old Boys,2,1,4.0,3
13098762,Old Salopians,Old Etonians,3,1,3.0,4
13098875,Old Haileyburians,Old Aldenhamians,2,8,0.0,10
13289947,Old Radleians,Old Bradfieldians,1,1,4.0,2
13098913,Old Westminsters,Old King's Scholars,3,0,2.0,3
13098903,KCS Old Boys,Old Reptonians,6,1,0.0,7
13098890,Old Tonbridgians,Old Wykehamists,2,3,4.0,5
13186679,Old Aldenhamians II,Old Carthusians III,0,2,2.0,2
13186710,Old Carthusians II,Old Marlburians,2,1,4.0,3
13186691,Old Wellingtonians,Old Salopians II,3,1,3.0,4
13186728,Lancing Old Boys II,Old Chigwellians II,3,0,2.0,3
13186670,Old Carthusians III,Old Aldenhamians II,1,0,3.0,1
13186659,Old Cholmeleians II,Old Haberdashers,4,3,4.0,7
13097177,Old Berkhamstedians,Old Cholmeleians III,4,2,3.0,6
13097210,Old Brentwoods II,Old Wykehamists II,1,1,4.0,2
13280587,Old Epsomians,Old Etonians II,1,1,4.0,2
13561370,Old Harrovians II,Old Millfieldians,1,5,2.0,6
13570987,Old Amplefordians,Old Chigwellians III,7,2,0.0,9
13570986,Old Bancroftians AFC,Old Brentwoods III,0,1,3.0,1
13570988,Old Brentwoods IV,Old Stoics,2,3,4.0,5
13570983,Old Cholmeleians IV,Old Oundelians,1,4,2.0,5
13570982,Old Westminsters II,Old Ardinians,3,0,2.0,3
13570990,Old Sennockians,Old Foresters III,3,1,3.0,4
13570989,Old Citizens,Old Alleynians AFC,3,0,2.0,3
13098783,Old Foresters,Old Salopians,1,1,4.0,2
13098810,Lancing Old Boys,Old Etonians,3,4,4.0,7
13413406,Old Reptonians Vets,Old Cholmeleians Vets,3,4,4.0,7
13098819,Old Etonians,Old Salopians,2,1,4.0,3
13098786,Lancing Old Boys,Old Chigwellians,4,1,2.0,5
13296802,Old Reptonians,Old Westminsters,1,1,4.0,2
13098881,KCS Old Boys,Old Aldenhamians,4,1,2.0,5
13098888,Old Haileyburians,Old Radleians,1,2,4.0,3
13186725,Old Cholmeleians II,Old Salopians II,5,1,2.0,6
13296886,Lancing Old Boys II,Old Carthusians III,0,1,3.0,1
13097181,Kings College Wimbledon II,Old Epsomians,2,6,2.0,8
13097185,Old Berkhamstedians,Old Harrovians II,2,2,5.0,4
13097168,Old Cholmeleians III,Old Wykehamists II,1,1,4.0,2
13097337,Old Brentwoods III,Old Malvernians II,3,2,4.0,5
13097329,Old Stoics,Old Westminsters II,1,3,3.0,4
13399798,Old Amplefordians,Old Cholmeleians IV,2,1,4.0,3
13097258,Old Foresters III,Old Sennockians,1,3,3.0,4
13550222,Old Foresters,Old Brentwoods,1,0,3.0,1
13535666,Old Tonbridgians,Old Carthusians,1,2,4.0,3
13549513,Old Carthusians II,Old Brentwoods II,2,0,2.0,2
13561449,Old Marlburians,Old Chigwellians II,6,1,0.0,7
13400464,Haberdashers Aske School 1st XI,Old Haberdashers,6,2,2.0,8
13423957,Old Foresters II,Forest School 1st XI,4,4,6.0,8
13401038,Old Etonians Vets,Old Chigwellians Vets,2,1,4.0,3
13098812,Old Chigwellians,Old Foresters,1,3,3.0,4
13098805,Old Brentwoods,Old Carthusians,0,2,2.0,2
13300422,Old Malvernians,Old Salopians,2,5,2.0,7
13098834,Old Etonians,Old Harrovians,2,1,4.0,3
13098904,Old Bradfieldians,Old King's Scholars,3,1,3.0,4
13339960,Old Radleians,Old Aldenhamians,0,3,2.0,3
13469538,KCS Old Boys,Old Tonbridgians,6,0,0.0,6
13186686,Old Carthusians III,Old Carthusians II,4,3,4.0,7
13399715,Old Haberdashers,Old Aldenhamians II,2,1,4.0,3
13186648,Old Salopians II,Lancing Old Boys II,1,1,4.0,2
13186707,Old Wellingtonians,Old Marlburians,1,0,3.0,1
13097222,Old Cholmeleians III,Kings College Wimbledon II,3,1,3.0,4
13097226,Old Epsomians,Old Foresters II,1,0,3.0,1
13097227,Old Etonians II,Old Harrovians II,2,2,5.0,4
13097336,Old Stoics,Old Bancroftians AFC,1,2,4.0,3
13438688,Lancing Old Boys,Old Reptonians,4,2,3.0,6
13550240,Old Kimboltonians,Old Chigwellians II,1,2,4.0,3
13549381,Old Millfieldians,Old Brentwoods III,6,4,4.0,10
13098830,Old Malvernians,Old Carthusians,2,6,2.0,8
13310577,Old Chigwellians,Old Salopians,1,1,4.0,2
13300469,Old Aldenhamians,Old Wykehamists,3,1,3.0,4
13098872,Old Tonbridgians,Old Reptonians,1,0,3.0,1
13098898,Old Westminsters,Old Haileyburians,1,3,3.0,4
13186665,Old Carthusians II,Old Cholmeleians II,1,0,3.0,1
13186714,Old Cholmeleians II,Old Carthusians II,1,1,4.0,2
13186646,Lancing Old Boys II,Old Haberdashers,3,0,2.0,3
13186708,Old Carthusians III,Old Chigwellians II,3,0,2.0,3
13186673,Old Chigwellians II,Old Carthusians III,1,4,2.0,5
13097200,Old Harrovians II,Old Berkhamstedians,0,4,1.0,4
13321421,Old Wykehamists II,Kings College Wimbledon II,3,7,2.0,10
13097175,Old Cholmeleians III,Old Etonians II,0,2,2.0,2
13097211,Old Etonians II,Old Cholmeleians III,3,2,4.0,5
13097330,Old Bancroftians AFC,Old Brentwoods III,1,1,4.0,2
13097325,Old Stoics,Old Malvernians II,1,0,3.0,1
13097326,Old Westminsters II,Old Eastbournians,1,1,4.0,2
13097271,Old Foresters III,Old Harrovians III,3,4,4.0,7
13438686,Old Brentwoods,Old Foresters,4,4,6.0,8
13515995,Old Alleynians AFC,Old Kimboltonians,3,3,5.0,6
13536696,Old Sennockians,Old Brentwoods II,0,3,2.0,3
13524757,Old Cholmeleians IV,Old Chigwellians III,1,6,0.0,7
13524785,Old Amplefordians,Old Millfieldians,0,5,0.0,5
13529650,Old Citizens,Old Epsomians,4,0,1.0,4
13098818,Old Chigwellians,Old Cholmeleians,0,2,2.0,2
13098887,KCS Old Boys,Old King's Scholars,10,0,0.0,10
13301407,Old Carthusians II,Old Chigwellians II,4,1,2.0,5
13097206,Kings College Wimbledon II,Old Brentwoods II,5,2,2.0,7
13097321,Old Malvernians II,Old Citizens,3,2,4.0,5
13426947,Old Millhillians,Old Harrovians III,2,3,4.0,5
13438687,Old Tonbridgians,Old Salopians,3,0,2.0,3
13478706,Old Westminsters,Old Carthusians,0,5,0.0,5
13529653,Old Carthusians III,Old Cholmeleians II,9,1,0.0,10
13529651,Old Harrovians II,Old Stoics,3,2,4.0,5
13420230,Old Sennockians,Old Ardinians,5,1,2.0,6
13506253,Old Carthusians III,Old Oundelians,6,2,2.0,8
13479987,Old Salopians Vets,Old Bradfieldians Vets,5,0,0.0,5
13414900,Old Alleynians AFC,Old Millfieldians,1,0,3.0,1
13469470,Old Cholmeleians,Old Malvernians,6,0,0.0,6
13098815,Old Harrovians,Old Carthusians,1,4,2.0,5
13300467,Old Tonbridgians,Old Westminsters,1,2,4.0,3
13296801,Old Aldenhamians,Old Haileyburians,0,2,2.0,2
13300472,Old Bradfieldians,Old Wykehamists,3,2,4.0,5
13186692,Old Aldenhamians II,Old Haberdashers,3,5,4.0,8
13186688,Old Marlburians,Old Salopians II,3,1,3.0,4
13186685,Old Wellingtonians,Old Cholmeleians II,2,2,5.0,4
13469676,Old Cholmeleians II,Old Wellingtonians,2,2,5.0,4
13455285,Old Citizens,Old Cholmeleians III,1,0,3.0,1
13455280,Old Wykehamists II,Old Chigwellians II,2,7,0.0,9
13420229,Old Amplefordians,Old Westminsters II,6,1,0.0,7
13518551,Glynn Old Boys II,Old Carthusians II,4,1,2.0,5
13406393,Old Suttonians,Old Carthusians III,5,2,2.0,7
13328065,Old Etonians,Old Cholmeleians,0,1,3.0,1
13098822,Old Harrovians,Old Chigwellians,4,0,1.0,4
13098914,Old Haileyburians,Old Bradfieldians,3,0,2.0,3
13339951,KCS Old Boys,Old Wykehamists,6,3,3.0,9
13098910,Old King's Scholars,Old Tonbridgians,1,8,0.0,9
13186672,Lancing Old Boys II,Old Cholmeleians II,0,3,2.0,3
13186715,Old Marlburians,Old Haberdashers,8,0,0.0,8
13097328,Old Malvernians II,Old Chigwellians III,3,2,4.0,5
13420232,Old Alleynians AFC,Old Brentwoods IV,4,1,2.0,5
13455288,Old Etonians II,Old Carthusians II,1,9,0.0,10
13430115,Old Aldenhamians,Old St Marys,2,0,2.0,2
13415965,Lancing Old Boys Vets,Old Foresters Vets,2,2,5.0,4
13401037,Old Carthusians Vets,Old Harrovians Vets,3,4,4.0,7
13469474,Old Brentwoods,Old Malvernians,5,1,2.0,6
13098820,Old Carthusians,Old Etonians,1,1,4.0,2
13098799,Old Harrovians,Old Foresters,2,3,4.0,5
13098779,Old Cholmeleians,Old Salopians,2,1,4.0,3
13098902,Old Wykehamists,Old Aldenhamians,3,2,4.0,5
13186700,Old Marlburians,Lancing Old Boys II,4,1,2.0,5
13471384,Old Berkhamstedians,Kings College Wimbledon II,2,1,4.0,3
13097331,Old Eastbournians,Old Chigwellians III,2,3,4.0,5
13420227,Old Bancroftians AFC,Old Millfieldians,1,3,3.0,4
13455281,Old Epsomians,Old Haberdashers,4,1,2.0,5
13420228,Old Harrovians III,Old Oundelians,3,7,2.0,10
13433406,Nottsborough FC,Old Carthusians III,3,0,2.0,3
13380243,Albanian FC,Old Carthusians II,0,5,0.0,5
13383308,"The King's School, Canterbury",Old King's Scholars,7,4,3.0,11
13098829,Old Foresters,Old Chigwellians,0,1,3.0,1
13098771,Old Malvernians,Old Cholmeleians,1,4,2.0,5
13098895,Old Bradfieldians,Old Aldenhamians,1,2,4.0,3
13098922,Old King's Scholars,KCS Old Boys,0,4,1.0,4
13186712,Old Aldenhamians II,Old Wellingtonians,2,4,3.0,6
13186690,Old Marlburians,Old Cholmeleians II,7,2,0.0,9
13455284,Lancing Old Boys II,Old Brentwoods III,0,2,2.0,2
13455279,Old Stoics,Old Salopians II,4,2,3.0,6
13409612,Old Aldenhamians Vets,Old Salopians Vets,2,3,4.0,5
13469468,Old Harrovians,Old Cholmeleians,1,0,3.0,1
13328098,Old Foresters,Old Carthusians,2,2,5.0,4
13289985,Old Bradfieldians,Old Radleians,2,1,4.0,3
13098879,Old Reptonians,Old King's Scholars,6,0,0.0,6
13098880,Old Tonbridgians,KCS Old Boys,1,2,4.0,3
13362726,Old Westminsters,Old Haileyburians,4,1,2.0,5
13455282,Kings College Wimbledon II,Old Malvernians II,0,5,0.0,5
13455287,Old Eastbournians,Old Harrovians II,1,3,3.0,4
13420233,Old Foresters III,Old Kimboltonians,3,3,5.0,6
13455283,Old Wellingtonians,Old Cholmeleians II,1,3,3.0,4
13455278,Old Foresters II,Old Aldenhamians II,1,2,4.0,3
13455286,Old Berkhamstedians,Old Marlburians,0,7,0.0,7
13417926,Old Chigwellians,Winchmore Hill,0,4,1.0,4
13417925,Alleyn Old Boys,Lancing Old Boys,4,0,1.0,4
13457337,Old Salopians,Old Carthusians,1,2,4.0,3
13421731,Sevenoaks School 1st XI,Old Sennockians,1,1,4.0,2
13098832,Lancing Old Boys,Old Brentwoods,0,2,2.0,2
13098753,Old Chigwellians,Old Etonians,3,3,5.0,6
13300470,Old Aldenhamians,Old Radleians,0,5,0.0,5
13186661,Old Aldenhamians II,Old Carthusians II,3,3,5.0,6
13186704,Old Chigwellians II,Old Salopians II,3,0,2.0,3
13097202,Old Brentwoods II,Old Harrovians II,5,4,5.0,9
13097199,Old Foresters II,Old Cholmeleians III,2,0,2.0,2
13097324,Old Chigwellians III,Old Brentwoods III,0,5,0.0,5
13097275,Old Harrovians III,Old Brentwoods IV,1,3,3.0,4
13348361,Old Berkhamstedians,Old Reptonians,2,8,0.0,10
13362312,Old Carthusians,Old Wykehamists,5,0,0.0,5
13348338,Old Marlburians,Old Foresters,0,4,1.0,4
12751555,Old Salopians,Old Cholmeleians,6,1,0.0,7
13391759,Old Cholmeleians II,Royal Bank of Scotland II,0,10,0.0,10
13391758,Old Westminsters,New College Old Boys,3,3,5.0,6
13391732,Civil Service III,Old Carthusians III,0,1,3.0,1
13098789,Old Brentwoods,Old Etonians,4,3,4.0,7
13098792,Old Harrovians,Old Salopians,1,5,2.0,6
13098899,Old Bradfieldians,Old Reptonians,3,1,3.0,4
13339961,Old Radleians,Old Westminsters,4,1,2.0,5
13098870,KCS Old Boys,Old Haileyburians,9,3,0.0,12
13186678,Lancing Old Boys II,Old Carthusians II,0,3,2.0,3
13186664,Old Aldenhamians II,Old Chigwellians II,2,3,4.0,5
13392713,Old Salopians II,Old Haberdashers,3,2,4.0,5
13097194,Kings College Wimbledon II,Old Harrovians II,0,2,2.0,2
13340215,Old Brentwoods II,Old Foresters II,2,2,5.0,4
13399216,Old Wykehamists II,Old Cholmeleians III,0,1,3.0,1
13310579,Old Bancroftians AFC,Old Eastbournians,1,1,4.0,2
13097320,Old Brentwoods III,Old Stoics,2,3,4.0,5
13097322,Old Westminsters II,Old Chigwellians III,1,0,3.0,1
13097242,Old Sennockians,Old Foresters III,7,1,0.0,8
13348123,Old Tonbridgians,Old Malvernians,4,0,1.0,4
13376665,Bealonians,Lancing Old Boys,0,6,0.0,6
13377162,Old Chigwellians,Old Stationers,3,2,4.0,5
13376666,Old Suttonians,Old Foresters,3,2,4.0,5
13363083,Old Wilsonians,Old Carthusians,3,1,3.0,4
13380546,Old Aldenhamians,Old Sedcopians,2,1,4.0,3
13340216,UCL Academicals III,Old Cholmeleians II,3,0,2.0,3
13329168,Old Aldenhamians Vets,Old Foresters Vets,1,4,2.0,5
13377332,Old Carthusians,Old Cholmeleians,1,0,3.0,1
13098813,Old Chigwellians,Old Brentwoods,1,2,4.0,3
13098817,Lancing Old Boys,Old Malvernians,2,1,4.0,3
13328042,Old Salopians,Old Foresters,1,1,4.0,2
13098878,Old Bradfieldians,Old Westminsters,3,1,3.0,4
13098919,Old Reptonians,Old Radleians,3,2,4.0,5
13098918,Old King's Scholars,Old Haileyburians,2,3,4.0,5
13098911,Old Wykehamists,KCS Old Boys,2,4,3.0,6
13300473,Old Aldenhamians,Old Tonbridgians,2,0,2.0,2
13186671,Old Marlburians,Old Carthusians II,1,1,4.0,2
13186669,Old Salopians II,Old Wellingtonians,1,2,4.0,3
13097191,Old Berkhamstedians,Old Brentwoods II,2,9,0.0,11
13340267,Old Harrovians II,Old Cholmeleians III,4,1,2.0,5
13340277,Old Wykehamists II,Old Foresters II,0,0,4.0,0
13097316,Old Bancroftians AFC,Old Chigwellians III,1,1,4.0,2
13097317,Old Brentwoods III,Old Westminsters II,7,1,0.0,8
13097318,Old Eastbournians,Old Malvernians II,0,2,2.0,2
13097319,Old Stoics,Old Citizens,2,4,3.0,6
13097270,Old Harrovians III,Old Amplefordians,0,2,2.0,2
13340145,Old Millhillians,Old Cholmeleians IV,5,3,4.0,8
13383453,Old Cholmeleians II,Icarus,1,2,4.0,3
13367712,Old Meadonians,Old Carthusians III,0,1,3.0,1
13414898,Millfield School 1st XI,Old Millfieldians,1,3,3.0,4
13260192,Old Salopians Vets,Old Chigwellians Vets,3,4,4.0,7
13260193,Old Westminsters Vets,Old Harrovians Vets,2,3,4.0,5
13260189,Old Wykehamists Vets,Old Etonians Vets,0,7,0.0,7
13098797,Old Etonians,Old Carthusians,1,2,4.0,3
13098776,Old Salopians,Old Brentwoods,2,1,4.0,3
13098775,Old Malvernians,Old Harrovians,1,0,3.0,1
13098861,Old Radleians,Old Haileyburians,2,2,5.0,4
13098862,Old Reptonians,KCS Old Boys,2,2,5.0,4
13098863,Old Wykehamists,Old Tonbridgians,1,3,3.0,4
13098864,Old King's Scholars,Old Bradfieldians,1,5,2.0,6
13186680,Old Chigwellians II,Old Marlburians,2,2,5.0,4
13186643,Old Haberdashers,Lancing Old Boys II,5,3,4.0,8
13186709,Old Salopians II,Old Aldenhamians II,1,2,4.0,3
13097187,Kings College Wimbledon II,Old Cholmeleians III,5,3,4.0,8
13097188,Old Epsomians,Old Berkhamstedians,1,2,4.0,3
13097189,Old Foresters II,Old Brentwoods II,1,0,3.0,1
13321426,Old Harrovians II,Old Wykehamists II,3,2,4.0,5
13097315,Old Stoics,Old Chigwellians III,1,4,2.0,5
13340221,Old Foresters III,Old Cholmeleians IV,1,1,4.0,2
13097252,Old Sennockians,Old Amplefordians,1,2,4.0,3
13328018,Mill Hill Village,Old Cholmeleians II,2,4,3.0,6
13359845,Old Carthusians II,Merton,1,4,2.0,5
13328017,Old Westminsters,Carshalton,2,0,2.0,2
13380236,Enfield Old Grammarians,Old Carthusians III,1,5,2.0,6
13328023,Old Hamptonians,Old Chigwellians,8,0,0.0,8
13366204,Old Carthusians,Old Malvernians,5,0,0.0,5
13366205,Old Salopians,Old Cholmeleians,1,2,4.0,3
13098908,KCS Old Boys,Old Bradfieldians,3,2,4.0,5
13296800,Old Haileyburians,Old Westminsters,2,4,3.0,6
13186720,Old Aldenhamians II,Lancing Old Boys II,2,3,4.0,5
13366106,Old Haberdashers,Old Cholmeleians II,2,2,5.0,4
13366267,Old Salopians II,Old Marlburians,1,4,2.0,5
13097221,Old Berkhamstedians,Old Wykehamists II,1,2,4.0,3
13238939,Old Brentwoods II,Old Epsomians,3,2,4.0,5
13097184,Old Foresters II,Old Harrovians II,2,2,5.0,4
13097312,Old Bancroftians AFC,Old Malvernians II,1,2,4.0,3
13097313,Old Brentwoods III,Old Citizens,1,6,0.0,7
13097314,Old Eastbournians,Old Westminsters II,0,0,4.0,0
13321539,Old Brentwoods IV,Old Sennockians,5,4,5.0,9
13368824,Old Harrovians III,Old Millhillians,4,4,6.0,8
13340172,Old Foresters III,Old Amplefordians,2,3,4.0,5
13340286,Kings College Wimbledon II,Old Minchendenians,4,5,5.0,9
13340285,UCL Academicals III,Old Cholmeleians III,5,1,2.0,6
13328072,Richmond & Kew SAL,Lancing Old Boys,2,3,4.0,5
13328071,Merton,Old Chigwellians,1,3,3.0,4
13328069,Old Foresters,Globe Rangers,5,0,0.0,5
13034803,Old Carthusians II,Wood Green Old Boys,7,1,0.0,8
13339942,Old Aldenhamians,Old Magdalenians,4,1,2.0,5
13339941,Old Reptonians,Witan,0,5,0.0,5
13328022,Old Brentwoods,Mayfield,3,4,4.0,7
13260187,Old Bradfieldians Vets,Old Carthusians Vets,2,4,3.0,6
13328841,Old Malvernians,Old Etonians,0,5,0.0,5
13098770,Old Harrovians,Old Brentwoods,6,1,0.0,7
13098855,Old Westminsters,Old Bradfieldians,6,3,3.0,9
13098894,Old Reptonians,Old Tonbridgians,2,2,5.0,4
13098917,Old Aldenhamians,KCS Old Boys,0,2,2.0,2
13098854,Old King's Scholars,Old Radleians,2,6,2.0,8
13356040,Old Cholmeleians II,Old Aldenhamians II,7,0,0.0,7
13355967,Old Marlburians,Old Wellingtonians,7,1,0.0,8
13186730,Old Carthusians III,Old Salopians II,4,1,2.0,5
13280588,Old Epsomians,Kings College Wimbledon II,5,2,2.0,7
13097219,Old Etonians II,Old Wykehamists II,1,1,4.0,2
13097311,Old Malvernians II,Old Stoics,0,5,0.0,5
13097310,Old Citizens,Old Eastbournians,6,1,0.0,7
13340144,Old Harrovians III,Old Foresters III,3,4,4.0,7
13097264,Old Millhillians,Old Brentwoods IV,2,2,5.0,4
12751372,Old Haileyburians,Old Haberdashers,5,1,2.0,6
13328070,Old Finchleians,Old Carthusians,3,9,0.0,12
13328073,Old Salopians,Albanian FC,1,2,4.0,3
13098773,Old Carthusians,Lancing Old Boys,3,0,2.0,3
13328854,Old Brentwoods,Old Cholmeleians,4,2,3.0,6
13337186,Old Wykehamists,Old Radleians,2,2,5.0,4
13334854,Old Aldenhamians,Old King's Scholars,7,1,0.0,8
13334529,Old Carthusians III,Old Marlburians,3,2,4.0,5
13301446,Old Chigwellians II,Old Carthusians II,1,3,3.0,4
13097178,Old Foresters II,Kings College Wimbledon II,1,5,2.0,6
13097179,Old Harrovians II,Old Brentwoods II,4,3,4.0,7
13337239,Old Wykehamists II,Old Etonians II,2,5,2.0,7
13097304,Old Chigwellians III,Old Malvernians II,2,2,5.0,4
13097306,Old Eastbournians,Old Bancroftians AFC,6,2,2.0,8
13097307,Old Westminsters II,Old Brentwoods III,3,3,5.0,6
13097305,Old Citizens,Old Stoics,1,1,4.0,2
13097244,Old Harrovians III,Old Cholmeleians IV,2,4,3.0,6
13097276,Old Amplefordians,Old Sennockians,1,4,2.0,5
12751375,Old Reptonians,Old Harrovians,3,2,4.0,5
12751368,KCS Old Boys,Old Foresters,6,7,5.0,13
12751373,Old Etonians,Old Tonbridgians,0,2,2.0,2
13327057,Old Wokingians I,Old Salopians,3,1,3.0,4
13278604,Old Cholmeleians III,Old Parmiterians,0,2,2.0,2
13282903,Old Woodhouseians,Old Westminsters,3,1,3.0,4
13260150,Old Foresters Vets,Old Kimboltonians Vets,1,0,3.0,1
13300420,Old Harrovians,Old Etonians,2,2,5.0,4
13324183,Old Malvernians,Old Foresters,2,8,0.0,10
13098916,Old Reptonians,Old Wykehamists,1,0,3.0,1
13289645,Old Tonbridgians,Old Haileyburians,4,3,4.0,7
13301405,Old Chigwellians II,Old Aldenhamians II,4,0,1.0,4
13356041,Old Salopians II,Old Carthusians III,1,4,2.0,5
13304933,Old Epsomians,Old Cholmeleians III,4,2,3.0,6
13304934,Old Harrovians II,Old Etonians II,0,2,2.0,2
13097301,Old Bancroftians AFC,Old Stoics,3,3,5.0,6
13325405,Old Westminsters II,Old Citizens,0,9,0.0,9
13301451,Old Sennockians,Old Cholmeleians IV,5,3,4.0,8
13301452,Old Millhillians,Old Foresters III,3,4,4.0,7
13097241,Old Brentwoods IV,Old Harrovians III,2,3,4.0,5
12751377,Lancing Old Boys,Old Chigwellians,2,1,4.0,3
12751369,Old Berkhamstedians,Old Aldenhamians,6,4,4.0,10
12751370,Old Eastbournians,Old Bradfieldians,2,3,4.0,5
12751367,Old King's Scholars,Old Carthusians,0,5,0.0,5
13034757,Bealonians,Old Cholmeleians,1,1,4.0,2
13289583,KCS Old Boys,Phoenix Old Boys,4,5,5.0,9
13262202,Old Carthusians II,Old Brentwoods II,2,2,5.0,4
13299014,Old Chigwellians III,Old Aloysians,1,4,2.0,5
13219853,Old Cholmeleians II,Wandsworth Borough,8,1,0.0,9
13251936,Polytechnic 2s,Old Haberdashers,4,0,1.0,4
13262201,Weirside Rangers,Old Westminsters,2,3,4.0,5
13098764,Old Chigwellians,Old Harrovians,1,1,4.0,2
13098765,Old Etonians,Old Malvernians,2,2,5.0,4
13098763,Lancing Old Boys,Old Salopians,3,1,3.0,4
13098849,Old Bradfieldians,Old Haileyburians,3,3,5.0,6
13098850,Old King's Scholars,Old Reptonians,1,5,2.0,6
13098851,Old Westminsters,KCS Old Boys,1,3,3.0,4
13186666,Old Aldenhamians II,Old Marlburians,4,8,2.0,12
13186654,Old Carthusians II,Old Salopians II,3,1,3.0,4
13186697,Old Cholmeleians II,Lancing Old Boys II,5,1,2.0,6
13186656,Old Haberdashers,Old Wellingtonians,1,2,4.0,3
13238940,Old Berkhamstedians,Old Etonians II,2,3,4.0,5
13097224,Old Harrovians II,Old Epsomians,1,3,3.0,4
13097298,Old Brentwoods III,Old Bancroftians AFC,1,1,4.0,2
13097299,Old Chigwellians III,Old Eastbournians,2,2,5.0,4
13097300,Old Citizens,Old Malvernians II,3,2,4.0,5
13097237,Old Foresters III,Old Brentwoods IV,6,2,2.0,8
13097239,Old Millhillians,Old Sennockians,5,1,2.0,6
13262768,Kings College Wimbledon II,BB Eagles,2,0,2.0,2
13033726,Old Aldenhamians,Lea Valley,1,4,2.0,5
13033725,Old Cholmeleians,Old Carthusians,2,8,0.0,10
13262760,Old Cholmeleians III,Old Buckwellians,1,1,4.0,2
13034802,Old Tenisonians,Old Chigwellians II,2,1,4.0,3
13033724,Polytechnic,Old Brentwoods,3,2,4.0,5
13034676,Sinjun Grammarians,Old Brentwoods II,3,1,3.0,4
13262759,Weirside Rangers,Old Carthusians III,0,5,0.0,5
13198366,Old Wykehamists,Winchester College 1st XI,1,0,3.0,1
13198365,Old Wykehamists II,Winchester College 2nd XI,5,1,2.0,6
13098760,Old Foresters,Old Brentwoods,1,2,4.0,3
13098761,Old Harrovians,Old Malvernians,4,2,3.0,6
13098814,Old Cholmeleians,Lancing Old Boys,1,3,3.0,4
13098836,Old Salopians,Old Chigwellians,3,3,5.0,6
13098900,Old Haileyburians,Old King's Scholars,4,0,1.0,4
13098882,Old Radleians,Old Wykehamists,1,4,2.0,5
13186651,Old Carthusians II,Old Carthusians III,0,2,2.0,2
13186694,Old Marlburians,Old Chigwellians II,4,2,3.0,6
13186653,Old Salopians II,Old Cholmeleians II,0,3,2.0,3
13186644,Lancing Old Boys II,Old Wellingtonians,2,3,4.0,5
13097167,Kings College Wimbledon II,Old Berkhamstedians,3,5,4.0,8
13097169,Old Epsomians,Old Brentwoods II,5,1,2.0,6
13097170,Old Foresters II,Old Etonians II,1,3,3.0,4
13097295,Old Eastbournians,Old Brentwoods III,2,0,2.0,2
13097297,Old Westminsters II,Old Stoics,1,2,4.0,3
13097334,Old Chigwellians III,Old Citizens,1,4,2.0,5
13097296,Old Malvernians II,Old Bancroftians AFC,1,1,4.0,2
13097235,Old Cholmeleians IV,Old Millhillians,4,6,4.0,10
13097234,Old Amplefordians,Old Harrovians III,7,1,0.0,8
13033634,Citigroup,Old Reptonians,1,3,3.0,4
13033633,Old Edmontonians,Old Aldenhamians,2,4,3.0,6
13098756,Lancing Old Boys,Old Harrovians,4,2,3.0,6
13098777,Old Brentwoods,Old Chigwellians,3,3,5.0,6
13098758,Old Carthusians,Old Foresters,2,2,5.0,4
13098759,Old Cholmeleians,Old Etonians,3,4,4.0,7
13098757,Old Salopians,Old Malvernians,2,1,4.0,3
13098847,Old Bradfieldians,Old Tonbridgians,2,4,3.0,6
13098907,Old King's Scholars,Old Wykehamists,2,6,2.0,8
13098926,Old Westminsters,Old Radleians,6,1,0.0,7
13186649,Old Carthusians II,Old Wellingtonians,4,0,1.0,4
13186713,Old Carthusians III,Lancing Old Boys II,3,1,3.0,4
13186650,Old Chigwellians II,Old Haberdashers,3,2,4.0,5
13097186,Old Brentwoods II,Kings College Wimbledon II,2,3,4.0,5
13097166,Old Etonians II,Old Epsomians,2,4,3.0,6
13097190,Old Wykehamists II,Old Harrovians II,1,2,4.0,3
13097165,Old Berkhamstedians,Old Foresters II,1,4,2.0,5
13097308,Old Bancroftians AFC,Old Westminsters II,1,2,4.0,3
13097292,Old Stoics,Old Brentwoods III,7,1,0.0,8
13097232,Old Amplefordians,Old Millhillians,4,6,4.0,10
13034677,Latymer Old Boys,Old Aldenhamians II,3,2,4.0,5
13033627,Old Eastbournians,Old Meadonians,0,1,3.0,1
13033626,Old Edmontonians,Old Cholmeleians III,3,4,4.0,7
13033696,Old Westminster Citizens,Old Salopians II,3,1,3.0,4
13198338,Old Aldenhamians,Aldenham School 1st XI,3,2,4.0,5
13098803,Old Chigwellians,Lancing Old Boys,0,2,2.0,2
13120584,Old Malvernians,Old Brentwoods,2,3,4.0,5
13098755,Old Foresters,Old Harrovians,1,1,4.0,2
13098843,Old Haileyburians,Old Reptonians,4,2,3.0,6
13098844,Old Radleians,Old King's Scholars,0,3,2.0,3
13098845,Old Tonbridgians,Old Aldenhamians,4,0,1.0,4
13186663,Lancing Old Boys II,Old Salopians II,2,0,2.0,2
13186684,Old Haberdashers,Old Marlburians,1,1,4.0,2
13097161,Kings College Wimbledon II,Old Etonians II,5,3,4.0,8
13097162,Old Cholmeleians III,Old Berkhamstedians,1,1,4.0,2
13097163,Old Epsomians,Old Wykehamists II,2,4,3.0,6
13097164,Old Harrovians II,Old Foresters II,1,3,3.0,4
13097290,Old Chigwellians III,Old Stoics,7,0,0.0,7
13097291,Old Eastbournians,Old Citizens,1,5,2.0,6
13097228,Old Brentwoods IV,Old Foresters III,6,0,0.0,6
13097231,Old Sennockians,Old Harrovians III,6,1,0.0,7
13033682,Old Aldenhamians II,Wake Green Amateur,1,5,2.0,6
13035630,Old Bancroftians AFC,Old Salvatorians,0,5,0.0,5
13033684,Old Brentwoods II,UCL Academicals,6,5,5.0,11
13033631,Old Brentwoods III,Hale End Athletic,2,7,0.0,9
13033683,Old Josephians,KCS Old Boys,0,16,1.0,16
13035610,Old Millhillians,Old Cholmeleians II,0,15,1.0,15
13033660,Old Salopians,South Bank Cuaco,3,0,2.0,3
13033685,Old Sedcopians,Old Carthusians II,2,7,0.0,9
13033630,Old Wokingians,Old Carthusians III,1,2,4.0,3
13238922,Arthurian League Representative Team,Forest School 1st XI,3,2,4.0,5
13098750,Old Carthusians,Old Brentwoods,3,1,3.0,4
13098751,Old Etonians,Lancing Old Boys,1,3,3.0,4
13098790,Old Cholmeleians,Old Chigwellians,0,3,2.0,3
13098841,KCS Old Boys,Old Radleians,1,1,4.0,2
13098921,Old Aldenhamians,Old Westminsters,1,1,4.0,2
13098885,Old Haileyburians,Old Tonbridgians,2,2,5.0,4
13098842,Old Wykehamists,Old Reptonians,3,2,4.0,5
13186683,Old Chigwellians II,Lancing Old Boys II,1,2,4.0,3
13186689,Old Haberdashers,Old Carthusians II,1,5,2.0,6
13186699,Old Aldenhamians II,Old Cholmeleians II,2,2,5.0,4
13097160,Old Wykehamists II,Old Berkhamstedians,4,4,6.0,8
13097159,Old Etonians II,Old Foresters II,0,1,3.0,1
13097287,Old Citizens,Old Brentwoods III,9,0,0.0,9
13097289,Old Westminsters II,Old Malvernians II,3,5,4.0,8
13097288,Old Stoics,Old Eastbournians,3,2,4.0,5
13097230,Old Cholmeleians IV,Old Amplefordians,0,2,2.0,2
13033737,Old Carthusians III,Wandsworth Borough,6,1,0.0,7
13033736,Old Cholmeleians III,Southgate County,4,2,3.0,6
13033735,Old Dorkinians,Kings College Wimbledon II,0,2,2.0,2
13098749,Old Cholmeleians,Old Foresters,1,3,3.0,4
13098838,Old Bradfieldians,KCS Old Boys,1,7,0.0,8
13098839,Old Reptonians,Old Aldenhamians,4,3,4.0,7
13098840,Old Wykehamists,Old Westminsters,2,2,5.0,4
13186645,Old Carthusians II,Old Aldenhamians II,8,0,0.0,8
13097213,Kings College Wimbledon II,Old Wykehamists II,4,0,1.0,4
13097156,Old Berkhamstedians,Old Epsomians,3,0,2.0,3
13097285,Old Citizens,Old Bancroftians AFC,7,0,0.0,7
13097286,Old Malvernians II,Old Eastbournians,4,2,3.0,6
13097284,Old Chigwellians III,Old Westminsters II,2,1,4.0,3
13097255,Old Amplefordians,Old Foresters III,10,1,0.0,11
13033674,Old Chigwellians II,Civil Service II,1,4,2.0,5
13033672,Old Cholmeleians II,Old Owens,4,3,4.0,7
13033676,Old Garchonians,Old Haileyburians,8,2,0.0,10
13033677,Old Millhillians,Old Challoners,6,6,6.0,12
13033675,Old Salopians II,Latymer Old Boys,1,4,2.0,5
13033673,Old Vaughanians,Old Haberdashers,3,7,2.0,10
13186314,Brentwood School 1st XI,Old Brentwoods,1,3,3.0,4
13186313,Brentwood School 2nd XI,Old Brentwoods II,3,0,2.0,3
13186312,Brentwood School 3rd XI,Old Brentwoods III,3,3,5.0,6
13186311,Brentwood School 4th XI,Old Brentwoods IV,3,3,5.0,6
13186316,Lancing College 1st XI,Lancing Old Boys,2,6,2.0,8
13186315,Lancing College 2nd XI,Lancing Old Boys II,2,0,2.0,2
13092967,Old Harrovians II,Old Etonians II,2,6,2.0,8
13072601,Old Malvernians,Old Tonbridgians,2,4,3.0,6
13175344,KCS Old Boys,Old Harrovians,1,1,4.0,2
13020710,Old Berkhamstedians,Old Amplefordians,7,5,4.0,12
13182491,Old Cholmeleians III,Old Cholmeleians IV,3,2,4.0,5
13120495,Old Etonians,Eton College 1st XI,2,0,2.0,2
13020745,Old Carthusians,Old Wilsonians,1,2,4.0,3
14275055,Old Chigwellians,Old Malvernians,9,2,0.0,11
14257696,Old Carthusians,Lancing Old Boys,2,1,4.0,3
14273784,Old Carthusians II,Old Carthusians III,3,4,4.0,7
14273927,Old Cholmeleians III,Old Brentwoods III,3,3,5.0,6
14760201,Old Alleynians AFC,Old Millhillians,3,0,2.0,3
14749381,Lancing Old Boys Vets,Old Etonians Vets,2,2,5.0,4
14755936,Old Reptonians Vets,Old Malvernians Vets,0,2,2.0,2
14257719,Old Etonians,Old Salopians,2,3,4.0,5
14257724,Old Cholmeleians,Lancing Old Boys,1,1,4.0,2
14275057,Old Reptonians,Old Aldenhamians,2,0,2.0,2
14275024,Old Westminsters,Old Chigwellians,2,6,2.0,8
14275054,Old Wykehamists,Old Malvernians,1,3,3.0,4
14273815,Old Wellingtonians,Old Cholmeleians II,8,2,0.0,10
14273883,Old Foresters II,Old Chigwellians II,1,2,4.0,3
14273976,Old Haberdashers,Old Carthusians III,1,2,4.0,3
14260372,Old Berkhamstedians,Old Millfieldians,0,3,2.0,3
14260320,Kings College Wimbledon II,Old Citizens,1,5,2.0,6
14260355,Old Epsomians,Old Harrovians II,2,0,2.0,2
14273833,Old Brentwoods III,Old Sennockians,1,3,3.0,4
14273863,Old Westminsters II,Old Tonbridgians II,4,6,4.0,10
14741632,Old Alleynians AFC,Old Bancroftians AFC,4,1,2.0,5
14257672,Old Etonians,Old Foresters,3,4,4.0,7
14749421,Old Reptonians Vets,Old Westminsters Vets,2,2,5.0,4
14257677,Old Etonians,Old Tonbridgians,2,0,2.0,2
14257725,Old Foresters,KCS Old Boys,5,1,2.0,6
14257723,Old Brentwoods,Old Salopians,1,1,4.0,2
14257681,Old Cholmeleians,Old Harrovians,3,0,2.0,3
14275028,Old Aldenhamians,Old Malvernians,4,4,6.0,8
14275015,Old Westminsters,Old Bradfieldians,2,5,2.0,7
14273929,Old King's Scholars,Old Haberdashers,0,3,2.0,3
14273864,Lancing Old Boys II,Old Chigwellians II,2,2,5.0,4
14273961,Old Carthusians III,Old Etonians II,5,0,0.0,5
14260323,Old Berkhamstedians,Kings College Wimbledon II,3,2,4.0,5
14260321,Old Epsomians,Old Brentwoods II,7,0,0.0,7
14260400,Old Salopians II,Old Citizens,1,2,4.0,3
14273915,Old Cholmeleians III,Old Chigwellians III,0,3,2.0,3
14273939,Old Westminsters II,Old Tonbridgians II,2,2,5.0,4
14728090,Lancing Old Boys,Old Carthusians,0,1,3.0,1
14736839,Old Millfieldians,Old Carthusians II,0,2,2.0,2
14748644,Old Alleynians AFC,Old Sennockians,3,0,2.0,3
14707143,Old Brentwoods Vets,Lancing Old Boys Vets,1,2,4.0,3
14691177,Old Malvernians Vets,Old Wykehamists Vets,1,0,3.0,1
14676473,Old Reptonians Vets,Old Harrovians Vets,3,1,3.0,4
14257693,Old Brentwoods,Old Tonbridgians,2,1,4.0,3
14257712,Lancing Old Boys,Old Etonians,1,2,4.0,3
14257675,Old Harrovians,Old Carthusians,0,4,1.0,4
14257673,Old Foresters,Old Cholmeleians,4,0,1.0,4
14275039,Old Wykehamists,Old Haileyburians,3,1,3.0,4
14275041,Old Chigwellians,Old Westminsters,5,1,2.0,6
14275020,Old Reptonians,Old Bradfieldians,1,5,2.0,6
14275032,Old Radleians,Old Malvernians,6,2,2.0,8
14273895,Old Carthusians II,Old King's Scholars,4,1,2.0,5
14273790,Old Carthusians III,Old Wellingtonians,2,1,4.0,3
14273846,Old Chigwellians II,Old Etonians II,5,0,0.0,5
14273898,Old Foresters II,Old Haberdashers,2,0,2.0,2
14260368,Old Brentwoods II,Kings College Wimbledon II,3,2,4.0,5
14260380,Old Millfieldians,Old Harrovians II,3,2,4.0,5
14260357,Old Salopians II,Old Berkhamstedians,1,2,4.0,3
14260393,Old Aldenhamians II,Old Epsomians,3,1,3.0,4
14273940,Old Brentwoods III,Old Chigwellians III,1,2,4.0,3
14273853,Old Cholmeleians III,Old Amplefordians,2,0,2.0,2
14273825,Old Eastbournians,Old Wykehamists II,2,0,2.0,2
14273809,Old Sennockians,Old Stoics,2,2,5.0,4
14273866,Old Bancroftians AFC,Old Cholmeleians IV,2,0,2.0,2
14273879,Old Oundelians,Old Tonbridgians II,2,0,2.0,2
14736578,Old Alleynians AFC,Old Westminsters II,3,0,2.0,3
14741631,Old Foresters III,Old Millhillians,0,3,2.0,3
14273847,Old Foresters III,Old Bancroftians AFC,5,1,2.0,6
14257687,KCS Old Boys,Old Etonians,0,2,2.0,2
14257714,Old Cholmeleians,Old Foresters,2,1,4.0,3
14257680,Lancing Old Boys,Old Brentwoods,4,3,4.0,7
14275051,Old Aldenhamians,Old Haileyburians,4,2,3.0,6
14275017,Old Malvernians,Old Wykehamists,1,3,3.0,4
14275048,Old Radleians,Old Chigwellians,1,3,3.0,4
14273889,Old Haberdashers,Old Carthusians II,0,1,3.0,1
14273871,Lancing Old Boys II,Old Etonians II,1,0,3.0,1
14273933,Old Carthusians III,Old Cholmeleians II,4,1,2.0,5
14273827,Old King's Scholars,Old Chigwellians II,2,2,5.0,4
14260360,Old Brentwoods II,Old Harrovians II,2,1,4.0,3
14260374,Old Epsomians,Old Aldenhamians II,2,1,4.0,3
14260394,Old Citizens,Old Berkhamstedians,1,3,3.0,4
14273903,Old Amplefordians,Old Brentwoods III,7,0,0.0,7
14273960,Old Wykehamists II,Old Eastbournians,2,3,4.0,5
14273980,Old Bancroftians AFC,Old Harrovians III,1,1,4.0,2
14273984,Old Cholmeleians IV,Old Brentwoods IV,3,1,3.0,4
14273972,Old Foresters III,Old Merchant Taylors,0,0,4.0,0
14273787,Old Millhillians,Old Alleynians AFC,4,6,4.0,10
14717294,Kings College Wimbledon II,Old Millfieldians,1,2,4.0,3
14726603,Old Oundelians,Old Westminsters II,0,5,0.0,5
14726578,Old Sennockians,Old Tonbridgians II,1,1,4.0,2
14381560,"King's College School, Wimbledon 1st XI",KCS Old Boys,4,2,3.0,6
14707258,Old Chigwellians Vets,Old Etonians Vets,0,4,1.0,4
14257689,Old Salopians,Old Brentwoods,1,0,3.0,1
14257659,Old Foresters,Old Harrovians,4,2,3.0,6
14275053,Old Westminsters,Old Marlburians,1,3,3.0,4
14273987,Old Haberdashers,Old Etonians II,3,0,2.0,3
14273966,Old Carthusians III,Old King's Scholars,7,3,2.0,10
14711581,Kings College Wimbledon II,Old Aldenhamians II,1,2,4.0,3
14260341,Old Brentwoods II,Old Citizens,1,0,3.0,1
14260386,Old Epsomians,Old Millfieldians,1,2,4.0,3
14350753,Old Chigwellians III,Old Wykehamists II,1,0,3.0,1
14273921,Old Brentwoods IV,Old Bancroftians AFC,1,3,3.0,4
14674208,Lancing Old Boys,Old Reptonians,4,1,2.0,5
14674209,Old Carthusians,Old Etonians,2,0,2.0,2
14716002,Old Harrovians II,Old Carthusians II,1,3,3.0,4
14716150,Old Alleynians AFC,Old Foresters III,4,1,2.0,5
14716088,Old Oundelians,Old Brentwoods III,4,0,1.0,4
14716141,Old Tonbridgians II,Old Eastbournians,5,0,0.0,5
14645938,Bradfield College,Old Bradfieldians,1,4,2.0,5
14287800,Stowe School,Old Stoics,9,0,0.0,9
14689085,Forest School 1st XI,Old Foresters II,3,0,2.0,3
14257685,Lancing Old Boys,Old Foresters,3,2,4.0,5
14257715,Old Carthusians,Old Salopians,7,0,0.0,7
14257701,Old Etonians,Old Harrovians,1,1,4.0,2
14257642,Old Brentwoods,Old Cholmeleians,1,1,4.0,2
14275074,Old Chigwellians,Old Wykehamists,3,1,3.0,4
14275012,Old Malvernians,Old Reptonians,3,3,5.0,6
14273857,Old Cholmeleians II,Old Haberdashers,0,5,0.0,5
14273802,Old King's Scholars,Old Etonians II,0,2,2.0,2
14273830,Old Foresters II,Lancing Old Boys II,2,1,4.0,3
14260365,Old Brentwoods II,Old Berkhamstedians,2,2,5.0,4
14260396,Old Millfieldians,Old Salopians II,4,0,1.0,4
14273925,Old Amplefordians,Old Stoics,1,3,3.0,4
14273881,Old Brentwoods IV,Old Cholmeleians IV,5,3,4.0,8
14695973,Kings College Wimbledon II,Old Chigwellians II,1,0,3.0,1
14703095,Old Carthusians III,Old Carthusians II,0,1,3.0,1
14686766,Old Cholmeleians III,Old Oundelians,0,5,0.0,5
14698225,Old Alleynians AFC,Old Merchant Taylors,4,2,3.0,6
14706362,Old Eastbournians,Old Chigwellians III,2,1,4.0,3
14706963,Old Sennockians,Old Harrovians III,4,0,1.0,4
14706357,Old Tonbridgians II,Old Bancroftians AFC,1,0,3.0,1
14608917,Eton College 1st XI,Old Etonians,1,2,4.0,3
14698264,Westminster School 1st XI,Old Westminsters,1,2,4.0,3
14698263,Westminster School 2nd XI,Old Westminsters II,2,2,5.0,4
14258399,Radley College 1st XI,Old Radleians,1,3,3.0,4
14602926,Old Brentwoods Vets,Old Carthusians Vets,1,0,3.0,1
14613238,Old Chigwellians Vets,Old Cholmeleians Vets,4,0,1.0,4
14650650,Old Westminsters Vets,Old Tonbridgians Vets,10,0,0.0,10
14257658,Old Etonians,Old Brentwoods,1,3,3.0,4
14257668,Old Harrovians,KCS Old Boys,0,1,3.0,1
14257682,Old Carthusians,Old Cholmeleians,1,0,3.0,1
14257716,Old Foresters,Old Tonbridgians,5,0,0.0,5
14274992,Old Chigwellians,Old Aldenhamians,6,2,2.0,8
14275030,Old Wykehamists,Old Westminsters,1,1,4.0,2
14275019,Old Marlburians,Old Malvernians,2,2,5.0,4
14273942,Old Cholmeleians II,Old Chigwellians II,5,3,4.0,8
14273817,Lancing Old Boys II,Old Carthusians II,0,0,4.0,0
14273935,Old Foresters II,Old Wellingtonians,1,3,3.0,4
14260362,Old Salopians II,Kings College Wimbledon II,3,1,3.0,4
14695896,Old Berkhamstedians,Old Harrovians II,2,3,4.0,5
14698224,Old Harrovians III,Old Rugbeians,4,2,3.0,6
14686549,Old Merchant Taylors II,Old Chigwellians III,2,6,2.0,8
14686561,Old Millhillians,Old Bancroftians AFC,0,2,2.0,2
14698226,Old Sennockians,Old Stoics,2,0,2.0,2
14686768,Old Tonbridgians II,Old Cholmeleians IV,4,2,3.0,6
14698223,Old Westminsters II,Old Amplefordians,2,0,2.0,2
14702283,Old Millfieldians,Old Reptonians,0,3,2.0,3
14697855,Haberdashers Aske School 1st XI,Old Haberdashers,0,0,4.0,0
14687853,Lancing College 1st XI,Lancing Old Boys,1,4,2.0,5
14429877,Oundle School 1st XI,Old Oundelians,0,2,2.0,2
14626511,Old Foresters Vets,Old Etonians Vets,0,4,1.0,4
14626512,Old Malvernians Vets,Old Bradfieldians Vets,2,1,4.0,3
14257662,Old Carthusians,Old Etonians,1,1,4.0,2
14257676,Old Tonbridgians,KCS Old Boys,2,5,2.0,7
14275058,Old Bradfieldians,Old Westminsters,3,1,3.0,4
14275031,Old Chigwellians,Old Marlburians,3,3,5.0,6
14274991,Old Haileyburians,Old Aldenhamians,1,3,3.0,4
14275044,Old Radleians,Old Wykehamists,3,1,3.0,4
14273867,Old Cholmeleians II,Old Carthusians II,0,2,2.0,2
14260399,Old Millfieldians,Old Aldenhamians II,12,1,1.0,13
14273958,Old Merchant Taylors,Old Bancroftians AFC,1,2,4.0,3
14273785,Old Millhillians,Old Oundelians,2,1,4.0,3
14273862,Old Oundelians,Old Millhillians,1,2,4.0,3
14652958,Old Chigwellians II,Lancing Old Boys II,1,0,3.0,1
14653091,Old Berkhamstedians,Old Etonians II,2,0,2.0,2
14653032,Old King's Scholars,Old Wellingtonians,2,0,2.0,2
14686547,Old Rugbeians,Old Ardinians,3,3,5.0,6
14686548,Old Stoics,Old Uppinghamians,5,1,2.0,6
14637087,Old Foresters,Polytechnic,1,3,3.0,4
14664241,Dulwich College 1st XI,Old Alleynians AFC,3,2,4.0,5
14257684,Old Tonbridgians,Lancing Old Boys,2,2,5.0,4
14257690,KCS Old Boys,Old Salopians,3,5,4.0,8
14275016,Old Bradfieldians,Old Radleians,2,2,5.0,4
14275070,Old Wykehamists,Old Aldenhamians,1,3,3.0,4
14275056,Old Marlburians,Old Haileyburians,11,0,0.0,11
14273797,Old Carthusians II,Old Haberdashers,8,0,0.0,8
14273975,Old Cholmeleians II,Old Wellingtonians,2,3,4.0,5
14273906,Old Etonians II,Old King's Scholars,1,0,3.0,1
14260378,Old Berkhamstedians,Old Citizens,5,0,0.0,5
14260402,Old Brentwoods II,Old Epsomians,1,1,4.0,2
14273858,Old Eastbournians,Old Brentwoods III,1,0,3.0,1
14273954,Old Westminsters II,Old Millhillians,0,3,2.0,3
14273804,Old Oundelians,Old Tonbridgians II,2,2,5.0,4
14666936,Old Carthusians III,Old Bancroftians AFC,5,0,0.0,5
14653066,Old Millfieldians,Old Foresters II,4,3,4.0,7
14653476,Old Stoics,Kings College Wimbledon II,1,2,4.0,3
14605326,Old Etonians,Queen Mary College Old Boys,0,2,2.0,2
14120751,Arthurian League Representative Team,AFC Representative Team,2,0,2.0,2
14257660,Old Salopians,Old Cholmeleians,1,1,4.0,2
14274993,Old Haileyburians,Old Malvernians,5,1,2.0,6
14275013,Old Wykehamists,Old Chigwellians,0,1,3.0,1
14275037,Old Aldenhamians,Old Bradfieldians,1,1,4.0,2
14275038,Old Radleians,Old Reptonians,2,4,3.0,6
14273812,Old Chigwellians II,Old Carthusians II,0,0,4.0,0
14273842,Old Wellingtonians,Old Carthusians III,2,3,4.0,5
14260384,Old Berkhamstedians,Old Salopians II,5,1,2.0,6
14260347,Old Harrovians II,Old Millfieldians,1,8,0.0,9
14260379,Old Brentwoods II,Old Malvernians II,5,0,0.0,5
14273856,Old Chigwellians III,Old Sennockians,1,0,3.0,1
14273892,Old Stoics,Old Cholmeleians III,0,3,2.0,3
14273912,Old Merchant Taylors,Old Cholmeleians IV,2,2,5.0,4
14273789,Old Tonbridgians II,Old Alleynians AFC,2,1,4.0,3
14574049,KCS Old Boys,Old Etonians,1,4,2.0,5
14629207,Old Brentwoods III,Old Bancroftians AFC,0,3,2.0,3
14602665,Old Chigwellians III,Old Sennockians,1,0,3.0,1
14257678,Old Foresters,Old Brentwoods,5,2,2.0,7
14257695,Old Salopians,Old Etonians,1,2,4.0,3
14257686,Old Tonbridgians,Old Cholmeleians,2,1,4.0,3
14275052,Old Bradfieldians,Old Reptonians,3,4,4.0,7
14275067,Old Wykehamists,Old Radleians,2,4,3.0,6
14275050,Old Aldenhamians,Old Marlburians,0,3,2.0,3
14273822,Old Etonians II,Old Carthusians III,0,2,2.0,2
14260367,Old Millfieldians,Old Citizens,2,1,4.0,3
14260391,Old Salopians II,Old Brentwoods II,2,5,2.0,7
14273920,Old Alleynians AFC,Old Oundelians,5,1,2.0,6
14605265,Old Harrovians,Lancing Old Boys,1,4,2.0,5
14574048,Old Haileyburians,Old Carthusians,1,5,2.0,6
14602666,Old Epsomians,Old Chigwellians II,5,7,4.0,12
14602661,Kings College Wimbledon II,Old Cholmeleians II,5,1,2.0,6
14602663,Old Aldenhamians II,Old Stoics,1,1,4.0,2
14627488,Old Ardinians,Old Foresters II,2,7,0.0,9
14602664,Old Berkhamstedians,Old Haberdashers,3,0,2.0,3
14642166,Old Carthusians II,Old Millhillians,3,2,4.0,5
14605256,Old Merchant Taylors,Old Harrovians II,1,6,0.0,7
14602574,Old Eastbournians,Old Wellingtonians,1,2,4.0,3
14543651,Old Malvernians,Fulham Compton Old Boys,0,5,0.0,5
14257708,Old Cholmeleians,Old Etonians,1,1,4.0,2
14257691,Lancing Old Boys,Old Harrovians,1,0,3.0,1
14257669,Old Salopians,Old Foresters,1,1,4.0,2
14257710,Old Tonbridgians,Old Brentwoods,5,0,0.0,5
14275060,Old Malvernians,Old Aldenhamians,7,2,0.0,9
14274988,Old Radleians,Old Marlburians,3,3,5.0,6
14273981,Old Carthusians II,Old Foresters II,2,0,2.0,2
14260397,Kings College Wimbledon II,Old Harrovians II,2,1,4.0,3
14260403,Old Citizens,Old Millfieldians,0,2,2.0,2
14273900,Old Oundelians,Old Westminsters II,3,4,4.0,7
14574047,Old Reptonians,Old Westminsters,2,1,4.0,3
14605386,Lancing Old Boys II,Old Tonbridgians II,6,0,0.0,6
14602613,Old Wykehamists II,Old Malvernians II,3,0,2.0,3
14629383,Old Alleynians AFC,Old Millhillians,2,3,4.0,5
14602662,Old King's Scholars,Old Brentwoods II,2,2,5.0,4
14602573,Old Etonians II,Old Salopians II,6,1,0.0,7
14618607,UCL Academicals IV,Old Bancroftians AFC,2,0,2.0,2
14257700,Old Brentwoods,Old Carthusians,0,2,2.0,2
14257666,Old Etonians,Lancing Old Boys,1,2,4.0,3
14257697,Old Harrovians,Old Cholmeleians,2,1,4.0,3
14275073,Old Aldenhamians,Old Radleians,4,1,2.0,5
14275069,Old Reptonians,Old Marlburians,2,7,0.0,9
14275046,Old Haileyburians,Old Chigwellians,2,4,3.0,6
14273807,Old Chigwellians II,Old Carthusians III,0,1,3.0,1
14273908,Old Haberdashers,Old Cholmeleians II,4,4,6.0,8
14273901,Old Wellingtonians,Old Etonians II,1,0,3.0,1
14273855,Old Carthusians II,Lancing Old Boys II,2,1,4.0,3
14260351,Old Brentwoods II,Old Salopians II,0,0,4.0,0
14260364,Old Harrovians II,Old Aldenhamians II,2,0,2.0,2
14260390,Old Malvernians II,Old Millfieldians,1,5,2.0,6
14260363,Kings College Wimbledon II,Old Epsomians,2,1,4.0,3
14273971,Old Chigwellians III,Old Amplefordians,4,2,3.0,6
14273885,Old Sennockians,Old Cholmeleians III,5,2,2.0,7
14273917,Old Stoics,Old Eastbournians,3,4,4.0,7
14273955,Old Alleynians AFC,Old Westminsters II,3,0,2.0,3
14514931,Old Brentwoods IV,Old Millhillians,0,3,2.0,3
14514933,Old Cholmeleians IV,Old Bancroftians AFC,1,6,0.0,7
14591082,NUFC Oilers,Old Foresters,0,1,3.0,1
14257655,Lancing Old Boys,Old Salopians,3,0,2.0,3
14257694,Old Carthusians,Old Harrovians,10,1,0.0,11
14257657,Old Cholmeleians,KCS Old Boys,1,3,3.0,4
14275014,Old Aldenhamians,Old Chigwellians,0,2,2.0,2
14275047,Old Bradfieldians,Old Haileyburians,3,3,5.0,6
14275049,Old Westminsters,Old Reptonians,1,3,3.0,4
14275009,Old Malvernians,Old Radleians,4,1,2.0,5
14274987,Old Marlburians,Old Wykehamists,6,0,0.0,6
14273902,Lancing Old Boys II,Old Wellingtonians,1,1,4.0,2
14273964,Old King's Scholars,Old Cholmeleians II,0,0,4.0,0
14273792,Old Haberdashers,Old Chigwellians II,2,0,2.0,2
14260392,Kings College Wimbledon II,Old Malvernians II,3,1,3.0,4
14260358,Old Aldenhamians II,Old Citizens,1,5,2.0,6
14273806,Old Wykehamists II,Old Amplefordians,4,3,4.0,7
14273848,Old Sennockians,Old Eastbournians,3,1,3.0,4
14273916,Old Harrovians III,Old Merchant Taylors,3,2,4.0,5
14273814,Old Millhillians,Old Tonbridgians II,3,2,4.0,5
14514934,Old Oundelians,Old Kimboltonians,8,2,0.0,10
14478336,Old Carthusians II,Old Meadonians,1,2,4.0,3
14519502,Hale End Athletic,Old Carthusians III,2,2,5.0,4
14450871,Old Bancroftians AFC,Bealonians,5,0,0.0,5
14556294,Epsom College 1st XI,Old Epsomians,1,3,3.0,4
14475807,Old Tonbridgians Vets,Old Salopians Vets,0,3,2.0,3
14603100,Old Tonbridgians Vets,Old Salopians Vets,3,0,2.0,3
14257683,Old Salopians,Old Harrovians,3,2,4.0,5
14257653,Old Carthusians,KCS Old Boys,4,1,2.0,5
14257638,Old Cholmeleians,Old Tonbridgians,1,1,4.0,2
14275066,Old Malvernians,Old Haileyburians,1,1,4.0,2
14275000,Old Radleians,Old Bradfieldians,3,4,4.0,7
14275001,Old Marlburians,Old Aldenhamians,7,3,2.0,10
14273826,Old Etonians II,Old Cholmeleians II,3,2,4.0,5
14273956,Old Foresters II,Old King's Scholars,3,3,5.0,6
14273829,Old Wellingtonians,Old Haberdashers,2,1,4.0,3
14260359,Old Berkhamstedians,Old Epsomians,0,1,3.0,1
14260375,Old Harrovians II,Old Salopians II,1,2,4.0,3
14260353,Kings College Wimbledon II,Old Millfieldians,0,4,1.0,4
14273979,Old Wykehamists II,Old Cholmeleians III,2,2,5.0,4
14273893,Old Westminsters II,Old Millhillians,1,5,2.0,6
14436867,Old Wykehamists,Lancing Old Boys,0,9,0.0,9
14588601,Old Tonbridgians II,Old Rugbeians,1,0,3.0,1
14588600,Old Merchant Taylors,Old Foresters III,7,1,0.0,8
14593075,Old Carthusians III,Winchmore Hill,2,3,4.0,5
14573796,Old Foresters,Old Salesians,0,2,2.0,2
14510500,Lea Valley,Old Etonians,1,5,2.0,6
14510387,Brentwood School 1st XI,Old Brentwoods,2,1,4.0,3
14510386,Brentwood School 2nd XI,Old Brentwoods II,1,1,4.0,2
14510385,Brentwood School 3rd XI,Old Brentwoods III,2,1,4.0,3
14510384,Brentwood School 4th XI,Old Brentwoods IV,1,6,0.0,7
14257643,KCS Old Boys,Lancing Old Boys,1,3,3.0,4
14257727,Old Tonbridgians,Old Carthusians,1,6,0.0,7
14257663,Old Cholmeleians,Old Brentwoods,3,2,4.0,5
14275033,Old Aldenhamians,Old Westminsters,3,10,1.0,13
14260395,Old Harrovians II,Old Brentwoods II,4,0,1.0,4
14260377,Old Aldenhamians II,Kings College Wimbledon II,1,1,4.0,2
14273924,Old Wykehamists II,Old Brentwoods III,11,1,0.0,12
14514935,Old Merchant Taylors II,Old Ardinians,2,4,3.0,6
14478335,Fulham Compton Old Boys,Old Carthusians III,2,4,3.0,6
14257665,Old Brentwoods,Old Harrovians,8,2,0.0,10
14436856,Old Berkhamstedians,Old Westminsters,3,5,4.0,8
14436947,Old Bradfieldians,Old Etonians,1,2,4.0,3
14437388,Old Haileyburians,Old Aldenhamians,3,2,4.0,5
14303814,Old Westminsters Vets,Old Carthusians Vets,0,3,2.0,3
14257713,Old Harrovians,Old Salopians,0,1,3.0,1
14257664,KCS Old Boys,Old Foresters,3,4,4.0,7
14275061,Old Chigwellians,Old Bradfieldians,5,2,2.0,7
14275021,Old Westminsters,Old Haileyburians,0,2,2.0,2
14275011,Old Radleians,Old Aldenhamians,7,0,0.0,7
14273962,Old Chigwellians II,Old Wellingtonians,2,4,3.0,6
14273850,Lancing Old Boys II,Old King's Scholars,1,2,4.0,3
14260373,Old Citizens,Old Brentwoods II,3,2,4.0,5
14260376,Old Malvernians II,Kings College Wimbledon II,2,3,4.0,5
14260406,Old Salopians II,Old Aldenhamians II,4,0,1.0,4
14273952,Old Sennockians,Old Amplefordians,6,1,0.0,7
14437001,Old Carthusians,Old Brentwoods,7,1,0.0,8
14514932,Old Foresters III,Old Westminsters II,3,3,5.0,6
14514930,Old Harrovians III,Old Tonbridgians II,3,4,4.0,7
14519334,Old Malvernians,Old Strand Academicals,2,1,4.0,3
14376329,Old Suttonians,Old Cholmeleians,8,0,0.0,8
14303812,Old Reptonians Vets,Lancing Old Boys Vets,2,8,0.0,10
14397403,Old Brentwoods Vets,Old Harrovians Vets,7,3,2.0,10
14257704,Old Etonians,Old Carthusians,1,1,4.0,2
14257652,Lancing Old Boys,Old Tonbridgians,2,5,2.0,7
14275027,Old Westminsters,Old Radleians,3,5,4.0,8
14273840,Old Chigwellians II,Old Haberdashers,3,3,5.0,6
14273876,Old Carthusians III,Lancing Old Boys II,3,2,4.0,5
14273859,Old Etonians II,Old Foresters II,2,0,2.0,2
14273845,Old Carthusians II,Old Wellingtonians,1,0,3.0,1
14260369,Old Citizens,Old Salopians II,1,2,4.0,3
14260370,Old Epsomians,Old Malvernians II,7,5,4.0,12
14260371,Old Harrovians II,Old Berkhamstedians,3,8,0.0,11
14260382,Kings College Wimbledon II,Old Brentwoods II,2,0,2.0,2
14350727,Old Amplefordians,Old Eastbournians,0,1,3.0,1
14273968,Old Wykehamists II,Old Sennockians,0,5,0.0,5
14273953,Old Stoics,Old Chigwellians III,1,0,3.0,1
14273880,Old Alleynians AFC,Old Westminsters II,5,3,4.0,8
14273936,Old Tonbridgians II,Old Millhillians,0,3,2.0,3
14436950,Old Reptonians,Old Marlburians,2,0,2.0,2
14437576,Old Harrovians,Old Chigwellians,2,1,4.0,3
14436868,Old King's Scholars,KCS Old Boys,1,7,0.0,8
14492036,Old Buckwellians,Old Bancroftians AFC,5,0,0.0,5
14345986,Old Cholmeleians II,Old Hamptonians,1,2,4.0,3
14455567,Old Foresters,Latymer Old Boys,4,1,2.0,5
14455566,UCL Academicals,Old Brentwoods,3,0,2.0,3
14412570,Old Brentwoods III,Old Wilsonians,1,5,2.0,6
14342559,Royal Navy Development XI,Arthurian League Representative Team,2,3,4.0,5
14303809,Old Chigwellians Vets,Old Wykehamists Vets,1,0,3.0,1
14257711,KCS Old Boys,Old Brentwoods,1,0,3.0,1
14257679,Old Salopians,Old Carthusians,1,2,4.0,3
14257720,Old Tonbridgians,Old Harrovians,1,0,3.0,1
14275064,Old Westminsters,Old Wykehamists,2,2,5.0,4
14275029,Old Chigwellians,Old Reptonians,3,2,4.0,5
14273823,Old Carthusians III,Old Foresters II,3,3,5.0,6
14273904,Old Carthusians II,Old Chigwellians II,4,0,1.0,4
14273813,Old Etonians II,Old Haberdashers,2,2,5.0,4
14260385,Old Citizens,Old Harrovians II,6,1,0.0,7
14260330,Old Millfieldians,Old Epsomians,3,2,4.0,5
14260366,Old Malvernians II,Old Salopians II,2,3,4.0,5
14273877,Old Chigwellians III,Old Eastbournians,1,3,3.0,4
14273986,Old Stoics,Old Brentwoods III,2,3,4.0,5
14273949,Old Cholmeleians IV,Old Foresters III,1,3,3.0,4
14345978,Old Aldenhamians,Winchmore Hill,0,3,2.0,3
14460046,Old Cholmeleians,Polytechnic,1,3,3.0,4
14460045,Old Foresters,Norsemen,6,1,0.0,7
14257674,Lancing Old Boys,Old Cholmeleians,1,2,4.0,3
14257707,Old Carthusians,Old Foresters,3,1,3.0,4
14257647,Old Harrovians,Old Brentwoods,5,1,2.0,6
14275022,Old Malvernians,Old Bradfieldians,3,2,4.0,5
14275043,Old Marlburians,Old Reptonians,1,4,2.0,5
14275071,Old Haileyburians,Old Radleians,7,2,0.0,9
14273838,Old Wellingtonians,Lancing Old Boys II,3,2,4.0,5
14273910,Old Foresters II,Old Cholmeleians II,3,2,4.0,5
14260383,Old Aldenhamians II,Old Malvernians II,2,1,4.0,3
14260327,Kings College Wimbledon II,Old Salopians II,1,4,2.0,5
14260389,Old Harrovians II,Old Epsomians,5,4,5.0,9
14273897,Old Eastbournians,Old Cholmeleians III,2,2,5.0,4
14273849,Old Wykehamists II,Old Chigwellians III,0,0,4.0,0
14273865,Old Amplefordians,Old Sennockians,1,4,2.0,5
14273888,Old Bancroftians AFC,Old Merchant Taylors,4,2,3.0,6
14273957,Old Harrovians III,Old Foresters III,2,3,4.0,5
14431045,Fulham Compton Old Boys,Old Carthusians II,1,0,3.0,1
14431029,Old Aldenhamians,Nottsborough FC,2,3,4.0,5
14005866,Old Pauline,Old Etonians,0,5,0.0,5
14303787,Old Aldenhamians Vets,Old Salopians Vets,2,4,3.0,6
14257702,Old Foresters,Lancing Old Boys,3,1,3.0,4
14257709,Old Salopians,KCS Old Boys,0,2,2.0,2
14275065,Old Bradfieldians,Old Aldenhamians,2,5,2.0,7
14275010,Old Marlburians,Old Westminsters,4,0,1.0,4
14275036,Old Reptonians,Old Malvernians,4,3,4.0,7
14273974,Lancing Old Boys II,Old Foresters II,2,1,4.0,3
14273918,Old Wellingtonians,Old King's Scholars,2,0,2.0,2
14260354,Old Aldenhamians II,Old Brentwoods II,0,3,2.0,3
14260356,Old Malvernians II,Old Citizens,0,2,2.0,2
14273841,Old Cholmeleians IV,Old Bancroftians AFC,2,6,2.0,8
14273869,Old Foresters III,Old Brentwoods IV,2,2,5.0,4
14273816,Old Westminsters II,Old Oundelians,6,7,5.0,13
14402428,Old Carthusians III,Nottsborough FC,3,1,3.0,4
14005852,Egbertian FC,Old Cholmeleians II,4,1,2.0,5
14005851,Old Carthusians II,Old Isleworthians II,7,3,2.0,10
14397012,Old Brentwoods,Old Aloysians,2,3,4.0,5
14287990,Harrow School 1st XI,Old Harrovians,1,6,0.0,7
14287989,Harrow School 2nd XI,Old Harrovians II,0,1,3.0,1
14376587,Eton College 1st XI,Old Etonians,2,1,4.0,3
14376589,Eton College 2nd XI,Old Etonians II,7,3,2.0,10
14294342,Eton College 3rd XI,Old Etonians Vets,5,3,4.0,8
14257699,KCS Old Boys,Old Tonbridgians,3,2,4.0,5
14257726,Old Harrovians,Old Etonians,0,0,4.0,0
14275045,Old Aldenhamians,Old Wykehamists,2,4,3.0,6
14275007,Old Bradfieldians,Old Marlburians,0,3,2.0,3
14275008,Old Haileyburians,Old Reptonians,3,2,4.0,5
14273913,Old Wellingtonians,Old Chigwellians II,1,1,4.0,2
14273973,Old Haberdashers,Lancing Old Boys II,0,0,4.0,0
14273836,Old King's Scholars,Old Foresters II,4,4,6.0,8
14273852,Old Cholmeleians II,Old Etonians II,2,0,2.0,2
14273834,Old Carthusians III,Old Carthusians II,1,1,4.0,2
14260349,Old Aldenhamians II,Old Millfieldians,0,3,2.0,3
14260350,Old Berkhamstedians,Old Harrovians II,3,1,3.0,4
14260352,Old Epsomians,Old Citizens,1,0,3.0,1
14273820,Old Chigwellians III,Old Cholmeleians III,2,2,5.0,4
14273909,Old Eastbournians,Old Sennockians,1,2,4.0,3
14273978,Old Stoics,Old Amplefordians,2,3,4.0,5
14273818,Old Bancroftians AFC,Old Brentwoods IV,0,2,2.0,2
14273989,Old Harrovians III,Old Cholmeleians IV,3,4,4.0,7
14273832,Old Alleynians AFC,Old Millhillians,4,2,3.0,6
14376470,Lancing Old Boys,Richmond & Kew SAL,0,2,2.0,2
14376233,Mayfield,Old Brentwoods,3,6,3.0,9
14376283,Norsemen,Old Foresters,1,7,0.0,8
14146096,Old Finchleians,Old Chigwellians,3,2,4.0,5
14376232,Old Wilsonians,Old Cholmeleians,3,1,3.0,4
14146092,Old Salopians,NUFC Oilers,0,2,2.0,2
14275063,Old Haileyburians,Old Bradfieldians,0,1,3.0,1
14275006,Old Wykehamists,Old Reptonians,1,4,2.0,5
14273982,Old Chigwellians II,Old Cholmeleians II,2,4,3.0,6
14273882,Old Etonians II,Old Carthusians II,0,1,3.0,1
14273868,Old Foresters II,Old Carthusians III,1,2,4.0,3
14260345,Old Aldenhamians II,Old Salopians II,0,2,2.0,2
14260405,Old Millfieldians,Old Brentwoods II,4,0,1.0,4
14260404,Old Harrovians II,Old Malvernians II,5,0,0.0,5
14260346,Old Citizens,Kings College Wimbledon II,5,3,4.0,8
14273831,Old Wykehamists II,Old Stoics,5,2,2.0,7
14273839,Old Amplefordians,Old Chigwellians III,1,1,4.0,2
14273911,Old Foresters III,Old Harrovians III,3,5,4.0,8
14273828,Old Tonbridgians II,Old Alleynians AFC,3,3,5.0,6
13920072,Old Berkhamstedians,Old Bancroftians AFC,5,1,2.0,6
13920079,Old Carthusians,Old Salopians,3,2,4.0,5
13920070,Old Epsomians,Old King's Scholars,3,4,4.0,7
13920071,Old Tonbridgians,Old Aldenhamians,1,2,4.0,3
13920076,Old Marlburians,Old Malvernians,4,2,3.0,6
13920074,Old Radleians,Old Etonians,0,6,0.0,6
13920073,Old Wellingtonians,Old Chigwellians,1,3,3.0,4
13920078,KCS Old Boys,Old Eastbournians,7,1,0.0,8
13920082,Old Sennockians,Lancing Old Boys,1,6,0.0,7
14146015,Enfield Old Grammarians,Old Foresters,1,2,4.0,3
14303813,Old Kimboltonians Vets,Old Etonians Vets,1,6,0.0,7
14257650,Lancing Old Boys,Old Carthusians,1,1,4.0,2
14257651,Old Brentwoods,Old Etonians,1,1,4.0,2
14257698,Old Salopians,Old Tonbridgians,0,4,1.0,4
14257703,KCS Old Boys,Old Harrovians,1,3,3.0,4
14275004,Old Haileyburians,Old Westminsters,2,1,4.0,3
14275005,Old Reptonians,Old Radleians,4,1,2.0,5
14275042,Old Malvernians,Old Chigwellians,0,4,1.0,4
14273944,Old Etonians II,Old Wellingtonians,5,0,0.0,5
14273890,Old King's Scholars,Lancing Old Boys II,2,3,4.0,5
14273950,Old Haberdashers,Old Foresters II,1,2,4.0,3
14273947,Old Carthusians III,Old Chigwellians II,6,1,0.0,7
14260344,Old Salopians II,Old Millfieldians,0,4,1.0,4
14260340,Old Berkhamstedians,Old Malvernians II,5,2,2.0,7
14260343,Old Aldenhamians II,Old Harrovians II,0,3,2.0,3
14260342,Old Epsomians,Kings College Wimbledon II,3,3,5.0,6
14273905,Old Chigwellians III,Old Stoics,1,1,4.0,2
14292573,Old Brentwoods III,Old Amplefordians,1,0,3.0,1
14273824,Old Cholmeleians III,Old Sennockians,4,3,4.0,7
14273907,Old Foresters III,Old Cholmeleians IV,1,0,3.0,1
14273988,Old Brentwoods IV,Old Merchant Taylors,2,4,3.0,6
14273886,Old Tonbridgians II,Old Millhillians,1,7,0.0,8
14273843,Old Alleynians AFC,Old Oundelians,2,3,4.0,5
13920077,Old Foresters,Old Wykehamists,1,2,4.0,3
13920080,Old Kimboltonians,Old Bradfieldians,1,3,3.0,4
14362006,Old Aldenhamians,Southgate County,5,0,0.0,5
14350697,Old Carthusians II,Old Garchonians,1,0,3.0,1
14350698,Old Sedcopians,Old Cholmeleians II,2,1,4.0,3
14350690,Old Cholmeleians,Hale End Athletic,3,0,2.0,3
14371093,Mayfield,Old Eastbournians,2,1,4.0,3
14371099,Old Bancroftians AFC,UCL Academicals V,1,0,3.0,1
14303788,Old Brentwoods Vets,Old Malvernians Vets,1,0,3.0,1
14257656,Old Carthusians,Old Tonbridgians,4,0,1.0,4
14257705,Old Foresters,Old Etonians,2,0,2.0,2
14257649,Old Salopians,Lancing Old Boys,1,4,2.0,5
14257648,Old Brentwoods,KCS Old Boys,3,2,4.0,5
14275068,Old Bradfieldians,Old Malvernians,4,4,6.0,8
14275034,Old Chigwellians,Old Haileyburians,2,1,4.0,3
14275035,Old Marlburians,Old Radleians,0,1,3.0,1
14273928,Old Etonians II,Old Chigwellians II,3,1,3.0,4
14273946,Lancing Old Boys II,Old Cholmeleians II,4,4,6.0,8
14273884,Old Haberdashers,Old Wellingtonians,2,5,2.0,7
14273854,Old Foresters II,Old Carthusians II,1,0,3.0,1
14260388,Old Citizens,Old Aldenhamians II,2,3,4.0,5
14260337,Old Epsomians,Old Salopians II,2,1,4.0,3
14260339,Old Millfieldians,Old Berkhamstedians,1,2,4.0,3
14273819,Old Brentwoods III,Old Stoics,1,3,3.0,4
14273983,Old Cholmeleians III,Old Eastbournians,6,7,5.0,13
14273891,Old Sennockians,Old Chigwellians III,5,1,2.0,6
14273821,Old Cholmeleians IV,Old Harrovians III,2,2,5.0,4
14273878,Old Merchant Taylors,Old Foresters III,3,3,5.0,6
14273919,Old Westminsters II,Old Alleynians AFC,3,6,3.0,9
14273930,Old Tonbridgians II,Old Oundelians,1,4,2.0,5
13920081,Old Harrovians,Old Cholmeleians,3,2,4.0,5
14361524,Old Carthusians III,Old Actonians Association FC,4,1,2.0,5
14361514,Old Salesians,Kings College Wimbledon II,2,1,4.0,3
14005856,Old Isleworthians,Old Westminsters,1,4,2.0,5
14005854,Sinjun Grammarians,Old Reptonians,4,3,4.0,7
14005789,Old Brentwoods II,Old Meadonians,3,5,4.0,8
13919337,Ampleforth College 1st XI,Old Amplefordians,2,4,3.0,6
13919264,Winchester College 1st XI,Old Wykehamists,0,8,0.0,8
13919263,Winchester College 2nd XI,Old Wykehamists II,1,5,2.0,6
14328610,Oxford University Football Club,Arthurian League Representative Team,3,2,4.0,5
14257717,Old Brentwoods,Old Foresters,0,2,2.0,2
14257671,Old Cholmeleians,Old Salopians,2,1,4.0,3
14257646,Old Etonians,KCS Old Boys,2,6,2.0,8
14257706,Old Harrovians,Old Tonbridgians,3,5,4.0,8
14275026,Old Bradfieldians,Old Wykehamists,1,2,4.0,3
14274999,Old Marlburians,Old Chigwellians,3,0,2.0,3
14275075,Old Reptonians,Old Westminsters,2,1,4.0,3
14275062,Old Radleians,Old Haileyburians,3,4,4.0,7
14273970,Old Chigwellians II,Old Foresters II,2,1,4.0,3
14273873,Old Cholmeleians II,Old Carthusians III,3,1,3.0,4
14273870,Old Haberdashers,Old King's Scholars,2,5,2.0,7
14273985,Old Etonians II,Lancing Old Boys II,1,2,4.0,3
14273805,Old Wellingtonians,Old Carthusians II,1,2,4.0,3
14260401,Old Berkhamstedians,Old Aldenhamians II,5,0,0.0,5
14260332,Old Citizens,Old Malvernians II,1,2,4.0,3
14260334,Old Millfieldians,Kings College Wimbledon II,3,1,3.0,4
14260335,Old Salopians II,Old Harrovians II,1,1,4.0,2
14273811,Old Brentwoods III,Old Cholmeleians III,1,5,2.0,6
14273923,Old Eastbournians,Old Chigwellians III,3,1,3.0,4
14273945,Old Stoics,Old Wykehamists II,4,3,4.0,7
14065937,Lancing Old Boys,Old Dorkinians,3,2,4.0,5
14065938,Old Carthusians,Old Wilsonians,2,2,5.0,4
14290476,Old Millhillians,Old Cholmeleians IV,3,4,4.0,7
14290479,Old Oundelians,Old Harrovians III,3,2,4.0,5
14290478,Old Westminsters II,Old Brentwoods IV,5,1,2.0,6
14290477,Old Tonbridgians II,Old Bancroftians AFC,2,2,5.0,4
14290475,Old Alleynians AFC,Old Foresters III,8,0,0.0,8
14005855,Old Tiffinians,Old Malvernians,2,5,2.0,7
14005853,Wandsworth Borough,Old Aldenhamians,4,0,1.0,4
14257721,Old Foresters,Old Salopians,6,0,0.0,6
14257645,Old Tonbridgians,Old Etonians,2,1,4.0,3
14257644,Old Carthusians,Old Brentwoods,0,2,2.0,2
14257722,Old Harrovians,Lancing Old Boys,1,6,0.0,7
14257692,KCS Old Boys,Old Cholmeleians,2,0,2.0,2
14275072,Old Malvernians,Old Westminsters,2,1,4.0,3
14274998,Old Reptonians,Old Wykehamists,5,6,5.0,11
14274997,Old Haileyburians,Old Marlburians,2,4,3.0,6
14273937,Old Carthusians II,Old Etonians II,1,2,4.0,3
14273808,Old Cholmeleians II,Old King's Scholars,1,1,4.0,2
14273914,Lancing Old Boys II,Old Carthusians III,2,2,5.0,4
14273875,Old Wellingtonians,Old Foresters II,0,0,4.0,0
14260328,Old Berkhamstedians,Old Brentwoods II,4,1,2.0,5
14260361,Old Millfieldians,Old Malvernians II,3,3,5.0,6
14260381,Old Salopians II,Old Epsomians,1,1,4.0,2
14273963,Old Cholmeleians III,Old Stoics,0,1,3.0,1
14273887,Old Amplefordians,Old Wykehamists II,3,2,4.0,5
14273959,Old Sennockians,Old Brentwoods III,3,0,2.0,3
14273844,Old Brentwoods IV,Old Harrovians III,4,2,3.0,6
14273872,Old Alleynians AFC,Old Tonbridgians II,5,0,0.0,5
14005988,Old Aldenhamians II,Old Crosbeians,3,0,2.0,3
14025745,Egbertian FC,Old Bancroftians AFC,2,3,4.0,5
14005872,Old Eastbournians,Fulham Compton Old Boys,4,3,4.0,7
14257654,Old Tonbridgians,Old Foresters,1,1,4.0,2
14257718,Old Cholmeleians,Old Carthusians,1,3,3.0,4
14257661,Lancing Old Boys,KCS Old Boys,1,1,4.0,2
14274995,Old Radleians,Old Westminsters,1,3,3.0,4
14275002,Old Reptonians,Old Chigwellians,2,4,3.0,6
14274996,Old Wykehamists,Old Bradfieldians,2,0,2.0,2
14274994,Old Malvernians,Old Marlburians,1,1,4.0,2
14273801,Old Cholmeleians II,Old Foresters II,7,3,2.0,10
14273922,Old Chigwellians II,Lancing Old Boys II,2,2,5.0,4
14273860,Old King's Scholars,Old Wellingtonians,1,2,4.0,3
14260387,Kings College Wimbledon II,Old Berkhamstedians,1,0,3.0,1
14260324,Old Brentwoods II,Old Millfieldians,6,0,0.0,6
14260325,Old Harrovians II,Old Citizens,3,3,5.0,6
14260326,Old Salopians II,Old Malvernians II,6,0,0.0,6
14273835,Old Eastbournians,Old Stoics,3,2,4.0,5
14273851,Old Chigwellians III,Old Brentwoods III,2,1,4.0,3
14273894,Old Brentwoods IV,Old Foresters III,0,0,4.0,0
14273899,Old Harrovians III,Old Bancroftians AFC,2,2,5.0,4
14273803,Old Millhillians,Old Alleynians AFC,3,5,4.0,8
14273837,Old Oundelians,Old Westminsters II,3,4,4.0,7
14106074,Old Aldenhamians,Old Hamptonians,2,1,4.0,3
14106073,Old Haberdashers,Bank of England,0,1,3.0,1
14005985,John Fisher Old Boys,Old Carthusians III,1,4,2.0,5
14005993,Old Cholmeleians III,Oakhill Tigers,1,8,0.0,9
14257688,Old Foresters,Old Carthusians,2,2,5.0,4
14257670,Old Brentwoods,Lancing Old Boys,2,5,2.0,7
14257667,Old Etonians,Old Cholmeleians,5,1,2.0,6
14275040,Old Aldenhamians,Old Reptonians,7,1,0.0,8
14275018,Old Chigwellians,Old Radleians,6,0,0.0,6
14275003,Old Westminsters,Old Malvernians,3,0,2.0,3
14275059,Old Haileyburians,Old Wykehamists,4,2,3.0,6
14274986,Old Marlburians,Old Bradfieldians,4,1,2.0,5
14273967,Old Foresters II,Old Etonians II,2,4,3.0,6
14273931,Lancing Old Boys II,Old Haberdashers,1,0,3.0,1
14273926,Old Carthusians II,Old Cholmeleians II,1,1,4.0,2
14273798,Old Chigwellians II,Old King's Scholars,0,0,4.0,0
14260348,Old Malvernians II,Old Brentwoods II,0,3,2.0,3
14260333,Old Epsomians,Old Berkhamstedians,2,4,3.0,6
14273795,Old Amplefordians,Old Cholmeleians III,4,2,3.0,6
14273796,Old Brentwoods III,Old Eastbournians,1,2,4.0,3
14273800,Old Sennockians,Old Wykehamists II,4,4,6.0,8
14273932,Old Bancroftians AFC,Old Foresters III,1,2,4.0,3
14273943,Old Cholmeleians IV,Old Merchant Taylors,1,4,2.0,5
14273788,Old Tonbridgians II,Old Westminsters II,4,1,2.0,5
14107546,Old Aldenhamians II,Bealonians,2,6,2.0,8
14107547,Old Carthusians III,Merton,4,2,3.0,6
14298599,Old Lyonians,Kings College Wimbledon II,3,9,0.0,12
13975698,Shrewsbury School 1st XI,Old Salopians,0,0,4.0,0
13975697,Shrewsbury School 2nd XI,Old Salopians II,5,2,2.0,7
14257639,KCS Old Boys,Old Carthusians,1,2,4.0,3
14257640,Old Harrovians,Old Foresters,1,8,0.0,9
14257641,Old Tonbridgians,Old Salopians,1,2,4.0,3
14274990,Old Bradfieldians,Old Chigwellians,2,3,4.0,5
14275023,Old Reptonians,Old Haileyburians,2,1,4.0,3
14274989,Old Westminsters,Old Aldenhamians,3,1,3.0,4
14275025,Old Wykehamists,Old Marlburians,1,5,2.0,6
14273941,Old Carthusians III,Old Haberdashers,5,1,2.0,6
14260317,Old Aldenhamians II,Old Berkhamstedians,0,1,3.0,1
14260318,Old Citizens,Old Epsomians,1,6,0.0,7
14260319,Old Harrovians II,Kings College Wimbledon II,3,2,4.0,5
14273948,Old Cholmeleians III,Old Wykehamists II,2,3,4.0,5
14273791,Old Eastbournians,Old Amplefordians,1,3,3.0,4
14273874,Old Stoics,Old Sennockians,1,2,4.0,3
14273799,Old Merchant Taylors,Old Harrovians III,1,1,4.0,2
14273793,Old Millhillians,Old Westminsters II,2,1,4.0,3
14273794,Old Oundelians,Old Alleynians AFC,1,2,4.0,3
14106066,Broomfield FC,Old Foresters II,7,7,6.0,14
14106067,Old Cholmeleians II,Parkfield,11,0,0.0,11
14106065,Old Millfieldians,Old Isleworthians,3,5,4.0,8
14106068,Old Salopians II,Old Woodhouseians,1,5,2.0,6
14216872,Royal Bank of Scotland,Old Carthusians II,3,3,5.0,6
14240980,St. James' Old Boys,Old Bancroftians AFC,5,2,2.0,7
14284233,UCL Academicals II,Old Brentwoods II,4,0,1.0,4
13919437,Old Etonians,Old Etonians II,3,0,2.0,3
13971835,Brentwood School 1st XI,Old Brentwoods,1,1,4.0,2
13971834,Brentwood School 2nd XI,Old Brentwoods II,5,2,2.0,7
13971833,Brentwood School 3rd XI,Old Brentwoods III,7,1,0.0,8
13971832,Brentwood School 4th XI,Old Brentwoods IV,0,0,4.0,0
13919339,Lancing College 1st XI,Lancing Old Boys,2,5,2.0,7
13919338,Lancing College 2nd XI,Lancing Old Boys II,1,3,3.0,4
13920686,Old Malvernians,TBC,2,1,4.0,3
13919255,Old Malvernians II,TBC,0,5,0.0,5
14273699,Old Carthusians,Old Foresters,2,1,4.0,3
14273607,Old Carthusians,Lancing Old Boys,2,0,2.0,2
14273608,Old Foresters,Old Foresters II,1,0,3.0,1
14266008,Lancing Old Boys,Old Aldenhamians,2,0,2.0,2
14265983,Old Carthusians,Old Reptonians,2,1,4.0,3
14265988,Old Carthusians,Old Marlburians,2,0,2.0,2
14266004,Old Foresters,Old King's Scholars,0,1,3.0,1
14266006,Old Foresters,Old Aldenhamians,1,0,3.0,1
14265987,Old Harrovians,Old Foresters II,0,1,3.0,1
14265993,Old Harrovians,Old Marlburians,0,1,3.0,1
14265990,Old Reptonians,Old Foresters II,1,2,4.0,3
14266001,Lancing Old Boys,Old King's Scholars,2,1,4.0,3
14265961,Old Carthusians,Old Harrovians,2,0,2.0,2
14265979,Old Carthusians,Old Foresters II,1,0,3.0,1
14265998,Old Foresters,Lancing Old Boys,3,1,3.0,4
14265980,Old Harrovians,Old Reptonians,0,4,1.0,4
14265999,Old King's Scholars,Old Aldenhamians,2,2,5.0,4
14265982,Old Marlburians,Old Foresters II,0,0,4.0,0
14265968,Old Reptonians,Old Marlburians,0,0,4.0,0
14273704,Old King's Scholars,Old Reptonians,0,2,2.0,2
13919342,Old Berkhamstedians,Old Millfieldians,0,0,4.0,0
13977320,Old Westminsters II,Steuerman Select Work XI,2,1,4.0,3
13975245,Old Malvernians,KCS Old Boys,0,5,0.0,5
13919344,Old Brentwoods III,Old Chigwellians III,0,0,4.0,0
13919184,Eton College 1st XI,Old Etonians,3,3,5.0,6
13975244,Old Malvernians,Old Epsomians,6,2,2.0,8
13975695,Old Oundelians,Old Tonbridgians,1,4,2.0,5
14249668,Nottsborough FC,Old Carthusians,3,4,4.0,7
14249681,Nottsborough FC III,Old Carthusians III,1,1,4.0,2
13975243,Old Tiffinians,KCS Old Boys,1,9,0.0,10
13975241,Montpellier Villa FC,KCS Old Boys,1,1,4.0,2
13975239,Old Alleynians AFC,Dulwich College 1st XI,3,2,4.0,5
13975256,Old Carthusians II,Old Marlburians,1,3,3.0,4
13975240,Old Malvernians,Old Citizens,1,0,3.0,1
13919370,Old Merchant Taylors,Old Cholmeleians II,4,0,1.0,4
14121337,Kings College Wimbledon II,Old Pauline,3,0,2.0,3
13977319,Old Westminsters,Shene FC,4,4,6.0,8
14211716,Old Aldenhamians,Old Millhillians,4,3,4.0,7
13919369,Old Cholmeleians,Old Chigwellians,1,2,4.0,3
13919345,Old Chigwellians III,Old Bancroftians AFC,2,2,5.0,4
13919390,Old Owens,Old Carthusians,4,2,3.0,6
13975242,Old Bradfieldians,KCS Old Boys,1,1,4.0,2
13975694,Old Chigwellians,Old Parkonians,1,4,2.0,5
14254580,Old Chigwellians III,Old Chigwellians Vets,0,1,3.0,1
13977273,Old Westminsters,New College Old Boys,6,1,0.0,7
13977272,Old Westminsters II,Old Sennockians,0,6,0.0,6
13990294,Corinthian-Casuals,Lancing Old Boys,2,1,4.0,3
13975246,Old Alleynians AFC,Parklife FC,2,2,5.0,4
14052140,Old Cholmeleians,FC Brotherhood,1,1,4.0,2
13975250,Old Aldenhamians II,Old Cholmeleians II,4,2,3.0,6
13919343,Old Berkhamstedians,Northchurch Baptist Church FC,4,2,3.0,6
13975679,Old Chigwellians,Old Brentwoods,2,1,4.0,3
13975252,Old Millfieldians,Old Reptonians,1,1,4.0,2
13928126,Old Owens,Old Cholmeleians,5,1,2.0,6
16056608,Old Suttonians SV,Old Berkhamstedians,3,8,0.0,11
15312581,Old Carthusians III,Old Westminsters,0,0,4.0,0
15299945,Old Cholmeleians,Old Tonbridgians,3,4,4.0,7
15312594,Old Millfieldians,Old Carthusians III,1,7,0.0,8
15315305,Old Alleynians AFC,Old Cholmeleians III,10,1,0.0,11
15869583,Old Bancroftians AFC,Old Merchant Taylors,0,1,3.0,1
15299986,Old Cholmeleians,Old Salopians,2,2,5.0,4
15304615,Old Bradfieldians,Old Aldenhamians,2,3,4.0,5
15304631,Old Wellingtonians,Old Brentwoods,1,3,3.0,4
15304642,Old Brentwoods,Old Wellingtonians,1,0,3.0,1
15312617,Old Carthusians III,Old Millfieldians,4,3,4.0,7
15816861,Old Tonbridgians II,Old Bancroftians AFC,2,1,4.0,3
15299991,Old Tonbridgians,Old Cholmeleians,3,2,4.0,5
15300022,Old Salopians,Old Foresters,3,3,5.0,6
15299937,Old Chigwellians,Lancing Old Boys,3,3,5.0,6
15315321,Old Millhillians,Old Stoics,7,2,0.0,9
15315311,Old Alleynians AFC,Old Aldenhamians II,0,0,4.0,0
15743090,Old Salvatorians,Old Carthusians III,1,3,3.0,4
15299944,KCS Old Boys,Old Foresters,2,2,5.0,4
15304605,Old Brentwoods,Old Harrovians,2,0,2.0,2
15312613,Old Millfieldians,Old Chigwellians II,7,0,0.0,7
15315323,Old Wykehamists II,Old Cholmeleians III,9,3,0.0,12
15315360,Old Brentwoods III,Old Cholmeleians IV,4,2,3.0,6
15315441,Old Westminsters II,Old Amplefordians,0,3,2.0,3
15839289,Old Salopians,Old Tonbridgians,0,1,3.0,1
15816750,Lancing Old Boys II,Old Carthusians III,1,4,2.0,5
15853891,Old Merchant Taylors,Old Alleynians AFC,2,1,4.0,3
15846001,Old Brentwoods Vets,Old Harrovians Vets,0,2,2.0,2
15849309,Old Bradfieldians Vets,Old Westminsters Vets,0,1,3.0,1
15299952,Lancing Old Boys,Old Etonians,2,2,5.0,4
15299994,Old Marlburians,Old Tonbridgians,2,5,2.0,7
15304637,Old Brentwoods,Old Aldenhamians,8,0,0.0,8
15304621,Old Reptonians,Old Haileyburians,7,0,0.0,7
15304643,Old Harrovians,Old Radleians,3,4,4.0,7
15312625,Old Carthusians II,Old Westminsters,4,1,2.0,5
15312568,Old Millfieldians,Old Foresters II,7,6,5.0,13
15314170,Old Salopians II,Old Haberdashers,3,3,5.0,6
15315341,Old Wykehamists II,Old Stoics,2,6,2.0,8
15839055,Old Merchant Taylors,Old Millhillians,4,2,3.0,6
15846329,Old Alleynians AFC,Old Tonbridgians II,1,0,3.0,1
15818606,Old Bradfieldians Vets,Old Chigwellians Vets,5,1,2.0,6
15299989,Old Marlburians,Old Foresters,0,2,2.0,2
15299974,Old Salopians,Old Etonians,2,3,4.0,5
15299996,KCS Old Boys,Lancing Old Boys,2,0,2.0,2
15304650,Old Bradfieldians,Old Brentwoods,1,6,0.0,7
15304656,Old Haileyburians,Old Wellingtonians,2,6,2.0,8
15304648,Old Radleians,Old Aldenhamians,1,0,3.0,1
15304654,Old Wykehamists,Old Reptonians,1,4,2.0,5
15312603,Old Etonians II,Old Carthusians III,1,5,2.0,6
15314201,Old Haberdashers,Old Eastbournians,3,3,5.0,6
15816860,Old Bancroftians AFC,Old Tonbridgians II,2,0,2.0,2
15781719,Old Aldenhamians Vets,Old Brentwoods Vets,0,6,0.0,6
15299953,Old Chigwellians,Old Marlburians,2,1,4.0,3
15299984,Old Carthusians,Old Foresters,2,2,5.0,4
15304633,Old Aldenhamians,Old Malvernians,2,3,4.0,5
15304616,Old Haileyburians,Old Brentwoods,1,13,1.0,14
15304630,Old Radleians,Old Harrovians,2,2,5.0,4
15304622,Old Wellingtonians,Old Bradfieldians,2,0,2.0,2
15312552,Old Foresters II,Old Carthusians III,1,1,4.0,2
15312596,Old Carthusians III,Old Foresters II,2,1,4.0,3
15312573,Old Etonians II,Lancing Old Boys II,0,3,2.0,3
15312622,Old Millfieldians,Old Carthusians II,4,1,2.0,5
15312588,Old Chigwellians II,Old Westminsters,2,5,2.0,7
15314213,Old Haberdashers,Kings College Wimbledon II,2,8,0.0,10
15314184,Old Sennockians,Old Citizens,2,0,2.0,2
15315334,Old Wykehamists II,Old Chigwellians III,5,2,2.0,7
15315386,Old Foresters III,Old Brentwoods III,2,1,4.0,3
15315358,Old Merchant Taylors,Old Cholmeleians IV,6,0,0.0,6
15315433,Old Oundelians,Old Tonbridgians II,2,0,2.0,2
15315449,Old Malvernians II,Old Westminsters II,1,4,2.0,5
15755859,Old Reptonians,Old Tonbridgians,0,1,3.0,1
15755858,Old Alleynians AFC,Old Salopians,0,2,2.0,2
15816492,Kings College Wimbledon III,Old Millhillians,3,3,5.0,6
15786660,Old Etonians Vets,Old Harrovians Vets,0,1,3.0,1
15789426,Old Bradfieldians Vets,Old Salopians Vets,6,5,5.0,11
15795643,Old Westminsters Vets,Old Malvernians Vets,2,1,4.0,3
15476829,Stowe School,Old Stoics,1,3,3.0,4
15299964,Old Chigwellians,Old Carthusians,1,9,0.0,10
15300011,Old Tonbridgians,Old Salopians,5,1,2.0,6
15300002,Old Etonians,Old Foresters,2,3,4.0,5
15304636,Old Reptonians,Old Wykehamists,0,1,3.0,1
15304651,Old Haileyburians,Old Radleians,1,5,2.0,6
15312548,Old Chigwellians II,Old Etonians II,1,3,3.0,4
15312576,Old Westminsters,Old Carthusians II,2,2,5.0,4
15314176,Old Citizens,Old Eastbournians,0,2,2.0,2
15314196,Old Salopians II,Old Harrovians II,0,4,1.0,4
15314160,Kings College Wimbledon II,Old Sennockians,1,1,4.0,2
15315373,Old Foresters III,Old Harrovians III,1,1,4.0,2
15780022,Old Millfieldians,Lancing Old Boys II,4,6,4.0,10
15779846,Old Berkhamstedians,Old Carthusians III,2,4,3.0,6
15789819,Old Millhillians,Old Rugbeians,3,2,4.0,5
15778753,Old Alleynians AFC,Old Westminsters II,3,2,4.0,5
15804510,Old Tonbridgians II,Old Amplefordians,3,1,3.0,4
15797886,Hampstead Heathens,Old Aldenhamians,1,2,4.0,3
15787769,Bradfield College,Old Bradfieldians,1,3,3.0,4
15787772,Epsom College 1st XI,Old Epsomians,1,1,4.0,2
15771102,Haberdashers Aske School 1st XI,Old Haberdashers,3,3,5.0,6
15586506,Highgate School 1st XI,Old Cholmeleians,2,1,4.0,3
15586504,Highgate School 3rd XI,Old Cholmeleians III,1,1,4.0,2
15800278,Forest School 1st XI,Old Foresters II,5,2,2.0,7
15300003,Lancing Old Boys,Old Cholmeleians,1,1,4.0,2
15299993,Old Foresters,Old Chigwellians,3,0,2.0,3
15300014,Old Marlburians,Old Etonians,2,0,2.0,2
15299995,Old Salopians,KCS Old Boys,4,3,4.0,7
15300023,Old Tonbridgians,Old Carthusians,2,3,4.0,5
15304634,Old Bradfieldians,Old Radleians,6,3,3.0,9
15304602,Old Aldenhamians,Old Haileyburians,10,1,0.0,11
15304600,Old Malvernians,Old Harrovians,1,4,2.0,5
15312624,Old Berkhamstedians,Old Carthusians III,3,0,2.0,3
15312578,Old Carthusians III,Old Berkhamstedians,0,0,4.0,0
15312612,Old Foresters II,Old Carthusians II,2,1,4.0,3
15312600,Lancing Old Boys II,Old Millfieldians,2,2,5.0,4
15314177,Old Epsomians,Old Harrovians II,4,1,2.0,5
15784577,Old Harrovians III,Old Cholmeleians III,1,3,3.0,4
15793776,Old Merchant Taylors,Old Aldenhamians II,1,0,3.0,1
15764210,Old Amplefordians,Old Stoics,2,2,5.0,4
15789418,Old Tonbridgians II,Old Cholmeleians IV,10,0,0.0,10
15764439,Kings College Wimbledon III,Old Bancroftians AFC,4,1,2.0,5
15776297,Westminster School 1st XI,Old Westminsters,1,1,4.0,2
15787770,Westminster School 2nd XI,Old Westminsters II,0,2,2.0,2
15314195,Old Brentwoods II,Old Sennockians,2,2,5.0,4
15762515,Sevenoaks School 1st XI,Old Sennockians,2,0,2.0,2
15300020,Old Foresters,Old Tonbridgians,1,2,4.0,3
15299990,Old Salopians,Lancing Old Boys,1,2,4.0,3
15300012,Old Carthusians,Old Chigwellians,1,1,4.0,2
15299950,Old Marlburians,Old Cholmeleians,1,4,2.0,5
15300024,KCS Old Boys,Old Etonians,0,2,2.0,2
15304667,Old Wellingtonians,Old Reptonians,0,0,4.0,0
15304647,Old Harrovians,Old Haileyburians,10,1,0.0,11
15304669,Old Aldenhamians,Old Brentwoods,1,11,0.0,12
15312619,Old Carthusians III,Old Etonians II,5,0,0.0,5
15312621,Old Foresters II,Lancing Old Boys II,0,3,2.0,3
15315330,Old Wykehamists II,Old Alleynians AFC,3,2,4.0,5
15315310,Old Stoics,Old Aldenhamians II,2,2,5.0,4
15315445,Old Amplefordians,Old Tonbridgians II,3,2,4.0,5
15315424,Old Westminsters II,Old Malvernians II,2,1,4.0,3
15746347,Old Merchant Taylors,Old Chigwellians III,3,1,3.0,4
15484527,Oundle School 1st XI,Old Oundelians,4,4,6.0,8
15314185,Old Brentwoods II,Kings College Wimbledon II,5,0,0.0,5
15694712,Lloyds of London Representative Team,Arthurian League Representative Team,2,2,5.0,4
15666583,Old Brentwoods Vets,Lancing Old Boys Vets,1,1,4.0,2
15675163,Old Reptonians Vets,Old Chigwellians Vets,4,6,4.0,10
15391319,Haileybury College,Old Haileyburians,0,2,2.0,2
15299967,Lancing Old Boys,Old Foresters,1,3,3.0,4
15299997,Old Chigwellians,Old Salopians,1,3,3.0,4
15300025,Old Etonians,Old Tonbridgians,0,1,3.0,1
15300000,KCS Old Boys,Old Cholmeleians,4,0,1.0,4
15304644,Old Wykehamists,Old Aldenhamians,4,1,2.0,5
15304629,Old Malvernians,Old Reptonians,3,1,3.0,4
15312597,Old Chigwellians II,Lancing Old Boys II,1,2,4.0,3
15312628,Old Carthusians III,Old Carthusians II,3,1,3.0,4
15314216,Old Eastbournians,Old Harrovians II,1,2,4.0,3
15314214,Old Sennockians,Old Salopians II,1,3,3.0,4
15314193,Old Citizens,Old Epsomians,1,3,3.0,4
15315337,Old Cholmeleians III,Old Chigwellians III,1,2,4.0,3
15315377,Old Merchant Taylors,Old Bancroftians AFC,1,4,2.0,5
15315446,Old Malvernians II,Old Rugbeians,3,7,2.0,10
15764173,Old Alleynians AFC,Old Millfieldians,2,3,4.0,5
15764448,Old Stoics,Old Berkhamstedians,1,4,2.0,5
15664517,Old Wykehamists Vets,Old Westminsters Vets,1,8,0.0,9
15299992,Old Cholmeleians,Lancing Old Boys,1,0,3.0,1
15299959,Old Foresters,Old Etonians,0,1,3.0,1
15299941,Old Marlburians,KCS Old Boys,1,1,4.0,2
15304609,Old Aldenhamians,Old Radleians,3,0,2.0,3
15304677,Old Reptonians,Old Brentwoods,0,10,0.0,10
15304626,Old Harrovians,Old Wykehamists,8,1,0.0,9
15304676,Old Wellingtonians,Old Haileyburians,10,0,0.0,10
15312591,Old Berkhamstedians,Old Westminsters,6,1,0.0,7
15314154,Old Eastbournians,Old Haberdashers,3,2,4.0,5
15314169,Old Epsomians,Old Sennockians,5,1,2.0,6
15315314,Old Alleynians AFC,Old Chigwellians III,2,0,2.0,2
15315421,Old Rugbeians,Old Westminsters II,1,3,3.0,4
15315426,Old Oundelians,Old Malvernians II,2,1,4.0,3
15719459,Old Merchant Taylors,Old Stoics,1,2,4.0,3
15745846,Old Harrovians II,Lancing Old Boys II,0,4,1.0,4
15719430,Old Millfieldians,Old Etonians II,4,2,3.0,6
15733641,Old Carthusians III,Old Foresters II,5,4,5.0,9
15746294,Old Wykehamists II,Kings College Wimbledon III,3,4,4.0,7
15746296,Old Foresters III,Old Amplefordians,0,1,3.0,1
15706355,Old Carthusians II,NUFC Oilers,2,3,4.0,5
15314191,Old Citizens,Old Brentwoods II,6,1,0.0,7
15656447,Old Tonbridgians Vets,Old Etonians Vets,1,1,4.0,2
15299988,Old Etonians,Old Carthusians,1,2,4.0,3
15300016,KCS Old Boys,Old Chigwellians,4,3,4.0,7
15300015,Old Salopians,Old Cholmeleians,6,0,0.0,6
15304598,Old Aldenhamians,Old Wykehamists,2,2,5.0,4
15304590,Old Brentwoods,Old Haileyburians,3,1,3.0,4
15304670,Old Harrovians,Old Bradfieldians,0,3,2.0,3
15304672,Old Wellingtonians,Old Malvernians,3,6,3.0,9
15312554,Old Carthusians III,Lancing Old Boys II,0,1,3.0,1
15312577,Old Carthusians II,Old Foresters II,3,2,4.0,5
15312563,Old Etonians II,Old Millfieldians,1,1,4.0,2
15314190,Old Harrovians II,Old Salopians II,2,0,2.0,2
15314207,Old Sennockians,Old Haberdashers,3,0,2.0,3
15315343,Old Wykehamists II,Old Millhillians,1,6,0.0,7
15315317,Old Chigwellians III,Old Aldenhamians II,0,1,3.0,1
15315333,Old Stoics,Old Cholmeleians III,1,1,4.0,2
15315366,Old Merchant Taylors,Old Harrovians III,1,1,4.0,2
15315380,Old Cholmeleians IV,Old Brentwoods III,5,4,5.0,9
15315434,Old Rugbeians,Old Malvernians II,1,2,4.0,3
15315429,Old Westminsters II,Old Oundelians,1,2,4.0,3
15656205,Old Radleians,Old Tonbridgians,1,4,2.0,5
15702393,Old Alleynians AFC,Lancing Old Boys,3,2,4.0,5
15702471,Old Berkhamstedians,Old Brentwoods II,3,2,4.0,5
15740457,Old Wykehamists,Old Barryians,0,1,3.0,1
15300013,Old Foresters,KCS Old Boys,2,1,4.0,3
15299936,Old Carthusians,Old Cholmeleians,2,2,5.0,4
15299985,Old Chigwellians,Old Etonians,2,0,2.0,2
15299943,Old Tonbridgians,Lancing Old Boys,1,1,4.0,2
15304674,Old Bradfieldians,Old Malvernians,3,3,5.0,6
15304668,Old Wykehamists,Old Brentwoods,2,3,4.0,5
15304671,Old Reptonians,Old Radleians,0,3,2.0,3
15304628,Old Haileyburians,Old Aldenhamians,2,2,5.0,4
15312561,Old Westminsters,Old Carthusians III,2,3,4.0,5
15312606,Old Berkhamstedians,Old Chigwellians II,3,1,3.0,4
15312592,Old Etonians II,Old Carthusians II,2,2,5.0,4
15314179,Old Epsomians,Old Haberdashers,6,0,0.0,6
15315304,Old Cholmeleians III,Old Wykehamists II,2,4,3.0,6
15656204,Old Harrovians,Old Salopians,1,2,4.0,3
15719455,Old Tonbridgians II,Old Alleynians AFC,2,3,4.0,5
15702532,Old Foresters II,Old Citizens,5,3,4.0,8
15719456,Old Carthusians III,Old Westminsters,3,2,4.0,5
15702472,Old Sennockians,Lancing Old Boys II,0,2,2.0,2
15314181,Old Brentwoods II,Old Eastbournians,2,1,4.0,3
15596043,Arthurian League Representative Team,SAL Representative Team,2,2,5.0,4
15611402,Radley College 1st XI,Old Radleians,1,4,2.0,5
15300009,Old Chigwellians,Old Foresters,1,3,3.0,4
15299968,Old Carthusians,Old Salopians,3,1,3.0,4
15299969,Old Cholmeleians,KCS Old Boys,1,4,2.0,5
15304661,Old Reptonians,Old Bradfieldians,1,0,3.0,1
15304673,Old Wykehamists,Old Haileyburians,7,1,0.0,8
15304613,Old Malvernians,Old Brentwoods,1,5,2.0,6
15304653,Old Wellingtonians,Old Harrovians,0,2,2.0,2
15312615,Old Berkhamstedians,Old Foresters II,3,1,3.0,4
15314163,Old Harrovians II,Old Eastbournians,3,3,5.0,6
15315344,Old Wykehamists II,Old Aldenhamians II,3,3,5.0,6
15315381,Old Foresters III,Old Bancroftians AFC,0,4,1.0,4
15315420,Old Oundelians,Old Amplefordians,9,0,0.0,9
15664992,Kings College Wimbledon II,Old Merchant Taylors,0,1,3.0,1
15664881,Old Carthusians III,Old Cholmeleians II,5,0,0.0,5
15664999,Old Salopians II,Old Etonians II,1,3,3.0,4
15682349,Old Tonbridgians II,Old Carthusians II,4,4,6.0,8
15664839,Old Aldenhamians,Old Strand Academicals,3,2,4.0,5
15716314,Old Alleynians AFC,Kings College Wimbledon III,1,4,2.0,5
15404277,Old Malvernians Vets,Old Harrovians Vets,3,4,4.0,7
15300004,Old Chigwellians,Old Tonbridgians,1,5,2.0,6
15300018,Old Cholmeleians,Old Marlburians,0,1,3.0,1
15304610,Old Bradfieldians,Old Harrovians,0,5,0.0,5
15304678,Old Wykehamists,Old Wellingtonians,1,2,4.0,3
15304666,Old Radleians,Old Malvernians,1,2,4.0,3
15312604,Old Foresters II,Old Westminsters,1,1,4.0,2
15312583,Old Etonians II,Old Chigwellians II,2,2,5.0,4
15314178,Old Eastbournians,Old Salopians II,2,2,5.0,4
15315331,Old Millhillians,Old Aldenhamians II,0,2,2.0,2
15315376,Old Harrovians III,Old Cholmeleians IV,6,0,0.0,6
15315368,Old Foresters III,Old Merchant Taylors,2,2,5.0,4
15315439,Old Malvernians II,Old Tonbridgians II,2,4,3.0,6
15550535,Lancing Old Boys,Old Foresters,3,2,4.0,5
15656203,Old Haileyburians,Old Reptonians,0,1,3.0,1
15664943,Old King's Scholars,Old Citizens,0,5,0.0,5
15665039,Old Wellingburians,Old Brentwoods II,0,8,0.0,8
15664874,Old Oundelians,Old Haberdashers,5,4,5.0,9
15664944,Old Epsomians,Old Stoics,2,3,4.0,5
15664996,Old Millfieldians,Old Amplefordians,10,1,0.0,11
15665000,Old Sennockians,Old Brentwoods III,5,0,0.0,5
15683664,Old Harrovians II,Old Westminsters II,2,2,5.0,4
15653171,Old Carthusians II,Old Owens,2,0,2.0,2
15654405,Old Whitgiftians,Old Carthusians III,0,3,2.0,3
15699116,Kings College Wimbledon III,Old Alleynians AFC,3,5,4.0,8
15300001,Lancing Old Boys,Old Salopians,0,5,0.0,5
15300007,KCS Old Boys,Old Carthusians,0,2,2.0,2
15299999,Old Tonbridgians,Old Etonians,2,1,4.0,3
15299973,Old Marlburians,Old Chigwellians,2,1,4.0,3
15304664,Old Aldenhamians,Old Bradfieldians,0,1,3.0,1
15304675,Old Reptonians,Old Harrovians,0,0,4.0,0
15304660,Old Malvernians,Old Haileyburians,1,2,4.0,3
15304618,Old Wellingtonians,Old Radleians,3,3,5.0,6
15312595,Old Carthusians II,Old Millfieldians,3,3,5.0,6
15314208,Old Citizens,Old Sennockians,4,0,1.0,4
15314183,Old Salopians II,Kings College Wimbledon II,3,4,4.0,7
15315320,Old Cholmeleians III,Old Aldenhamians II,0,1,3.0,1
15315313,Old Stoics,Old Millhillians,3,1,3.0,4
15664961,Old Berkhamstedians,Old Chigwellians III,8,1,0.0,9
15665327,Old Wykehamists II,Old Foresters II,4,4,6.0,8
15664883,Old Westminsters,Old Eastbournians,5,1,2.0,6
15664998,Lancing Old Boys II,Old Chigwellians II,3,1,3.0,4
15593994,Old Westminsters II,Old Foresters III,4,1,2.0,5
15598150,Old Brentwoods,Old Garchonians,1,4,2.0,5
15598147,Old Foresters,Old Hamptonians,3,4,4.0,7
15605918,East Barnet Old Grammarians,Old Merchant Taylors,1,1,4.0,2
15314215,Old Brentwoods II,Old Haberdashers,4,2,3.0,6
15312611,Old Cholmeleians II,Old Carthusians III,0,3,2.0,3
15681055,Kings College Wimbledon III,Old Bancroftians AFC,3,1,3.0,4
15492116,Old Chigwellians Vets,Old Brentwoods Vets,0,2,2.0,2
15299998,Old Marlburians,Old Carthusians,0,6,0.0,6
15304649,Old Reptonians,Old Malvernians,3,0,2.0,3
15312601,Old Berkhamstedians,Old Carthusians II,3,4,4.0,7
15312629,Old Westminsters,Old Etonians II,4,2,3.0,6
15314171,Old Eastbournians,Kings College Wimbledon II,1,1,4.0,2
15314156,Old Harrovians II,Old Sennockians,4,3,4.0,7
15315328,Old Millhillians,Old Cholmeleians III,5,3,4.0,8
15315325,Old Stoics,Old Alleynians AFC,1,8,0.0,9
15315365,Old Harrovians III,Old Bancroftians AFC,2,5,2.0,7
15315436,Old Tonbridgians II,Old Amplefordians,0,0,4.0,0
15593993,Old Wykehamists II,Old Rugbeians,5,1,2.0,6
15594002,Old Wellingburians,Old Aldenhamians II,4,4,6.0,8
15598166,Honourable Artillery Company,KCS Old Boys,4,1,2.0,5
15654246,Southgate County,Old Aldenhamians,0,2,2.0,2
15378375,Brentwood School 2nd XI,Old Brentwoods II,4,3,4.0,7
15378374,Brentwood School 3rd XI,Old Brentwoods III,2,2,5.0,4
15646853,Old Parmiterians,Old Chigwellians II,0,0,4.0,0
15392443,KCS Wimbledon 1st XI,KCS Old Boys,1,5,2.0,6
15392442,KCS Wimbledon 2nd XI,Kings College Wimbledon II,1,6,0.0,7
15312570,Old Carthusians II,Old Carthusians III,2,6,2.0,8
15509114,Old Foresters Vets,Old Carthusians Vets,4,2,3.0,6
15304640,Old Wykehamists,Old Radleians,2,3,4.0,5
15304638,Old Malvernians,Old Bradfieldians,2,2,5.0,4
15557306,Old Carthusians III,London Welsh F.C.,6,0,0.0,6
15312541,Old Carthusians II,Old Cholmeleians II,8,1,0.0,9
15404275,Old Bradfieldians Vets,Lancing Old Boys Vets,0,5,0.0,5
15300010,Old Cholmeleians,Old Etonians,2,3,4.0,5
15300005,Old Foresters,Old Carthusians,3,0,2.0,3
15304665,Old Haileyburians,Old Harrovians,0,1,3.0,1
15312614,Lancing Old Boys II,Old Westminsters,8,1,0.0,9
15312593,Old Foresters II,Old Chigwellians II,0,0,4.0,0
15314175,Old Salopians II,Old Eastbournians,2,3,4.0,5
15550538,Old Bradfieldians,Old Reptonians,3,4,4.0,7
15550536,Old Salopians,Old Brentwoods,2,1,4.0,3
15550532,Old Alleynians AFC,Old Chigwellians,3,2,4.0,5
15550533,Old Radleians,KCS Old Boys,2,1,4.0,3
15550534,Old Tonbridgians,Old Millfieldians,5,1,2.0,6
15593999,Old Cholmeleians III,Old Merchant Taylors,1,3,3.0,4
15593996,Old Oundelians,Old Bancroftians AFC,5,2,2.0,7
15593991,Kings College Wimbledon III,Old Amplefordians,1,2,4.0,3
15557289,Old Minchendenians,Old Carthusians II,2,3,4.0,5
15585826,Old Kingsburians,Old Carthusians III,2,2,5.0,4
15073175,Wellington College 1st XI,Old Wellingtonians,1,1,4.0,2
15593726,Aldenham School 1st XI,Old Aldenhamians,1,0,3.0,1
15593725,Aldenham School 2nd XI,Old Aldenhamians II,1,0,3.0,1
15312618,Old Etonians II,Old Cholmeleians II,1,0,3.0,1
15460818,Arthurian League Representative Team,Royal Navy Development XI,4,1,2.0,5
15300008,Lancing Old Boys,Old Marlburians,1,6,0.0,7
15300019,Old Etonians,Old Salopians,0,0,4.0,0
15304658,Old Radleians,Old Wykehamists,6,1,0.0,7
15304645,Old Bradfieldians,Old Wellingtonians,4,1,2.0,5
15312575,Old Millfieldians,Old Berkhamstedians,3,3,5.0,6
15312607,Old Carthusians II,Old Etonians II,3,1,3.0,4
15312585,Lancing Old Boys II,Old Foresters II,1,0,3.0,1
15314194,Old Harrovians II,Kings College Wimbledon II,3,4,4.0,7
15314161,Old Eastbournians,Old Epsomians,0,3,2.0,3
15314172,Old Salopians II,Old Sennockians,0,3,2.0,3
15315335,Old Aldenhamians II,Old Cholmeleians III,2,0,2.0,2
15550537,Old Haileyburians,Old Cholmeleians,3,2,4.0,5
15550531,Old Westminsters,Old Harrovians,1,3,3.0,4
15529745,Broomfield FC,Old Foresters,1,6,0.0,7
15529743,Old Brentwoods,Old Pauline,2,0,2.0,2
15529744,KCS Old Boys,Old Parmiterians,3,1,3.0,4
15483833,Old Aldenhamians,Old Strand Academicals,1,3,3.0,4
15550644,Chigwell School 1st XI,Old Chigwellians,0,0,4.0,0
15550643,Chigwell School 2nd XI,Old Chigwellians II,0,0,4.0,0
15550642,Chigwell School 3rd XI,Old Chigwellians III,3,3,5.0,6
15312587,Old Carthusians III,Old Cholmeleians II,2,2,5.0,4
15581684,Old Tonbridgians II,Old Alleynians AFC,2,0,2.0,2
15299980,Old Chigwellians,Old Cholmeleians,4,2,3.0,6
15299982,Old Foresters,Old Salopians,2,0,2.0,2
15299979,Old Carthusians,Lancing Old Boys,3,1,3.0,4
15299978,KCS Old Boys,Old Tonbridgians,1,2,4.0,3
15304663,Old Wykehamists,Old Harrovians,1,2,4.0,3
15304625,Old Haileyburians,Old Bradfieldians,3,7,2.0,10
15304627,Old Malvernians,Old Radleians,2,2,5.0,4
15304624,Old Brentwoods,Old Reptonians,2,2,5.0,4
15304662,Old Wellingtonians,Old Aldenhamians,6,3,3.0,9
15312572,Old Etonians II,Old Westminsters,2,3,4.0,5
15312584,Old Foresters II,Old Millfieldians,1,3,3.0,4
15312605,Lancing Old Boys II,Old Carthusians III,2,0,2.0,2
15312586,Old Carthusians II,Old Berkhamstedians,2,3,4.0,5
15314210,Old Citizens,Kings College Wimbledon II,2,0,2.0,2
15314209,Old Haberdashers,Old Salopians II,1,1,4.0,2
15314217,Old Sennockians,Old Epsomians,1,2,4.0,3
15315324,Old Aldenhamians II,Old Millhillians,4,2,3.0,6
15315326,Old Stoics,Old Wykehamists II,3,0,2.0,3
15315430,Old Amplefordians,Old Malvernians II,0,0,4.0,0
15315444,Old Westminsters II,Old Tonbridgians II,0,2,2.0,2
15509442,Old Parmiterians,Old Etonians,3,1,3.0,4
15314168,Old Eastbournians,Old Brentwoods II,1,4,2.0,5
15299972,Old Cholmeleians,Old Foresters,0,4,1.0,4
15299977,Old Salopians,Old Tonbridgians,2,2,5.0,4
15299975,Lancing Old Boys,KCS Old Boys,2,1,4.0,3
15299976,Old Carthusians,Old Marlburians,3,1,3.0,4
15304619,Old Harrovians,Old Aldenhamians,2,1,4.0,3
15304623,Old Wykehamists,Old Malvernians,4,1,2.0,5
15304641,Old Bradfieldians,Old Haileyburians,6,1,0.0,7
15304620,Old Radleians,Old Brentwoods,3,6,3.0,9
15312579,Old Millfieldians,Lancing Old Boys II,2,1,4.0,3
15312623,Old Westminsters,Old Chigwellians II,5,0,0.0,5
15314187,Old Harrovians II,Old Haberdashers,1,2,4.0,3
15314166,Old Eastbournians,Old Sennockians,2,3,4.0,5
15314147,Old Salopians II,Old Epsomians,5,5,6.0,10
15315385,Old Bancroftians AFC,Old Harrovians III,1,0,3.0,1
15367007,Old Cholmeleians IV,Old Foresters III,1,1,4.0,2
15315363,Old Merchant Taylors,Old Brentwoods III,4,1,2.0,5
15544236,Old Carthusians II,Old Parmiterians,4,2,3.0,6
15483830,Weirside Rangers,Old Cholmeleians III,4,0,1.0,4
15509552,Old Carthusians III,Economicals,2,1,4.0,3
15509620,Oakhill Tigers,Old Aldenhamians II,7,0,0.0,7
15143206,Eton College 1st XI,Old Etonians,2,1,4.0,3
15143205,Eton College 2nd XI,Old Etonians II,2,1,4.0,3
15314165,Old Brentwoods II,Old Citizens,3,1,3.0,4
15551727,Kings College Wimbledon III,Old Rugbeians,3,4,4.0,7
15404281,Old Wykehamists Vets,Old Tonbridgians Vets,0,3,2.0,3
15299970,Lancing Old Boys,Old Tonbridgians,1,1,4.0,2
15299971,Old Carthusians,KCS Old Boys,4,2,3.0,6
15300006,Old Marlburians,Old Salopians,1,6,0.0,7
15304646,Old Brentwoods,Old Wykehamists,7,3,2.0,10
15312589,Old Millfieldians,Old Etonians II,4,1,2.0,5
15312580,Lancing Old Boys II,Old Berkhamstedians,3,0,2.0,3
15314164,Kings College Wimbledon II,Old Haberdashers,3,1,3.0,4
15315322,Old Aldenhamians II,Old Chigwellians III,0,5,0.0,5
15315336,Old Alleynians AFC,Old Stoics,6,1,0.0,7
15315374,Old Bancroftians AFC,Old Cholmeleians IV,10,0,0.0,10
15315440,Old Tonbridgians II,Old Rugbeians,4,0,1.0,4
15315442,Old Malvernians II,Old Amplefordians,1,4,2.0,5
15249270,Old Eastbournians,Old Haileyburians,0,4,1.0,4
15429421,Old Merchant Taylors,Old Radleians,3,4,4.0,7
15249273,Old Etonians,Old Chigwellians,2,3,4.0,5
15487275,Old Brentwoods III,Queen Mary College Old Boys,5,5,6.0,10
15483832,Old Carthusians III,Polytechnic 3s,3,1,3.0,4
15483831,Old Westminsters II,Hale End Athletic,1,7,0.0,8
15509443,Fulham Compton Old Boys,Old Cholmeleians,3,0,2.0,3
15445249,Old Malvernians,Old Aldenhamians,0,2,2.0,2
15445250,Old Hamptonians,Old Carthusians II,5,4,5.0,9
15513385,Harrow School 1st XI,Old Harrovians,2,4,3.0,6
15513384,Harrow School 2nd XI,Old Harrovians II,1,3,3.0,4
15538999,Chingford Athletic,Old Foresters,0,5,0.0,5
15312574,Old Foresters II,Old Cholmeleians II,8,2,0.0,10
15314198,Old Salopians II,Old Brentwoods II,0,2,2.0,2
15300021,Old Etonians,Lancing Old Boys,0,2,2.0,2
15304597,Old Wellingtonians,Old Wykehamists,4,3,4.0,7
15304652,Old Malvernians,Old Aldenhamians,4,1,2.0,5
15304614,Old Radleians,Old Reptonians,3,1,3.0,4
15312610,Old Berkhamstedians,Lancing Old Boys II,1,1,4.0,2
15312627,Old Etonians II,Old Foresters II,2,1,4.0,3
15312616,Old Carthusians II,Old Chigwellians II,1,0,3.0,1
15314157,Old Citizens,Old Harrovians II,8,3,0.0,11
15314146,Kings College Wimbledon II,Old Epsomians,1,1,4.0,2
15315303,Old Aldenhamians II,Old Stoics,1,1,4.0,2
15315312,Old Chigwellians III,Old Cholmeleians III,1,0,3.0,1
15315370,Old Brentwoods III,Old Harrovians III,1,2,4.0,3
15315369,Old Bancroftians AFC,Old Foresters III,2,0,2.0,2
15315438,Old Amplefordians,Old Rugbeians,3,2,4.0,5
15249279,Old Haberdashers,Old Bradfieldians,1,2,4.0,3
15425848,Old Alleynians AFC,Old Sennockians,5,0,0.0,5
15249277,Old Harrovians,Old Marlburians,4,0,1.0,4
15509152,Old Blues,KCS Old Boys,0,4,1.0,4
15430486,Old Brentwoods,Old Suttonians,3,3,5.0,6
15430489,Old Carthusians,Nottsborough FC,1,2,4.0,3
15430490,Old Chigwellians,Old Wilsonians,1,2,4.0,3
15445304,Old Salopians,Broomfield FC,2,4,3.0,6
15445306,Old Wokingians,Old Foresters,1,2,4.0,3
15478798,Old Wilsonians,Old Merchant Taylors,0,3,2.0,3
15460826,AFC Representative Team,Arthurian League Representative Team,2,3,4.0,5
15438559,Old Millfieldians,Old Aldenhamians,5,0,0.0,5
15404258,Old Carthusians Vets,Old Reptonians Vets,3,1,3.0,4
15299965,Old Etonians,KCS Old Boys,1,0,3.0,1
15312566,Old Chigwellians II,Old Carthusians III,1,3,3.0,4
15312565,Lancing Old Boys II,Old Carthusians II,0,4,1.0,4
15314158,Old Haberdashers,Old Sennockians,0,3,2.0,3
15314199,Kings College Wimbledon II,Old Citizens,2,0,2.0,2
15315339,Old Millhillians,Old Chigwellians III,3,1,3.0,4
15315378,Old Bancroftians AFC,Old Brentwoods III,4,0,1.0,4
15315383,Old Foresters III,Old Cholmeleians IV,8,1,0.0,9
15315447,Old Oundelians,Old Westminsters II,6,1,0.0,7
15249278,Old Berkhamstedians,Old Brentwoods,3,4,4.0,7
15249280,Old Malvernians,Old Salopians,1,3,3.0,4
15249268,Old Westminsters,Old Wykehamists,2,1,4.0,3
15249272,Old King's Scholars,Lancing Old Boys,0,9,0.0,9
15249276,Old Tonbridgians,Old Epsomians,5,1,2.0,6
15498109,Old Foresters,Old Parkonians,3,4,4.0,7
15479125,Park View,Old Cholmeleians,3,4,4.0,7
15312567,Old Cholmeleians II,Old Etonians II,2,8,0.0,10
15314159,Old Harrovians II,Old Brentwoods II,6,2,2.0,8
15404257,Old Westminsters Vets,Old Chigwellians Vets,2,4,3.0,6
15299963,Old Tonbridgians,Old Marlburians,5,3,4.0,8
15299961,Lancing Old Boys,Old Chigwellians,2,1,4.0,3
15304632,Old Wykehamists,Old Bradfieldians,2,4,3.0,6
15304608,Old Reptonians,Old Aldenhamians,4,1,2.0,5
15304607,Old Radleians,Old Haileyburians,3,1,3.0,4
15304606,Old Malvernians,Old Wellingtonians,2,1,4.0,3
15304635,Old Harrovians,Old Brentwoods,2,1,4.0,3
15312564,Old Westminsters,Lancing Old Boys II,3,2,4.0,5
15312598,Old Etonians II,Old Berkhamstedians,1,3,3.0,4
15312555,Old Chigwellians II,Old Millfieldians,1,5,2.0,6
15314192,Old Haberdashers,Old Epsomians,2,5,2.0,7
15314180,Old Sennockians,Kings College Wimbledon II,2,0,2.0,2
15314174,Old Harrovians II,Old Citizens,2,2,5.0,4
15315340,Old Chigwellians III,Old Alleynians AFC,1,1,4.0,2
15315315,Old Cholmeleians III,Old Millhillians,1,3,3.0,4
15315375,Old Brentwoods III,Old Foresters III,3,4,4.0,7
15315371,Old Cholmeleians IV,Old Merchant Taylors,5,5,6.0,10
15315443,Old Rugbeians,Old Oundelians,4,5,5.0,9
15249269,Old Carthusians,Old Foresters,0,3,2.0,3
15251428,Alexandra Park FC,Old Salopians II,3,2,4.0,5
15251427,Old Wokingians,Old Carthusians II,0,2,2.0,2
15341655,Old Etonians,Latymer Old Boys,4,1,2.0,5
15445268,Reigatians,Old Carthusians III,0,3,2.0,3
15465267,Old Bancroftians AFC,Old Parmiterians,7,1,0.0,8
15299949,Old Foresters,Lancing Old Boys,2,1,4.0,3
15299958,Old Cholmeleians,Old Chigwellians,1,1,4.0,2
15299957,Old Carthusians,Old Tonbridgians,1,3,3.0,4
15299956,KCS Old Boys,Old Salopians,0,2,2.0,2
15299981,Old Etonians,Old Marlburians,5,0,0.0,5
15304639,Old Reptonians,Old Wellingtonians,1,2,4.0,3
15304603,Old Brentwoods,Old Bradfieldians,4,2,3.0,6
15304617,Old Harrovians,Old Malvernians,1,0,3.0,1
15312558,Old Chigwellians II,Old Carthusians II,0,1,3.0,1
15312559,Old Foresters II,Old Berkhamstedians,3,3,5.0,6
15312609,Old Westminsters,Old Millfieldians,2,2,5.0,4
15312557,Lancing Old Boys II,Old Etonians II,1,1,4.0,2
15314204,Old Salopians II,Old Citizens,1,1,4.0,2
15314189,Old Epsomians,Kings College Wimbledon II,1,1,4.0,2
15314203,Old Sennockians,Old Harrovians II,2,1,4.0,3
15315329,Old Stoics,Old Chigwellians III,1,3,3.0,4
15315357,Old Harrovians III,Old Merchant Taylors,0,6,0.0,6
15315427,Old Rugbeians,Old Tonbridgians II,2,5,2.0,7
15315435,Old Malvernians II,Old Oundelians,1,3,3.0,4
15381073,Old Bancroftians AFC,Somerville Old Boys,0,1,3.0,1
15381072,Old Pegasonians F.C.,Old Aldenhamians,2,3,4.0,5
15251440,Old Brentwoods III,Broomfield FC,5,5,6.0,10
15392433,Old Cholmeleians III,Alleyn Old Boys,2,1,4.0,3
15455197,Old Owens,Old Carthusians III,1,3,3.0,4
15392434,Old Parmiterians,Old Aldenhamians II,5,1,2.0,6
15251439,Old Westminsters II,Egbertian FC,1,0,3.0,1
15311965,Old Eastbournians,Shene Old Grammarians,1,4,2.0,5
15022399,Winchester College 1st XI,Old Wykehamists,2,4,3.0,6
15023804,Winchester College 2nd XI,Old Wykehamists II,1,3,3.0,4
15300017,Lancing Old Boys,Old Carthusians,1,2,4.0,3
15299987,Old Chigwellians,KCS Old Boys,4,4,6.0,8
15299962,Old Etonians,Old Cholmeleians,3,1,3.0,4
15304599,Old Haileyburians,Old Reptonians,0,1,3.0,1
15304601,Old Radleians,Old Wellingtonians,1,4,2.0,5
15312571,Old Chigwellians II,Old Foresters II,1,0,3.0,1
15312556,Old Westminsters,Old Berkhamstedians,6,3,3.0,9
15314206,Old Epsomians,Old Citizens,2,2,5.0,4
15314152,Kings College Wimbledon II,Old Harrovians II,2,1,4.0,3
15315308,Old Chigwellians III,Old Wykehamists II,1,1,4.0,2
15315342,Old Millhillians,Old Alleynians AFC,2,2,5.0,4
15315362,Old Cholmeleians IV,Old Bancroftians AFC,1,4,2.0,5
15315384,Old Harrovians III,Old Brentwoods III,2,1,4.0,3
15315448,Old Amplefordians,Old Oundelians,1,4,2.0,5
15315432,Old Tonbridgians II,Old Westminsters II,6,0,0.0,6
15160909,Old Foresters,Albanian FC,3,1,3.0,4
15160910,Old Ignatians,Old Salopians,2,2,5.0,4
15311157,Globe Rangers,Old Aldenhamians,1,3,3.0,4
15311932,Mickleham Old Boxhillians FC,Old Malvernians,4,4,6.0,8
15311933,Enfield Old Grammarians,Old Carthusians II,2,6,2.0,8
15311934,Old Parmiterians,Old Cholmeleians II,6,2,2.0,8
15311940,Old Carthusians III,Heathrow Seniors,5,0,0.0,5
15311958,Old Challoners,Old Aldenhamians II,0,2,2.0,2
15314153,Old Brentwoods II,Old Salopians II,2,2,5.0,4
15299940,Old Foresters,Old Cholmeleians,4,0,1.0,4
15299948,Old Carthusians,Old Etonians,2,2,5.0,4
15299951,Old Tonbridgians,Old Chigwellians,5,1,2.0,6
15299960,Old Marlburians,Lancing Old Boys,4,6,4.0,10
15304594,Old Aldenhamians,Old Harrovians,1,0,3.0,1
15304659,Old Brentwoods,Old Radleians,6,0,0.0,6
15304595,Old Bradfieldians,Old Reptonians,1,4,2.0,5
15304596,Old Haileyburians,Old Malvernians,2,1,4.0,3
15312550,Lancing Old Boys II,Old Chigwellians II,2,1,4.0,3
15312551,Old Berkhamstedians,Old Etonians II,1,1,4.0,2
15312553,Old Millfieldians,Old Westminsters,2,2,5.0,4
15314182,Old Citizens,Old Haberdashers,5,3,4.0,8
15314197,Old Harrovians II,Old Epsomians,4,2,3.0,6
15314151,Kings College Wimbledon II,Old Eastbournians,2,1,4.0,3
15315338,Old Aldenhamians II,Old Wykehamists II,1,4,2.0,5
15315319,Old Chigwellians III,Old Millhillians,4,6,4.0,10
15315309,Old Cholmeleians III,Old Stoics,3,1,3.0,4
15315361,Old Harrovians III,Old Foresters III,1,1,4.0,2
15315428,Old Tonbridgians II,Old Malvernians II,2,0,2.0,2
15249138,Old Alleynians AFC,Old Amplefordians,5,4,5.0,9
15249139,Old Merchant Taylors,Old Bancroftians AFC,2,1,4.0,3
15312700,Shrewsbury School 1st XI,Old Salopians,0,1,3.0,1
15312699,Shrewsbury School 2nd XI,Old Salopians II,4,3,4.0,7
15312582,Old Cholmeleians II,Old Carthusians II,1,0,3.0,1
15314205,Old Sennockians,Old Brentwoods II,2,1,4.0,3
15299947,Old Salopians,Old Carthusians,0,3,2.0,3
15299946,Old Etonians,Old Chigwellians,4,1,2.0,5
15299983,KCS Old Boys,Old Marlburians,2,1,4.0,3
15304589,Old Aldenhamians,Old Reptonians,2,4,3.0,6
15304592,Old Malvernians,Old Wykehamists,3,5,4.0,8
15304593,Old Radleians,Old Bradfieldians,1,0,3.0,1
15304591,Old Harrovians,Old Wellingtonians,3,0,2.0,3
15312547,Old Carthusians II,Lancing Old Boys II,3,0,2.0,3
15314186,Old Citizens,Old Salopians II,2,3,4.0,5
15314150,Old Epsomians,Old Eastbournians,1,1,4.0,2
15315307,Old Chigwellians III,Old Stoics,0,4,1.0,4
15315316,Old Alleynians AFC,Old Wykehamists II,5,0,0.0,5
15315359,Old Brentwoods III,Old Bancroftians AFC,0,2,2.0,2
15315379,Old Merchant Taylors,Old Foresters III,6,1,0.0,7
15315367,Old Cholmeleians IV,Old Harrovians III,1,5,2.0,6
15315431,Old Oundelians,Old Rugbeians,2,3,4.0,5
15315425,Old Amplefordians,Old Westminsters II,0,2,2.0,2
15345433,Globe Rangers,Old Foresters,3,8,0.0,11
15162920,Economicals,Lancing Old Boys,2,1,4.0,3
15251153,Old Garchonians,Old Foresters II,4,0,1.0,4
15163566,Old Carthusians III,Old Actonians Association FC,3,1,3.0,4
15341654,Oakhill Tigers,Old Cholmeleians,3,4,4.0,7
15311957,Old Millhillians,UCL Academicals IV,3,6,3.0,9
15054002,Millfield School 1st XI,Old Millfieldians,0,3,2.0,3
15314200,Old Brentwoods II,Old Harrovians II,4,0,1.0,4
15312549,Old Cholmeleians II,Old Westminsters,4,7,3.0,11
15396920,Old Merchant Taylors II,Old Tonbridgians II,2,6,2.0,8
15299966,Old Foresters,Old Marlburians,3,0,2.0,3
15299942,Old Salopians,Old Chigwellians,4,1,2.0,5
15299955,Old Tonbridgians,KCS Old Boys,3,1,3.0,4
15304604,Old Bradfieldians,Old Wykehamists,4,1,2.0,5
15304655,Old Brentwoods,Old Malvernians,4,2,3.0,6
15312544,Old Chigwellians II,Old Berkhamstedians,0,4,1.0,4
15312546,Old Foresters II,Old Etonians II,4,1,2.0,5
15314148,Kings College Wimbledon II,Old Salopians II,3,2,4.0,5
15314149,Old Sennockians,Old Eastbournians,3,1,3.0,4
15315306,Old Millhillians,Old Wykehamists II,2,1,4.0,3
15315318,Old Cholmeleians III,Old Alleynians AFC,1,7,0.0,8
15315372,Old Brentwoods III,Old Merchant Taylors,0,4,1.0,4
15315422,Old Rugbeians,Old Amplefordians,3,2,4.0,5
15250587,London Welsh F.C.,Old Millfieldians,2,1,4.0,3
15250588,Old Bancroftians AFC,Leyton County Old Boys,3,1,3.0,4
15162952,Old Haberdashers,Royal Bank of Scotland,4,6,4.0,10
15162951,Old Haileyburians,Putney Ferrets,3,1,3.0,4
15162953,Old Westminsters,Putney Saint-Germain,3,3,5.0,6
15251434,Old Parkonians,Old Foresters III,13,0,1.0,13
15020552,Charterhouse School 1st XI,Old Carthusians,1,2,4.0,3
15020551,Charterhouse School 2nd XI,Old Carthusians II,4,4,6.0,8
15020550,Charterhouse School 3rd XI,Old Carthusians III,1,2,4.0,3
15301535,Repton School 1st XI,Old Reptonians,0,0,4.0,0
15301109,Harrow School 1st XI,Old Harrovians,0,0,4.0,0
15301108,Harrow School 2nd XI,Old Harrovians II,0,0,4.0,0
15301107,Harrow School 3rd XI,Old Harrovians III,0,0,4.0,0
15314173,Old Brentwoods II,Old Epsomians,7,2,0.0,9
15312545,Old Cholmeleians II,Lancing Old Boys II,1,1,4.0,2
15378234,Old Wellingtonians,Old Radleians,1,5,2.0,6
15299954,Old Cholmeleians,Old Carthusians,1,3,3.0,4
15299938,Old Salopians,Old Marlburians,0,1,3.0,1
15299939,Old Tonbridgians,Old Foresters,5,4,5.0,9
15304657,Old Harrovians,Old Reptonians,3,0,2.0,3
15304611,Old Aldenhamians,Old Wellingtonians,1,1,4.0,2
15304612,Old Haileyburians,Old Wykehamists,2,1,4.0,3
15312540,Old Berkhamstedians,Old Millfieldians,1,1,4.0,2
15312542,Old Carthusians III,Old Chigwellians II,3,0,2.0,3
15312543,Old Westminsters,Old Foresters II,4,0,1.0,4
15314167,Old Epsomians,Old Salopians II,1,1,4.0,2
15314211,Old Haberdashers,Old Harrovians II,5,3,4.0,8
15314188,Old Eastbournians,Old Citizens,2,6,2.0,8
15315327,Old Aldenhamians II,Old Alleynians AFC,3,1,3.0,4
15315382,Old Bancroftians AFC,Old Merchant Taylors,1,1,4.0,2
15315423,Old Tonbridgians II,Old Oundelians,0,1,3.0,1
15315437,Old Westminsters II,Old Rugbeians,1,4,2.0,5
15162989,Kings College Wimbledon II,Old Minchendenians,3,4,4.0,7
14985354,Brentwood School 1st XI,Old Brentwoods,1,5,2.0,6
14985353,Brentwood School 2nd XI,Old Brentwoods II,1,4,2.0,5
14985357,Brentwood School 3rd XI,Old Brentwoods III,4,5,5.0,9
14985356,Eton College 1st XI,Old Etonians,0,0,4.0,0
14985355,Eton College 2nd XI,Old Etonians II,0,0,4.0,0
15311152,Lancing College 1st XI,Lancing Old Boys,0,8,0.0,8
15311151,Lancing College 2nd XI,Lancing Old Boys II,0,7,0.0,7
15367008,Old Cholmeleians IV,Old Foresters III,4,8,2.0,12
15054015,Old Harrovians,KCS Old Boys,2,0,2.0,2
15311150,Old Cholmeleians III,Hornsey and Highgate FC,4,2,3.0,6
15072572,Repton School 1st XI,Old Reptonians,1,2,4.0,3
15055938,Old Bradfieldians,KCS Old Boys,3,5,4.0,8
15117835,Old Brentwoods III,Old Chigwellians III,2,0,2.0,2
15143324,Old Tonbridgians,Old Etonians,1,1,4.0,2
15054014,Old Harrovians II,Old Millfieldians,2,3,4.0,5
15008829,Old Epsomians,Old Berkhamstedians,1,4,2.0,5
15046384,Old Carthusians,Old Wilsonians,1,0,3.0,1
15117806,Old Bancroftians AFC,Old Chigwellians III,2,1,4.0,3
15194629,Old Merchant Taylors,Old Cholmeleians III,3,0,2.0,3
15205404,Old Harrovians,Old Stoics,5,2,2.0,7
14985360,Old Sennockians,Old Westminsters II,2,2,5.0,4
15143325,Old Etonians,PWC Select XI,2,2,5.0,4
15130906,Old Wellingtonians,Old Wellingtonians Select XI,1,1,4.0,2
15142908,Old Alleynians AFC,LM United,5,0,0.0,5
15124933,Old Brentwoods,Old Cholmeleians,4,0,1.0,4
15011081,Old Cholmeleians III,Old Foresters III,2,2,5.0,4
15117805,Old Parkonians,Old Chigwellians III,4,0,1.0,4
15131098,Old Chigwellians,Old Parkonians,0,0,4.0,0
15072713,Old Etonians II,Old Harrovians II,6,4,4.0,10
14992638,Old Harrovians,Old Marlburians,3,0,2.0,3
15129626,Old Barryians,Old Millfieldians,3,5,4.0,8
15117872,Chingford Athletic,Old Foresters,5,3,4.0,8
15019201,Old Sennockians,St Lawrence,0,1,3.0,1
15053984,Old Cholmeleians,Old Aldenhamians,2,2,5.0,4
14985361,Old Marlburians,Old Alleynians AFC,3,4,4.0,7
15086776,Old Brentwoods,Old Foresters,4,0,1.0,4
15008830,Old Epsomians,Donnington Wanderers,4,4,6.0,8
16412535,Old Berkhamstedians,Old Carthusians III,3,3,5.0,6
16413451,Old Stoics,Old Bancroftians AFC,2,1,4.0,3
17057536,Old Albanians SA,Old Columbans,1,8,0.0,9
17071300,Old Rugbeians,Old Johnians FC,0,7,0.0,7
16393133,Old Carthusians,Old Salopians,3,2,4.0,5
16393121,Old Carthusians,Old Harrovians,8,2,0.0,10
16412494,Old Westminsters,Lancing Old Boys II,5,2,2.0,7
16412520,Kings College Wimbledon II,Old Carthusians III,3,2,4.0,5
16413497,Old Tonbridgians II,Old Stoics,4,3,4.0,7
16413500,Old Wykehamists II,Old Bancroftians AFC,1,2,4.0,3
17057540,Old Epsomians II,Old Albanians SA,6,2,2.0,8
17069715,Old Merchant Taylors II,Old Johnians FC,1,3,3.0,4
17069714,Old Rugbeians,Old Chigwellians III,5,3,4.0,8
17063147,Old Wokingians,Old Carthusians,2,0,2.0,2
16589184,Old Rugbeians,Old Malvernians II,0,0,4.0,0
16394068,Old Radleians,Old Malvernians,4,1,2.0,5
16413466,Old Cholmeleians II,Old Haberdashers,1,3,3.0,4
17057533,Old Brentwoods II,Old Foresters III,3,0,2.0,3
17057534,Old Chigwellians III,Old Brentwoods III,2,1,4.0,3
16589198,Old Westminsters II,Old Harrovians III,2,2,5.0,4
17059827,Old Reptonians,Old Carthusians,1,3,3.0,4
17062188,Old Westminsters,Old Carthusians III,3,4,4.0,7
17051057,Old Rugbeians,Old Tonbridgians II,1,1,4.0,2
16589208,Old Rugbeians,Old Harrovians III,2,1,4.0,3
17057535,Old Chigwellians III,Old Merchant Taylors II,5,0,0.0,5
16393062,Old Carthusians,Old Foresters,6,1,0.0,7
16393078,Old Tonbridgians,Lancing Old Boys,0,3,2.0,3
16394123,Old Cholmeleians,Old Bradfieldians,0,0,4.0,0
16412493,Old Carthusians II,Old Foresters II,3,0,2.0,3
16412542,Kings College Wimbledon II,Old Westminsters,4,0,1.0,4
16413557,Old Aldenhamians II,Old Chigwellians II,3,0,2.0,3
16413469,Old Bancroftians AFC,Old Merchant Taylors,1,2,4.0,3
16413484,Old Tonbridgians II,Old Haberdashers,6,4,4.0,10
16413492,Old Wykehamists II,Old Cholmeleians II,3,0,2.0,3
16987137,Old Brentwoods III,Old Brentwoods II,1,2,4.0,3
17044856,Old Merchant Taylors II,Old Foresters III,2,1,4.0,3
16434414,Old Westminsters II,Old Rugbeians,0,6,0.0,6
17036039,Old Alleynians AFC,Old Carthusians III,0,1,3.0,1
16394134,Old Malvernians,Old Chigwellians,2,5,2.0,7
17002787,Old Carthusians,Old Etonians,1,0,3.0,1
16394038,Southern Amateur League Rep XI,Arthurian League Representative Team,0,3,2.0,3
17013589,Old Harrovians Vets,Old Foresters Vets,1,4,2.0,5
17045769,Old Malvernians Vets,Old Brentwoods Vets,3,2,4.0,5
16393083,Old Brentwoods,Old Etonians,1,3,3.0,4
16393137,Lancing Old Boys,Old Salopians,1,4,2.0,5
16394101,Old Reptonians,Old Aldenhamians,3,3,5.0,6
16394120,Old Malvernians,Old Wykehamists,0,3,2.0,3
16394140,Old Bradfieldians,Old Cholmeleians,2,3,4.0,5
16412501,Old Carthusians III,Old Foresters II,2,0,2.0,2
16412526,Old Sennockians,Old Berkhamstedians,2,2,5.0,4
16413473,Old Suttonians SV,Old Cholmeleians II,5,3,4.0,8
16413464,Old Wykehamists II,Old Merchant Taylors,1,2,4.0,3
17044692,Old Brentwoods II,Old Chigwellians III,2,5,2.0,7
16589213,Old Alleynians AFC II,Old Westminsters II,7,5,4.0,12
17023615,Old Westminsters,Kings College Wimbledon II,4,3,4.0,7
17042808,Old Rugbeians,Old Columbans,3,3,5.0,6
17044393,Old Tonbridgians II,Old Epsomians II,2,0,2.0,2
17021281,Polytechnic,Old Carthusians,4,1,2.0,5
17013569,Old Malvernians Vets,Old Tonbridgians Vets,3,0,2.0,3
16393088,Old Harrovians,Old Brentwoods,2,1,4.0,3
16394107,Old Wellingtonians,Old Malvernians,6,1,0.0,7
16394084,Old Radleians,Old Chigwellians,1,3,3.0,4
16412536,Old Carthusians II,Kings College Wimbledon II,1,1,4.0,2
16412558,Old Carthusians III,Lancing Old Boys II,0,5,0.0,5
16413539,Old Aldenhamians II,Old Alleynians AFC,2,2,5.0,4
16413556,Old Salopians II,Old Chigwellians II,2,6,2.0,8
16413515,Old Citizens,Old Harrovians II,1,2,4.0,3
16413487,Old Stoics,Old Cholmeleians II,4,3,4.0,7
17035775,Old Merchant Taylors II,Old Brentwoods II,1,1,4.0,2
17035776,Old Foresters III,Old Chigwellians III,6,0,0.0,6
16589190,Old Amplefordians,Old Alleynians AFC II,5,5,6.0,10
16589202,Old Alleynians AFC II,Old Amplefordians,5,5,6.0,10
16434418,Kings College Wimbledon III,Old Rugbeians,3,1,3.0,4
17037397,Old Reptonians,Old Salopians,2,1,4.0,3
17036081,Old Tonbridgians II,Old Bancroftians AFC,1,0,3.0,1
16982087,Old Hamptonians,Old Carthusians,2,3,4.0,5
16393096,Lancing Old Boys,Old Brentwoods,4,1,2.0,5
16393080,Old Foresters,Old Tonbridgians,2,0,2.0,2
16393129,Old Marlburians,Old Carthusians,2,5,2.0,7
16394153,Old Wykehamists,Old Millfieldians,3,1,3.0,4
16412554,Old Carthusians II,Old Berkhamstedians,0,3,2.0,3
16412537,Old Etonians II,Old Westminsters,3,4,4.0,7
16412502,Old Sennockians,Kings College Wimbledon II,2,1,4.0,3
16413555,Old Epsomians,Old Citizens,1,4,2.0,5
16413546,Old Salopians II,Old Eastbournians,2,0,2.0,2
16413518,Old Harrovians II,Old Alleynians AFC,2,1,4.0,3
16413455,Old Suttonians SV,Old Merchant Taylors,0,4,1.0,4
17030367,Old Brentwoods III,Old Foresters III,1,2,4.0,3
16987138,Old Chigwellians III,Old Merchant Taylors II,2,1,4.0,3
16589223,Old Malvernians II,Old Johnians FC,1,3,3.0,4
16948962,Old Salopians,Old Reptonians,2,2,5.0,4
17014219,Old Tonbridgians II,Old Carthusians III,3,3,5.0,6
16996922,Old Alleynians AFC II,Old Bancroftians AFC,3,4,4.0,7
17012308,Old Epsomians II,Old Haberdashers,4,3,4.0,7
17023574,Old Rugbeians,Old Albanians SA,3,2,4.0,5
17002720,Southgate Olympic,Old Aldenhamians II,2,1,4.0,3
16552154,Radley College 1st XI,Old Radleians,3,5,4.0,8
16709884,Highgate School 1st XI,Old Cholmeleians,3,0,2.0,3
16709883,Highgate School 2nd XI,Old Cholmeleians II,0,0,4.0,0
16709882,Highgate School 3rd XI,Old Cholmeleians III,2,0,2.0,2
16393056,Old Marlburians,Old Etonians,3,3,5.0,6
16393125,Old Tonbridgians,Old Carthusians,1,6,0.0,7
16394122,Old Chigwellians,Old Reptonians,2,1,4.0,3
16394119,Old Cholmeleians,Old Millfieldians,1,1,4.0,2
16394146,Old Malvernians,Old Aldenhamians,0,2,2.0,2
16394141,Old Wellingtonians,Old Wykehamists,1,0,3.0,1
16412568,Old Sennockians,Old Etonians II,1,0,3.0,1
16413527,Old Eastbournians,Old Epsomians,4,1,2.0,5
16413491,Old Tonbridgians II,Old Suttonians SV,4,3,4.0,7
16434379,Old Chigwellians III,Old Brentwoods II,0,1,3.0,1
16589194,Old Alleynians AFC II,Old Johnians FC,2,3,4.0,5
16434433,Kings College Wimbledon III,Old Amplefordians,4,1,2.0,5
17012367,Old Westminsters,Old Harrovians II,4,0,1.0,4
17011924,Old Alleynians AFC,Lancing Old Boys II,5,0,0.0,5
17012184,Old Berkhamstedians,Kings College Wimbledon II,2,4,3.0,6
16987209,Old Tonbridgians II,Old Suttonians SV,4,3,4.0,7
16973438,Old Merchant Taylors,Old Rugbeians,2,3,4.0,5
16340723,Forest School 1st XI,Old Foresters,2,3,4.0,5
16340722,Forest School 2nd XI,Old Foresters II,2,2,5.0,4
17008102,Bancroft's School 1st XI,Old Bancroftians AFC,0,0,4.0,0
16576918,Haberdashers Aske School 1st XI,Old Haberdashers,3,2,4.0,5
16937422,Old Cholmeleians Vets,Old Foresters Vets,3,3,5.0,6
16958664,Old Brentwoods Vets,Old Haileyburians Vets,3,0,2.0,3
16952713,Old Malvernians Vets,Old Reptonians Vets,4,2,3.0,6
16393118,Lancing Old Boys,KCS Old Boys,0,4,1.0,4
16393064,Old Harrovians,Old Marlburians,3,5,4.0,8
16393116,Old Salopians,Old Tonbridgians,5,0,0.0,5
16393068,Old Etonians,Old Brentwoods,1,0,3.0,1
16394112,Old Aldenhamians,Old Wykehamists,4,2,3.0,6
16394095,Old Reptonians,Old Chigwellians,2,3,4.0,5
16412567,Old Foresters II,Lancing Old Boys II,0,4,1.0,4
16413505,Old Alleynians AFC,Old Aldenhamians II,5,1,2.0,6
16434396,Old Foresters III,Old Cholmeleians III,7,0,0.0,7
16434392,Old Brentwoods II,Old Brentwoods III,4,1,2.0,5
16968913,Old Harrovians II,Old Alleynians AFC II,2,1,4.0,3
16968911,Old Carthusians III,Old Rugbeians,4,1,2.0,5
16968923,Old Tonbridgians II,Old Carthusians II,1,0,3.0,1
16968919,Kings College Wimbledon II,Old Chigwellians II,3,3,5.0,6
16973434,Old Albanians SA,Old Johnians FC,5,5,6.0,10
16973435,Old Wykehamists II,Old Epsomians II,1,6,0.0,7
16973437,Old Columbans,Old Stoics,2,1,4.0,3
16973436,Old Haberdashers,Old Amplefordians,5,4,5.0,9
16941939,Nottsborough FC,Old Carthusians,0,2,2.0,2
16998007,Malvern College 1st XI,Old Malvernians,1,2,4.0,3
16998010,Malvern College 2nd XI,Old Malvernians II,0,1,3.0,1
16560517,Westminster School 1st XI,Old Westminsters,1,1,4.0,2
16560991,Westminster School 2nd XI,Old Westminsters II,2,3,4.0,5
16987222,Merchant Taylors School 1st XI,Old Merchant Taylors,2,0,2.0,2
16987223,Merchant Taylors School 2nd XI,Old Merchant Taylors II,0,5,0.0,5
16964731,Arthurian League Representative Team,Herts Senior County League,5,4,5.0,9
16969991,Old Harrovians Vets,Lancing Old Boys Vets,2,1,4.0,3
16393108,Old Carthusians,Old Etonians,1,1,4.0,2
16393115,Old Harrovians,Old Foresters,2,1,4.0,3
16393071,Old Marlburians,Old Brentwoods,7,3,2.0,10
16393065,Old Salopians,Lancing Old Boys,5,3,4.0,8
16393061,KCS Old Boys,Old Tonbridgians,2,3,4.0,5
16394111,Old Wellingtonians,Old Millfieldians,3,1,3.0,4
16394127,Old Aldenhamians,Old Chigwellians,0,2,2.0,2
16394155,Old Reptonians,Old Bradfieldians,1,3,3.0,4
16394131,Old Malvernians,Old Radleians,2,1,4.0,3
16412539,Old Etonians II,Old Carthusians III,1,3,3.0,4
16434382,Old Brentwoods II,Old Cholmeleians III,1,2,4.0,3
16589216,Old Rugbeians,Kings College Wimbledon III,2,0,2.0,2
16589210,Old Alleynians AFC II,Old Harrovians III,3,5,4.0,8
16951351,Old Etonians,Old Carthusians,1,1,4.0,2
16968921,Old Alleynians AFC,Old Sennockians,2,0,2.0,2
16968915,Old Eastbournians,Old Westminsters,1,4,2.0,5
16968925,Old Merchant Taylors,Old Berkhamstedians,0,4,1.0,4
16393110,Old Brentwoods,Lancing Old Boys,1,0,3.0,1
16393073,Old Etonians,Old Tonbridgians,4,1,2.0,5
16393104,Old Carthusians,KCS Old Boys,7,1,0.0,8
16394102,Old Wykehamists,Old Cholmeleians,5,1,2.0,6
16394066,Old Reptonians,Old Millfieldians,0,3,2.0,3
16394136,Old Chigwellians,Old Wellingtonians,2,1,4.0,3
16394125,Old Radleians,Old Aldenhamians,3,1,3.0,4
16412550,Lancing Old Boys II,Old Carthusians II,2,2,5.0,4
16412571,Old Carthusians III,Old Westminsters,3,3,5.0,6
16412555,Old Etonians II,Old Sennockians,2,0,2.0,2
16412510,Kings College Wimbledon II,Old Foresters II,2,2,5.0,4
16413516,Old Eastbournians,Old Salopians II,1,2,4.0,3
16413552,Old Epsomians,Old Chigwellians II,1,2,4.0,3
16413452,Old Haberdashers,Old Merchant Taylors,1,4,2.0,5
16434385,Old Foresters III,Old Brentwoods II,1,3,3.0,4
16434395,Old Chigwellians III,Old Brentwoods III,2,2,5.0,4
16589212,Old Johnians FC,Old Rugbeians,1,2,4.0,3
16589191,Old Amplefordians,Old Malvernians II,5,2,2.0,7
16589224,Old Westminsters II,Old Alleynians AFC II,0,2,2.0,2
16944386,Old Tonbridgians II,Old Merchant Taylors II,4,4,6.0,8
16951766,Old Finchleians,Old Bancroftians AFC,3,0,2.0,3
16412519,Old Haileyburians,Old Berkhamstedians,2,7,0.0,9
16911323,AFC Representative Team,Arthurian League Representative Team,1,1,4.0,2
16773139,Old Harrovians Vets,Old Carthusians Vets,4,2,3.0,6
16393052,Old Foresters,Old Etonians,1,1,4.0,2
16393067,Lancing Old Boys,Old Harrovians,5,0,0.0,5
16393092,Old Salopians,Old Brentwoods,7,1,0.0,8
16393126,KCS Old Boys,Old Marlburians,4,0,1.0,4
16394063,Old Aldenhamians,Old Wellingtonians,1,1,4.0,2
16394099,Old Chigwellians,Old Bradfieldians,2,0,2.0,2
16394110,Old Reptonians,Old Cholmeleians,2,1,4.0,3
16412525,Old Foresters II,Old Etonians II,1,0,3.0,1
16412512,Old Carthusians III,Old Carthusians II,3,1,3.0,4
16412541,Old Westminsters,Old Sennockians,3,1,3.0,4
16413526,Old Harrovians II,Old Aldenhamians II,4,2,3.0,6
16589199,Old Alleynians AFC II,Old Rugbeians,1,7,0.0,8
16915255,Old Berkhamstedians,Old Bancroftians AFC,4,2,3.0,6
16915260,Old Tonbridgians II,Old Salopians II,2,1,4.0,3
16944376,Old Ardinians,Old Suttonians SV,0,3,2.0,3
16944370,Old Cholmeleians III,Old Johnians FC,1,9,0.0,10
16944392,Old Haberdashers,Old Foresters III,1,0,3.0,1
16944366,Old Chigwellians III,Old Amplefordians,0,2,2.0,2
16944390,Old Columbans,Kings College Wimbledon III,3,1,3.0,4
16944378,Old Merchant Taylors,Old Brentwoods II,4,1,2.0,5
16944368,Old Harrovians III,Old Albanians SA,3,9,0.0,12
16944382,Old Shirburnians,Old Epsomians II,0,2,2.0,2
16944394,Old Stoics,Old Malvernians II,3,2,4.0,5
16944374,Old Westminsters II,Old King's Scholars,5,2,2.0,7
16951741,London Welsh F.C.,Old Malvernians,3,1,3.0,4
16858371,Old Carthusians,Clapham Old Xaverians,5,0,0.0,5
16873788,Old Brentwoods Vets,Old Salopians Vets,3,0,2.0,3
16774924,Old Malvernians Vets,Old Wykehamists Vets,4,0,1.0,4
16393077,Old Brentwoods,Old Foresters,3,2,4.0,5
16393123,Old Salopians,Old Etonians,1,0,3.0,1
16393132,KCS Old Boys,Old Harrovians,3,3,5.0,6
16394126,Old Wykehamists,Old Chigwellians,5,3,4.0,8
16394117,Old Reptonians,Old Malvernians,0,6,0.0,6
16394133,Old Bradfieldians,Old Wellingtonians,4,2,3.0,6
16434427,Old Johnians FC,Kings College Wimbledon III,1,0,3.0,1
16589207,Old Malvernians II,Old Westminsters II,2,2,5.0,4
16858376,Old Berkhamstedians,Old Carthusians,0,3,2.0,3
16915268,Old Eastbournians,Old Wykehamists II,5,3,4.0,8
16915263,Lancing Old Boys II,Old Wellingburians,3,2,4.0,5
16915247,Old Aldenhamians II,Old Carthusians III,1,2,4.0,3
16915272,Old Chigwellians II,Old Merchant Taylors II,2,0,2.0,2
16915253,Old Etonians II,Old Rugbeians,1,2,4.0,3
16915264,Old Harrovians II,Old Brentwoods III,7,1,0.0,8
16915275,Old Merchant Taylors,Old Epsomians,3,1,3.0,4
16915251,Old Sennockians,Old Shirburnians,5,2,2.0,7
16915267,Old Stoics,Old Alleynians AFC,2,3,4.0,5
16915259,Old Westminsters,Old Citizens,4,1,2.0,5
16915256,Old Columbans,Old Foresters II,2,1,4.0,3
16915276,Old Epsomians II,Old Alleynians AFC II,1,2,4.0,3
16803327,Old Chigwellians Vets,Lancing Old Boys Vets,0,0,4.0,0
16393047,Old Foresters,Old Harrovians,1,0,3.0,1
16393060,Old Tonbridgians,Old Etonians,0,1,3.0,1
16393119,Old Brentwoods,Old Marlburians,3,0,2.0,3
16393082,KCS Old Boys,Lancing Old Boys,2,4,3.0,6
16394129,Old Aldenhamians,Old Bradfieldians,1,1,4.0,2
16394156,Old Wellingtonians,Old Radleians,2,2,5.0,4
16412557,Old Berkhamstedians,Old Foresters II,6,0,0.0,6
16412517,Old Carthusians III,Old Sennockians,6,0,0.0,6
16413553,Old Epsomians,Old Eastbournians,2,2,5.0,4
16413519,Old Chigwellians II,Old Alleynians AFC,2,0,2.0,2
16413461,Old Suttonians SV,Old Bancroftians AFC,1,5,2.0,6
16413458,Old Wykehamists II,Old Tonbridgians II,3,6,3.0,9
16434403,Old Amplefordians,Old Westminsters II,3,6,3.0,9
16899517,Old Wilsonians,Old Carthusians,1,1,4.0,2
16412569,Old Westminsters,Old Haileyburians,6,2,2.0,8
16757216,Rugby School,Old Rugbeians,0,2,2.0,2
16802836,Old Cholmeleians Vets,Old Westminsters Vets,1,1,4.0,2
16393131,Old Tonbridgians,Old Foresters,0,1,3.0,1
16393114,Old Carthusians,Lancing Old Boys,6,3,3.0,9
16393130,Old Salopians,KCS Old Boys,4,1,2.0,5
16394115,Old Millfieldians,Old Aldenhamians,4,2,3.0,6
16394103,Old Bradfieldians,Old Wykehamists,3,2,4.0,5
16394118,Old Wellingtonians,Old Cholmeleians,3,8,0.0,11
16412564,Old Sennockians,Lancing Old Boys II,0,2,2.0,2
16412565,Kings College Wimbledon II,Old Carthusians II,2,1,4.0,3
16413549,Old Aldenhamians II,Old Salopians II,0,3,2.0,3
16413551,Old Eastbournians,Old Harrovians II,1,3,3.0,4
16413550,Old Epsomians,Old Alleynians AFC,1,4,2.0,5
16413514,Old Citizens,Old Chigwellians II,1,1,4.0,2
16413489,Old Suttonians SV,Old Stoics,6,2,2.0,8
16413478,Old Wykehamists II,Old Haberdashers,4,1,2.0,5
16413498,Old Merchant Taylors,Old Tonbridgians II,2,3,4.0,5
16434432,Old Johnians FC,Old Amplefordians,3,0,2.0,3
16589226,Old Malvernians II,Old Alleynians AFC II,5,2,2.0,7
16858375,Old Brentwoods,Old Reptonians,0,1,3.0,1
16859846,Old Chigwellians,Old Etonians,0,3,2.0,3
16788875,Old Carthusians III,Alleyn Old Boys,1,2,4.0,3
16861558,Old Bancroftians AFC,Old Suttonians,1,0,3.0,1
16899343,Old Etonians II,Old Parmiterians,0,2,2.0,2
16412561,Old Berkhamstedians,Old Haileyburians,15,0,1.0,15
16393112,Old Foresters,Old Marlburians,2,2,5.0,4
16393127,Old Brentwoods,Old Tonbridgians,1,2,4.0,3
16393093,Old Etonians,Old Carthusians,0,5,0.0,5
16394124,Old Malvernians,Old Cholmeleians,5,7,4.0,12
16394070,Old Millfieldians,Old Bradfieldians,0,6,0.0,6
16412530,Old Berkhamstedians,Kings College Wimbledon II,1,4,2.0,5
16412518,Old Foresters II,Old Westminsters,3,0,2.0,3
16413554,Old Salopians II,Old Alleynians AFC,2,5,2.0,7
16413472,Old Haberdashers,Old Bancroftians AFC,4,2,3.0,6
16413453,Old Wykehamists II,Old Suttonians SV,2,6,2.0,8
16589217,Old Alleynians AFC II,Old Malvernians II,7,1,0.0,8
16434429,Old Amplefordians,Old Rugbeians,1,1,4.0,2
16434438,Kings College Wimbledon III,Old Johnians FC,1,6,0.0,7
16434437,Old Harrovians III,Old Westminsters II,1,5,2.0,6
16857591,Old Salopians,Lancing Old Boys,2,1,4.0,3
16788876,Old Vaughanians,Old Aldenhamians II,0,3,2.0,3
16609284,Epsom College 1st XI,Old Epsomians,3,2,4.0,5
16891890,Epsom College 2nd XI,Old Epsomians II,0,0,4.0,0
16773138,Old Etonians Vets,Old Foresters Vets,1,3,3.0,4
16393124,Lancing Old Boys,Old Etonians,2,0,2.0,2
16393084,Old Carthusians,Old Tonbridgians,4,3,4.0,7
16393105,KCS Old Boys,Old Salopians,3,1,3.0,4
16394108,Old Wykehamists,Old Reptonians,5,0,0.0,5
16394085,Old Radleians,Old Millfieldians,2,8,0.0,10
16394145,Old Bradfieldians,Old Chigwellians,3,2,4.0,5
16412547,Old Westminsters,Old Carthusians II,0,4,1.0,4
16412543,Old Etonians II,Old Berkhamstedians,2,3,4.0,5
16413538,Old Eastbournians,Old Aldenhamians II,2,3,4.0,5
16413533,Old Salopians II,Old Citizens,2,4,3.0,6
16413457,Old Haberdashers,Old Cholmeleians II,1,4,2.0,5
16413467,Old Stoics,Old Merchant Taylors,2,2,5.0,4
16434389,Old Merchant Taylors II,Old Cholmeleians III,10,0,0.0,10
16434375,Old Foresters III,Old Brentwoods III,3,0,2.0,3
16589193,Old Johnians FC,Old Westminsters II,0,1,3.0,1
16589195,Old Harrovians III,Old Rugbeians,0,7,0.0,7
16434423,Old Malvernians II,Kings College Wimbledon III,2,3,4.0,5
16412532,Old Haileyburians,Old Sennockians,1,2,4.0,3
16757416,Haileybury College,Old Haileyburians,6,5,5.0,11
16393097,Old Foresters,Old Salopians,2,0,2.0,2
16393136,Old Harrovians,Lancing Old Boys,2,4,3.0,6
16393066,Old Etonians,Old Marlburians,4,0,1.0,4
16394086,Old Wykehamists,Old Aldenhamians,5,0,0.0,5
16394135,Old Radleians,Old Cholmeleians,2,7,0.0,9
16394091,Old Malvernians,Old Bradfieldians,2,5,2.0,7
16394092,Old Wellingtonians,Old Reptonians,2,2,5.0,4
16412556,Old Foresters II,Old Carthusians III,2,2,5.0,4
16412506,Old Sennockians,Old Carthusians II,0,1,3.0,1
16412545,Lancing Old Boys II,Old Etonians II,0,4,1.0,4
16413483,Old Cholmeleians II,Old Suttonians SV,3,6,3.0,9
16413470,Old Stoics,Old Wykehamists II,1,1,4.0,2
16434424,Kings College Wimbledon III,Old Westminsters II,1,2,4.0,3
16725816,Old Chigwellians,Old Merchant Taylors,5,0,0.0,5
16774982,Old Brentwoods,Old Parkonians,0,1,3.0,1
16774983,Old Carthusians,Old Hamptonians,5,1,2.0,6
16788877,Old Thorntonians,Old Aldenhamians II,5,0,0.0,5
16511722,Brentwood School 1st XI,Old Brentwoods,0,0,4.0,0
16511721,Brentwood School 2nd XI,Old Brentwoods II,7,2,0.0,9
16511720,Brentwood School 3rd XI,Old Brentwoods III,1,2,4.0,3
16760712,Old Alleynians AFC,Dulwich College 1st XI,6,0,0.0,6
16760713,Old Alleynians AFC II,Dulwich College 2nd XI,0,0,4.0,0
16380199,"King's College School, Wimbledon 1st XI",KCS Old Boys,1,0,3.0,1
16380198,"King's College School, Wimbledon 2nd XI",Kings College Wimbledon II,5,1,2.0,6
16679858,Old Wykehamists Vets,Old Etonians Vets,2,4,3.0,6
16730720,Old Chigwellians Vets,Old Haileyburians Vets,2,2,5.0,4
16565272,Old Salopians Vets,Old Westminsters Vets,3,6,3.0,9
16394093,Old Bradfieldians,Old Aldenhamians,3,1,3.0,4
16412553,Kings College Wimbledon II,Lancing Old Boys II,2,0,2.0,2
16413536,Old Salopians II,Old Aldenhamians II,4,2,3.0,6
16413494,Old Cholmeleians II,Old Bancroftians AFC,2,2,5.0,4
16413476,Old Merchant Taylors,Old Stoics,3,1,3.0,4
16725815,Lancing Old Boys,Old Harrovians,2,1,4.0,3
16725809,Old Berkhamstedians,Old Malvernians,4,3,4.0,7
16725813,Old Marlburians,Old Salopians,0,6,0.0,6
16743685,Park View,Old Carthusians,0,3,2.0,3
16305253,Old Wykehamists,Old Wykehamists Select,7,6,5.0,13
16772862,Old Wykehamists II,Old Wykehamists Select,7,5,4.0,12
16793677,Old Tonbridgians II,Old Alleynians AFC II,3,2,4.0,5
16412559,Old Sennockians,Old Haileyburians,6,0,0.0,6
16393081,Old Harrovians,Old Salopians,1,5,2.0,6
16393140,Old Tonbridgians,Old Marlburians,1,0,3.0,1
16394128,Old Wykehamists,Old Radleians,7,2,0.0,9
16394079,Old Millfieldians,Old Chigwellians,0,5,0.0,5
16412521,Old Berkhamstedians,Old Etonians II,3,6,3.0,9
16412505,Lancing Old Boys II,Old Westminsters,5,2,2.0,7
16412544,Kings College Wimbledon II,Old Sennockians,2,0,2.0,2
16413537,Old Chigwellians II,Old Harrovians II,2,2,5.0,4
16413540,Old Citizens,Old Epsomians,1,4,2.0,5
16413475,Old Bancroftians AFC,Old Suttonians SV,3,1,3.0,4
16413454,Old Cholmeleians II,Old Wykehamists II,2,2,5.0,4
16413481,Old Stoics,Old Tonbridgians II,2,2,5.0,4
16434373,Old Brentwoods III,Old Chigwellians III,1,1,4.0,2
16434409,Old Harrovians III,Old Malvernians II,4,1,2.0,5
16589205,Old Alleynians AFC II,Kings College Wimbledon III,3,1,3.0,4
16589181,Old Westminsters II,Old Amplefordians,2,2,5.0,4
16725818,Old Reptonians,KCS Old Boys,5,2,2.0,7
16725817,Old Bradfieldians,Old Carthusians,1,6,0.0,7
16725810,Old Brentwoods,Old Cholmeleians,4,2,3.0,6
16725808,Old Foresters,Old Etonians,1,3,3.0,4
16693763,Old Foresters III,Old Rugbeians,1,1,4.0,2
16697855,Old Salopians II,South Bank Cuaco,0,4,1.0,4
16743684,Wood Green Old Boys,Old Malvernians,0,6,0.0,6
16679216,Old Carthusians III,Bealonians,3,1,3.0,4
16759207,Shene Old Grammarians,Old Eastbournians,3,0,2.0,3
16743863,Aldenham School 1st XI,Old Aldenhamians,1,3,3.0,4
16743862,Aldenham School 2nd XI,Old Aldenhamians II,10,1,0.0,11
16565274,Old Brentwoods Vets,Old Carthusians Vets,2,3,4.0,5
16393138,Old Etonians,KCS Old Boys,1,1,4.0,2
16394104,Old Cholmeleians,Old Aldenhamians,9,0,0.0,9
16394151,Old Wykehamists,Old Malvernians,0,1,3.0,1
16394149,Old Millfieldians,Old Reptonians,1,2,4.0,3
16412511,Lancing Old Boys II,Old Berkhamstedians,3,1,3.0,4
16412563,Old Carthusians III,Kings College Wimbledon II,2,1,4.0,3
16413530,Old Eastbournians,Old Chigwellians II,1,3,3.0,4
16413524,Old Citizens,Old Salopians II,9,1,0.0,10
16693762,Old Epsomians II,Old Brentwoods II,4,0,1.0,4
16693754,Old Merchant Taylors II,Old Malvernians II,7,0,0.0,7
16693756,Old Suttonians SV,Old Haberdashers,5,7,4.0,12
16693752,Old Wellingburians,Old Kimboltonians,5,0,0.0,5
16693766,Old Amplefordians,Old Alleynians AFC II,2,3,4.0,5
16693772,Old Stoics,Old Ardinians,5,2,2.0,7
16693764,Old Rugbeians,Old Foresters III,8,0,0.0,8
16693748,Kings College Wimbledon III,Old Wykehamists II,1,2,4.0,3
16693768,Old Johnians FC,Old Merchant Taylors,1,3,3.0,4
16697857,Old Brentwoods,Globe Rangers,5,2,2.0,7
16697858,Old Thorntonians,Old Carthusians,1,4,2.0,5
16697856,Old Salopians,NUFC Oilers,0,1,3.0,1
16743866,Old King's Scholars,Old Bancroftians AFC,1,3,3.0,4
16717561,Old Sennockians,Somerville Old Boys,4,7,3.0,11
16412492,Old Haileyburians,Old Westminsters,1,8,0.0,9
16686009,Old Tonbridgians Vets,Lancing Old Boys Vets,1,5,2.0,6
16393074,Old Foresters,KCS Old Boys,0,2,2.0,2
16393072,Old Brentwoods,Old Carthusians,0,4,1.0,4
16393113,Old Tonbridgians,Old Harrovians,2,0,2.0,2
16393075,Old Salopians,Old Marlburians,3,4,4.0,7
16394089,Old Aldenhamians,Old Millfieldians,6,1,0.0,7
16394074,Old Malvernians,Old Reptonians,3,0,2.0,3
16394152,Old Radleians,Old Bradfieldians,0,1,3.0,1
16412496,Old Westminsters,Old Carthusians III,2,6,2.0,8
16412531,Old Etonians II,Old Carthusians II,1,1,4.0,2
16413535,Old Harrovians II,Old Citizens,3,0,2.0,3
16413508,Old Alleynians AFC,Old Salopians II,6,2,2.0,8
16413545,Old Epsomians,Old Aldenhamians II,5,3,4.0,8
16413468,Old Suttonians SV,Old Tonbridgians II,2,2,5.0,4
16413450,Old Merchant Taylors,Old Cholmeleians II,1,2,4.0,3
16434372,Old Cholmeleians III,Old Chigwellians III,0,5,0.0,5
16434381,Old Foresters III,Old Merchant Taylors II,6,1,0.0,7
16434383,Old Brentwoods III,Old Brentwoods II,0,3,2.0,3
16434416,Old Amplefordians,Old Johnians FC,3,8,0.0,11
16434428,Kings College Wimbledon III,Old Harrovians III,1,4,2.0,5
16693771,Old Ardinians,Old Stoics,0,0,4.0,0
16739537,Old Bancroftians AFC,Old King's Scholars,1,1,4.0,2
16391818,Old Eastbournians,Old Meadonians,2,1,4.0,3
16678849,Old Minchendenians,Old Etonians,3,2,4.0,5
16243551,Winchester College 1st XI,Old Wykehamists,0,1,3.0,1
16243550,Winchester College 2nd XI,Old Wykehamists II,3,1,3.0,4
16393048,Lancing Old Boys,Old Foresters,0,1,3.0,1
16393101,Old Tonbridgians,Old Salopians,2,5,2.0,7
16393134,Old Brentwoods,KCS Old Boys,1,2,4.0,3
16393085,Old Marlburians,Old Harrovians,0,0,4.0,0
16394132,Old Aldenhamians,Old Reptonians,1,2,4.0,3
16394142,Old Chigwellians,Old Cholmeleians,6,1,0.0,7
16394094,Old Millfieldians,Old Malvernians,5,0,0.0,5
16394064,Old Bradfieldians,Old Radleians,4,4,6.0,8
16412508,Old Berkhamstedians,Old Carthusians II,0,2,2.0,2
16412514,Old Sennockians,Old Westminsters,2,1,4.0,3
16413532,Old Citizens,Old Eastbournians,3,4,4.0,7
16413482,Old Bancroftians AFC,Old Stoics,2,0,2.0,2
16693765,Old Alleynians AFC II,Old Amplefordians,4,4,6.0,8
16693757,Old Brentwoods III,Old Chigwellians III,1,0,3.0,1
16693769,Old Cholmeleians II,Old Tonbridgians II,3,4,4.0,7
16693759,Old Cholmeleians III,Old Shirburnians,0,5,0.0,5
16693755,Old Haberdashers,Old Suttonians SV,2,1,4.0,3
16693751,Old Kimboltonians,Old Wellingburians,3,2,4.0,5
16693753,Old Malvernians II,Old Merchant Taylors II,2,3,4.0,5
16693767,Old Merchant Taylors,Old Johnians FC,3,3,5.0,6
16693747,Old Wykehamists II,Kings College Wimbledon III,5,2,2.0,7
16693749,Old Columbans,Old Westminsters II,5,0,0.0,5
16693761,Old Brentwoods II,Old Epsomians II,3,0,2.0,3
16678848,Old Aloysians,Old Carthusians,2,6,2.0,8
16412516,Old Haileyburians,Old Foresters II,4,5,5.0,9
16398290,Eton College 1st XI,Old Etonians,2,1,4.0,3
16398289,Eton College 2nd XI,Old Etonians II,2,2,5.0,4
16530670,Arthurian League Representative Team,Lloyds of London Representative Team,2,0,2.0,2
16565271,Old Malvernians Vets,Old Foresters Vets,1,8,0.0,9
16393122,Old Marlburians,Lancing Old Boys,7,1,0.0,8
16393095,Old Salopians,Old Harrovians,2,3,4.0,5
16394138,Old Reptonians,Old Radleians,4,6,4.0,10
16394098,Old Wellingtonians,Old Chigwellians,1,3,3.0,4
16394075,Old Millfieldians,Old Cholmeleians,0,2,2.0,2
16412500,Old Foresters II,Kings College Wimbledon II,4,3,4.0,7
16412515,Lancing Old Boys II,Old Sennockians,1,1,4.0,2
16412523,Old Carthusians II,Old Westminsters,0,8,0.0,8
16412509,Old Carthusians III,Old Etonians II,1,2,4.0,3
16413531,Old Chigwellians II,Old Salopians II,2,0,2.0,2
16413544,Old Alleynians AFC,Old Citizens,7,2,0.0,9
16413541,Old Harrovians II,Old Epsomians,4,2,3.0,6
16413463,Old Bancroftians AFC,Old Haberdashers,0,1,3.0,1
16434380,Old Cholmeleians III,Old Brentwoods III,0,5,0.0,5
16434377,Old Merchant Taylors II,Old Brentwoods II,7,2,0.0,9
16434388,Old Chigwellians III,Old Foresters III,4,2,3.0,6
16434440,Old Harrovians III,Old Amplefordians,2,5,2.0,7
16589229,Old Rugbeians,Old Alleynians AFC II,1,4,2.0,5
16434413,Kings College Wimbledon III,Old Malvernians II,4,2,3.0,6
16206120,Old Tonbridgians,Old Carthusians,0,4,1.0,4
16658953,Old Aldenhamians II,Old Parmiterians,7,4,3.0,11
16658954,Old Cholmeleians II,Albanian FC,1,7,0.0,8
16679234,Old Malvernians,University of Hertfordshire,5,3,4.0,8
16491295,Old Wimbledonians,Old Stoics,7,1,0.0,8
16662938,Old Owens,Old Etonians,3,2,4.0,5
16565273,Old Reptonians Vets,Old Cholmeleians Vets,2,4,3.0,6
16393091,Old Etonians,Old Harrovians,2,2,5.0,4
16394096,Old Aldenhamians,Old Malvernians,1,3,3.0,4
16394144,Old Reptonians,Old Wykehamists,2,2,5.0,4
16394100,Old Radleians,Old Wellingtonians,3,0,2.0,3
16412504,Lancing Old Boys II,Old Carthusians III,1,1,4.0,2
16412533,Old Westminsters,Old Foresters II,1,0,3.0,1
16412503,Kings College Wimbledon II,Old Etonians II,1,2,4.0,3
16413511,Old Aldenhamians II,Old Eastbournians,2,2,5.0,4
16413548,Old Salopians II,Old Harrovians II,2,3,4.0,5
16413471,Old Suttonians SV,Old Wykehamists II,4,4,6.0,8
16413462,Old Tonbridgians II,Old Merchant Taylors,1,2,4.0,3
16434390,Old Brentwoods II,Old Chigwellians III,1,1,4.0,2
16434376,Old Cholmeleians III,Old Foresters III,4,4,6.0,8
16589186,Old Rugbeians,Old Westminsters II,5,1,2.0,6
16434419,Old Malvernians II,Old Harrovians III,1,1,4.0,2
16206107,Lancing Old Boys,Old Amplefordians,12,1,1.0,13
16206108,Old Brentwoods,Old Alleynians AFC,4,0,1.0,4
16206110,Old Cholmeleians,Old Epsomians,4,2,3.0,6
16206116,Old Kimboltonians,KCS Old Boys,3,6,3.0,9
16206114,Old Sennockians,Old Chigwellians,2,3,4.0,5
16211297,Ibis Eagles,Old Salopians,1,2,4.0,3
16211295,NUFC Oilers,Old Foresters,4,0,1.0,4
16211296,Old Carthusians,Merton,4,1,2.0,5
16578183,Old Merchant Taylors II,Old Bancroftians AFC,1,4,2.0,5
16412522,Old Haileyburians,Old Carthusians II,1,4,2.0,5
16565269,Old Bradfieldians Vets,Old Etonians Vets,1,3,3.0,4
16393135,Old Foresters,Old Carthusians,3,2,4.0,5
16393102,Lancing Old Boys,Old Tonbridgians,3,7,2.0,10
16394105,Old Millfieldians,Old Wellingtonians,3,4,4.0,7
16412538,Old Foresters II,Old Sennockians,0,3,2.0,3
16412485,Old Carthusians II,Lancing Old Boys II,2,3,4.0,5
16413513,Old Harrovians II,Old Chigwellians II,7,2,0.0,9
16413558,Old Epsomians,Old Salopians II,1,1,4.0,2
16413477,Old Tonbridgians II,Old Cholmeleians II,3,0,2.0,3
16413503,Old Merchant Taylors,Old Haberdashers,5,4,5.0,9
16413460,Old Stoics,Old Suttonians SV,5,5,6.0,10
16589183,Old Harrovians III,Old Johnians FC,1,9,0.0,10
16206109,Old Bradfieldians,Old Westminsters,2,0,2.0,2
16206112,Old Reptonians,Old Aldenhamians,5,0,0.0,5
16206119,Old Salopians,Old Eastbournians,5,0,0.0,5
16206105,Old Wykehamists,Old Etonians,1,3,3.0,4
16206106,Old Marlburians,Old Bancroftians AFC,2,1,4.0,3
16206113,Old Radleians,Old Malvernians,3,4,4.0,7
16211286,KCS Old Boys,Dorkinians,0,1,3.0,1
16211285,Old Lyonians,Old Chigwellians,3,2,4.0,5
16658511,Old Sedcopians,Old Brentwoods,2,4,3.0,6
16598522,Old Brentwoods II,UCL Academicals III,3,4,4.0,7
16672865,Kings College Wimbledon II,Old Alleynians AFC,2,6,2.0,8
16412513,Old Etonians II,Old Haileyburians,9,1,0.0,10
16393063,Old Etonians,Lancing Old Boys,2,0,2.0,2
16393098,Old Tonbridgians,KCS Old Boys,2,4,3.0,6
16393106,Old Brentwoods,Old Harrovians,1,1,4.0,2
16393089,Old Marlburians,Old Foresters,0,5,0.0,5
16393120,Old Salopians,Old Carthusians,1,7,0.0,8
16394121,Old Reptonians,Old Wellingtonians,2,0,2.0,2
16394139,Old Wykehamists,Old Bradfieldians,3,0,2.0,3
16394147,Old Millfieldians,Old Radleians,4,4,6.0,8
16394081,Old Cholmeleians,Old Malvernians,3,2,4.0,5
16412488,Kings College Wimbledon II,Old Berkhamstedians,1,5,2.0,6
16413547,Old Eastbournians,Old Alleynians AFC,3,5,4.0,8
16413528,Old Harrovians II,Old Salopians II,3,0,2.0,3
16413465,Old Bancroftians AFC,Old Tonbridgians II,1,0,3.0,1
16413474,Old Wykehamists II,Old Stoics,2,3,4.0,5
16434387,Old Cholmeleians III,Old Brentwoods II,4,1,2.0,5
16434384,Old Merchant Taylors II,Old Chigwellians III,4,2,3.0,6
16434415,Old Johnians FC,Old Malvernians II,3,4,4.0,7
16589192,Old Harrovians III,Old Alleynians AFC II,1,1,4.0,2
16434430,Old Westminsters II,Kings College Wimbledon III,0,2,2.0,2
16211306,Old Suttonians SV,Old Strand Academicals,6,7,5.0,13
16539143,Old Aldenhamians,London Welsh F.C.,0,3,2.0,3
16539154,Old Sennockians,TBC,2,1,4.0,3
16357840,Hale End Athletic,Old Carthusians II,5,0,0.0,5
16635429,Old Carthusians III,Old Wokingians,2,0,2.0,2
16382912,Old Aldenhamians II,Old Manorians,3,2,4.0,5
16578184,Bealonians,Old Foresters III,5,3,4.0,8
16341284,Old Etonians II,Glynn Old Boys II,1,0,3.0,1
16412534,Lancing Old Boys II,Old Haileyburians,0,0,4.0,0
16393094,Old Foresters,Old Brentwoods,2,0,2.0,2
16393055,Lancing Old Boys,Old Carthusians,0,3,2.0,3
16393059,Old Marlburians,Old Salopians,3,1,3.0,4
16393053,Old Harrovians,KCS Old Boys,0,2,2.0,2
16394130,Old Cholmeleians,Old Wellingtonians,1,2,4.0,3
16394148,Old Chigwellians,Old Radleians,4,0,1.0,4
16394137,Old Malvernians,Old Millfieldians,1,1,4.0,2
16412491,Old Berkhamstedians,Old Sennockians,3,1,3.0,4
16412560,Old Westminsters,Old Etonians II,3,2,4.0,5
16412489,Old Carthusians II,Old Carthusians III,1,1,4.0,2
16413529,Old Alleynians AFC,Old Harrovians II,2,1,4.0,3
16413559,Old Chigwellians II,Old Epsomians,2,0,2.0,2
16413486,Old Haberdashers,Old Stoics,2,3,4.0,5
16434386,Old Brentwoods III,Old Merchant Taylors II,2,4,3.0,6
16434394,Old Brentwoods II,Old Foresters III,3,3,5.0,6
16589182,Kings College Wimbledon III,Old Alleynians AFC II,1,2,4.0,3
16223442,Kings College Wimbledon II,Civil Service II,1,8,0.0,9
16223459,Old Aldenhamians II,Old Tiffinians,7,3,2.0,10
16578112,Old Ignatians,Old Cholmeleians II,0,1,3.0,1
16271827,Economicals,Old Salopians II,1,2,4.0,3
16357847,Old Uffingtonians FC,Old Reptonians,3,2,4.0,5
16357841,Old Aldenhamians,New-Magdalen AFC,0,1,3.0,1
16382911,Old Aloysians,Old Chigwellians III,5,2,2.0,7
16341285,Old Esthameians,Old Rugbeians,4,1,2.0,5
16341295,Old Parkonians,Old Merchant Taylors,6,1,0.0,7
16533141,Old Wilsonians,Old Etonians,0,1,3.0,1
16535131,Old Columbans,Old Shirburnians,1,4,2.0,5
16412490,Old Foresters II,Old Haileyburians,5,0,0.0,5
16393087,Old Etonians,Old Salopians,1,1,4.0,2
16393070,Old Harrovians,Old Tonbridgians,1,3,3.0,4
16393058,KCS Old Boys,Old Brentwoods,3,2,4.0,5
16393090,Old Carthusians,Old Marlburians,2,0,2.0,2
16394078,Old Cholmeleians,Old Reptonians,0,4,1.0,4
16394106,Old Chigwellians,Old Millfieldians,1,1,4.0,2
16394116,Old Radleians,Old Wykehamists,0,1,3.0,1
16394109,Old Bradfieldians,Old Malvernians,6,2,2.0,8
16394150,Old Wellingtonians,Old Aldenhamians,1,6,0.0,7
16412527,Old Berkhamstedians,Old Westminsters,5,4,5.0,9
16412507,Lancing Old Boys II,Old Foresters II,3,2,4.0,5
16412551,Old Sennockians,Old Carthusians III,1,5,2.0,6
16413523,Old Aldenhamians II,Old Epsomians,1,6,0.0,7
16413485,Old Bancroftians AFC,Old Cholmeleians II,6,0,0.0,6
16413456,Old Haberdashers,Old Suttonians SV,3,4,4.0,7
16413502,Old Tonbridgians II,Old Wykehamists II,6,0,0.0,6
16434368,Old Brentwoods III,Old Cholmeleians III,2,1,4.0,3
16589178,Old Johnians FC,Old Alleynians AFC II,3,3,5.0,6
16434426,Old Amplefordians,Old Harrovians III,5,2,2.0,7
16223428,AFC Oldsmiths,Old Salopians II,1,2,4.0,3
16223430,Old Carthusians II,Economicals,2,2,5.0,4
16223429,Royal Bank of Scotland,Old Brentwoods II,4,0,1.0,4
16271782,Sinjun Grammarians,Lancing Old Boys,3,2,4.0,5
16340732,Old Foresters,Toby Football Club,1,4,2.0,5
16412540,Old Haileyburians,Kings College Wimbledon II,3,4,4.0,7
16393139,Old Harrovians,Old Carthusians,0,4,1.0,4
16393057,Old Tonbridgians,Old Brentwoods,5,1,2.0,6
16393100,Old Marlburians,KCS Old Boys,1,1,4.0,2
16393099,Old Etonians,Old Foresters,2,4,3.0,6
16394073,Old Aldenhamians,Old Radleians,4,1,2.0,5
16394090,Old Cholmeleians,Old Chigwellians,3,1,3.0,4
16394082,Old Millfieldians,Old Wykehamists,3,4,4.0,7
16394076,Old Wellingtonians,Old Bradfieldians,2,4,3.0,6
16412486,Old Foresters II,Old Berkhamstedians,3,1,3.0,4
16412498,Lancing Old Boys II,Kings College Wimbledon II,2,1,4.0,3
16412562,Old Carthusians II,Old Etonians II,3,3,5.0,6
16413542,Old Aldenhamians II,Old Harrovians II,0,4,1.0,4
16413543,Old Alleynians AFC,Old Chigwellians II,4,2,3.0,6
16413560,Old Eastbournians,Old Citizens,0,2,2.0,2
16413501,Old Cholmeleians II,Old Stoics,2,3,4.0,5
16413449,Old Haberdashers,Old Tonbridgians II,3,2,4.0,5
16413490,Old Merchant Taylors,Old Bancroftians AFC,2,2,5.0,4
16434371,Old Merchant Taylors II,Old Brentwoods III,4,1,2.0,5
16434369,Old Foresters III,Old Chigwellians III,1,1,4.0,2
16434408,Old Rugbeians,Old Amplefordians,2,1,4.0,3
16357852,Old Brentwoods II,Hale End Athletic,4,3,4.0,7
16412524,Old Carthusians III,Old Haileyburians,11,0,0.0,11
16239425,Shrewsbury School 1st XI,Old Salopians,2,1,4.0,3
16243221,Shrewsbury School 2nd XI,Old Salopians II,0,4,1.0,4
16393128,Old Harrovians,Old Etonians,1,3,3.0,4
16393079,Lancing Old Boys,Old Marlburians,2,0,2.0,2
16393051,Old Brentwoods,Old Salopians,1,1,4.0,2
16393054,KCS Old Boys,Old Foresters,1,2,4.0,3
16394069,Old Aldenhamians,Old Cholmeleians,2,4,3.0,6
16394113,Old Bradfieldians,Old Millfieldians,0,7,0.0,7
16394071,Old Wykehamists,Old Wellingtonians,3,1,3.0,4
16394114,Old Chigwellians,Old Malvernians,3,0,2.0,3
16394087,Old Radleians,Old Reptonians,1,3,3.0,4
16412528,Old Etonians II,Lancing Old Boys II,1,3,3.0,4
16412487,Old Sennockians,Old Foresters II,4,2,3.0,6
16412552,Old Westminsters,Old Berkhamstedians,1,1,4.0,2
16413521,Old Harrovians II,Old Eastbournians,6,2,2.0,8
16413509,Old Chigwellians II,Old Aldenhamians II,2,0,2.0,2
16413510,Old Salopians II,Old Epsomians,0,3,2.0,3
16413512,Old Citizens,Old Alleynians AFC,1,3,3.0,4
16413496,Old Haberdashers,Old Wykehamists II,4,1,2.0,5
16413480,Old Merchant Taylors,Old Suttonians SV,1,1,4.0,2
16434370,Old Cholmeleians III,Old Merchant Taylors II,2,1,4.0,3
16434421,Old Johnians FC,Old Harrovians III,3,0,2.0,3
16434410,Old Amplefordians,Kings College Wimbledon III,2,2,5.0,4
16434442,Old Malvernians II,Old Rugbeians,2,4,3.0,6
16223465,Civil Service III,Old Westminsters II,7,0,0.0,7
16223445,Old Cholmeleians II,Old Challoners,1,0,3.0,1
16561178,Old Alleynians AFC,Old Brentwoods II,4,2,3.0,6
16252206,Charterhouse School 1st XI,Old Carthusians,2,3,4.0,5
16252204,Charterhouse School 2nd XI,Old Carthusians II,1,4,2.0,5
16252203,Charterhouse School 3rd XI,Old Carthusians III,0,3,2.0,3
16399019,Tonbridge School 1st XI,Old Tonbridgians,1,3,3.0,4
16399018,Tonbridge School 2nd XI,Old Tonbridgians II,0,5,0.0,5
16552781,Old Barryians,Old Brentwoods II,5,0,0.0,5
16393069,Old Foresters,Lancing Old Boys,4,4,6.0,8
16393049,Old Carthusians,Old Brentwoods,3,0,2.0,3
16393050,Old Marlburians,Old Tonbridgians,0,3,2.0,3
16393076,KCS Old Boys,Old Etonians,4,0,1.0,4
16394067,Old Bradfieldians,Old Reptonians,2,1,4.0,3
16394097,Old Cholmeleians,Old Radleians,2,2,5.0,4
16394088,Old Chigwellians,Old Wykehamists,0,2,2.0,2
16394143,Old Malvernians,Old Wellingtonians,1,0,3.0,1
16412570,Old Berkhamstedians,Lancing Old Boys II,1,0,3.0,1
16412495,Old Etonians II,Kings College Wimbledon II,1,1,4.0,2
16412529,Old Foresters II,Old Carthusians II,2,0,2.0,2
16413507,Old Aldenhamians II,Old Citizens,1,2,4.0,3
16413525,Old Alleynians AFC,Old Epsomians,3,2,4.0,5
16413517,Old Chigwellians II,Old Eastbournians,2,4,3.0,6
16413479,Old Bancroftians AFC,Old Wykehamists II,3,4,4.0,7
16413459,Old Cholmeleians II,Old Merchant Taylors,2,3,4.0,5
16413499,Old Stoics,Old Haberdashers,1,2,4.0,3
16434367,Old Brentwoods II,Old Merchant Taylors II,0,0,4.0,0
16434391,Old Brentwoods III,Old Foresters III,7,1,0.0,8
16434412,Old Rugbeians,Old Johnians FC,4,3,4.0,7
16434439,Old Westminsters II,Old Malvernians II,2,2,5.0,4
16211312,Hale End Athletic,Old Millfieldians,2,1,4.0,3
16211303,Old Aldenhamians,Old Pegasonians F.C.,3,1,3.0,4
16211304,Old Tollingtonians,Old Westminsters,2,1,4.0,3
16211302,Old Haileyburians,Old Boilers FC,0,5,0.0,5
16211305,Old Sennockians,Old Challoners,0,0,4.0,0
16223446,Carshalton,Old Carthusians III,3,2,4.0,5
16240769,Harrow School 1st XI,Old Harrovians,0,0,4.0,0
16240768,Harrow School 2nd XI,Old Harrovians II,0,0,4.0,0
16240767,Harrow School 3rd XI,Old Harrovians III,0,0,4.0,0
16393086,Old Salopians,Old Foresters,1,5,2.0,6
16393046,KCS Old Boys,Old Carthusians,1,3,3.0,4
16394154,Old Chigwellians,Old Aldenhamians,3,0,2.0,3
16394065,Old Cholmeleians,Old Wykehamists,1,2,4.0,3
16412482,Old Carthusians II,Old Sennockians,4,1,2.0,5
16412566,Old Carthusians III,Old Berkhamstedians,3,1,3.0,4
16412484,Old Westminsters,Kings College Wimbledon II,7,0,0.0,7
16412483,Old Etonians II,Old Foresters II,2,0,2.0,2
16413534,Old Alleynians AFC,Old Eastbournians,2,1,4.0,3
16413522,Old Chigwellians II,Old Citizens,1,0,3.0,1
16413506,Old Epsomians,Old Harrovians II,4,1,2.0,5
16413493,Old Suttonians SV,Old Haberdashers,2,6,2.0,8
16413504,Old Tonbridgians II,Old Bancroftians AFC,4,1,2.0,5
16413495,Old Merchant Taylors,Old Wykehamists II,4,1,2.0,5
16434393,Old Merchant Taylors II,Old Foresters III,4,1,2.0,5
16434366,Old Chigwellians III,Old Cholmeleians III,6,0,0.0,6
16434407,Old Malvernians II,Old Amplefordians,1,5,2.0,6
16434404,Old Harrovians III,Kings College Wimbledon III,0,4,1.0,4
16434405,Old Westminsters II,Old Johnians FC,1,4,2.0,5
16311080,Brentwood School 1st XI,Old Brentwoods,1,5,2.0,6
16311079,Brentwood School 2nd XI,Old Brentwoods II,0,4,1.0,4
16173509,Lancing College 1st XI,Lancing Old Boys,3,0,2.0,3
16424346,Marlborough College 1st XI,Old Marlburians,0,9,0.0,9
16153999,Old Harrovians,KCS Old Boys,1,2,4.0,3
16443351,Old Sennockians,Old Amplefordians,6,2,2.0,8
16341177,Old Parmiterians,Old Tonbridgians,6,1,0.0,7
16173508,Old Rugbeians,Old Suttonians SV,5,5,6.0,10
16434328,Old Carthusians,Old Suttonians,0,0,4.0,0
16173522,Old Chigwellians,Old Brentwoods,2,3,4.0,5
16173521,Old Harrovians II,Old Alleynians AFC,1,0,3.0,1
16195968,Old Salopians,Lancing Old Boys,1,4,2.0,5
16196067,Kings College Wimbledon II,Worcester College Old Boys,3,1,3.0,4
16434329,Old Carthusians II,Old Marlburians,1,2,4.0,3
16205461,Repton School 1st XI,Old Reptonians,1,2,4.0,3
16154161,Eton College 1st XI,Old Etonians,3,3,5.0,6
16195967,Lancing Old Boys,Old Hamptonians,2,5,2.0,7
16196079,Kings College Wimbledon III,Kings College Wimbledon II,0,0,4.0,0
16196078,KCS Old Boys,Kings College Wimbledon III,0,0,4.0,0
16196080,KCS Old Boys,Kings College Wimbledon II,0,0,4.0,0
16380131,Old Cholmeleians,Old Garchonians,0,3,2.0,3
16154000,Old Brentwoods,Old Foresters,0,2,2.0,2
16195966,Lancing Old Boys,Corinthian-Casuals,3,3,5.0,6
16303007,Old Salopians,Old Reptonians,2,0,2.0,2
16154706,Old Harrovians,Old Marlburians,5,5,6.0,10
16271790,Old Harrovians II,Old Alleynians AFC,6,4,4.0,10
16154159,Old Etonians,PWC Select XI,3,2,4.0,5
16196019,KCS Old Boys,Old Salopians,4,1,2.0,5
16154747,Old Harrovians,Old Stoics,8,1,0.0,9
16154176,Old Brentwoods,Harold Wood FC,7,1,0.0,8
16154158,Old Etonians,Honourable Artillery Company,1,4,2.0,5
18021103,Herts Senior County League,Arthurian League Representative Team,3,1,3.0,4
17517339,Old Carthusians,Old Foresters,4,3,4.0,7
18230300,Old Chigwellians Vets,Albanian FC,2,1,4.0,3
17517410,Old Salopians,Old Carthusians,4,4,6.0,8
17517347,Old Wykehamists,Old Carthusians,2,2,5.0,4
17517352,KCS Old Boys,Old Foresters,0,3,2.0,3
17507341,Old Aldenhamians,Old Wellingtonians,2,1,4.0,3
17507344,Old Reptonians,Old Berkhamstedians,2,3,4.0,5
17507314,Old Wellingtonians,Old Aldenhamians,0,1,3.0,1
17519463,Old Foresters II,Old Harrovians II,3,1,3.0,4
17519475,Old Westminsters,Old Etonians II,4,1,2.0,5
18222743,Old Columbans,Old Harrovians III,2,1,4.0,3
17517380,Old Tonbridgians,Old Carthusians,3,3,5.0,6
17517387,Old Foresters,Old Salopians,1,1,4.0,2
17519446,Old Westminsters,Kings College Wimbledon II,3,3,5.0,6
17519477,Lancing Old Boys II,Old Foresters II,2,0,2.0,2
17508783,Old Aldenhamians II,Old Sennockians,1,0,3.0,1
17508759,Old Tonbridgians II,Old Salopians II,0,0,4.0,0
17508765,Old Citizens,Old Haberdashers,10,0,0.0,10
17524132,Old Cholmeleians II,Old Foresters III,5,0,0.0,5
18161843,Old Tonbridgians,Old Carthusians,3,3,5.0,6
18191691,Old Alleynians AFC,Old Kimboltonians,2,1,4.0,3
18186744,Old Johnians FC,Old Rugbeians,2,1,4.0,3
18214415,Old Columbans,Old Shirburnians,3,0,2.0,3
18214416,Old Harrovians III,Old Brentwoods III,6,1,0.0,7
18116557,Old Suttonians,Old Etonians II,0,1,3.0,1
17517354,Old Marlburians,Old Carthusians,2,6,2.0,8
18208034,Old Malvernians Vets,Old Foresters Vets,4,2,3.0,6
18207979,Old Haileyburians Vets,Old Bradfieldians Vets,0,1,3.0,1
17517393,Old Foresters,Old Wykehamists,3,0,2.0,3
17517366,Old Carthusians,Old Salopians,0,0,4.0,0
17517399,Old Marlburians,Lancing Old Boys,2,2,5.0,4
17507327,Old Bradfieldians,Old Reptonians,3,1,3.0,4
17507359,Old Malvernians,Old Berkhamstedians,1,0,3.0,1
17519483,Old Harrovians II,Old Radleians,3,5,4.0,8
17519484,Old Westminsters,Old Foresters II,4,4,6.0,8
17519438,Lancing Old Boys II,Kings College Wimbledon II,0,3,2.0,3
17519468,Old Alleynians AFC,Old Etonians II,3,1,3.0,4
17508787,Old Aldenhamians II,Old Chigwellians II,0,2,2.0,2
17508779,Old Eastbournians,Old Sennockians,1,2,4.0,3
17508748,Old Merchant Taylors,Old Tonbridgians II,5,2,2.0,7
17526757,Old Rugbeians,Old Stoics,7,1,0.0,8
17526763,Old Suttonians SV,Old Merchant Taylors II,4,1,2.0,5
17524125,Old Brentwoods III,Old Columbans,1,3,3.0,4
17524126,Old Chigwellians III,Old Cholmeleians II,1,3,3.0,4
17527241,Old Westminsters II,Old Harrovians III,1,4,2.0,5
17527215,Kings College Wimbledon III,Old Amplefordians,2,2,5.0,4
18098816,Old Brentwoods Vets,Old Foresters Vets,1,2,4.0,3
18188179,Old Carthusians Vets,Old Bradfieldians Vets,0,3,2.0,3
18181342,Old Westminsters Vets,Old Haileyburians Vets,3,5,4.0,8
17517364,Old Chigwellians,Old Tonbridgians,1,1,4.0,2
17517382,Old Foresters,KCS Old Boys,4,1,2.0,5
17507358,Old Harrovians,Old Cholmeleians,3,0,2.0,3
17507324,Old Brentwoods,Old Reptonians,4,0,1.0,4
17507357,Old Bradfieldians,Old Aldenhamians,7,1,0.0,8
17519488,Old Carthusians II,Old Etonians II,1,0,3.0,1
17519435,Old Etonians II,Old Carthusians II,1,0,3.0,1
17519465,Old Westminsters,Old Alleynians AFC,2,3,4.0,5
17519428,Old Radleians,Old Carthusians III,8,0,0.0,8
17519456,Kings College Wimbledon II,Old Foresters II,2,2,5.0,4
17508763,Old Salopians II,Old Merchant Taylors,3,3,5.0,6
17508737,Old Citizens,Old Tonbridgians II,9,0,0.0,9
17526745,Old Suttonians SV,Old Rugbeians,1,1,4.0,2
17526765,Old Johnians FC,Old Bancroftians AFC,1,1,4.0,2
17526741,Old Stoics,Old Merchant Taylors II,3,0,2.0,3
17526755,Old Wykehamists II,Old Alleynians AFC II,1,6,0.0,7
17524123,Old Foresters III,Old Columbans,0,4,1.0,4
17524121,Old Chigwellians III,Old Brentwoods III,0,2,2.0,2
17527234,Old Harrovians III,Old Amplefordians,2,1,4.0,3
17527242,Old Epsomians II,Old Westminsters II,2,1,4.0,3
18072064,Old Hamptonians,Old Carthusians,0,1,3.0,1
17517404,Old Carthusians,Old Etonians,2,1,4.0,3
18180527,Old Malvernians Vets,Old Harrovians Vets,6,4,4.0,10
18091583,Old Berkhamstedians Vets,Old Carthusians Vets,0,2,2.0,2
17517368,Lancing Old Boys,KCS Old Boys,3,3,5.0,6
17517356,Old Tonbridgians,Old Etonians,7,1,0.0,8
17517348,Old Chigwellians,Old Carthusians,0,1,3.0,1
17517325,Old Wykehamists,Old Salopians,4,3,4.0,7
17507372,Old Berkhamstedians,Old Cholmeleians,0,5,0.0,5
17507382,Old Reptonians,Old Brentwoods,2,3,4.0,5
17507339,Old Malvernians,Old Bradfieldians,1,4,2.0,5
17519447,Lancing Old Boys II,Old Carthusians II,1,0,3.0,1
17519482,Old Carthusians III,Old Etonians II,0,1,3.0,1
17519423,Kings College Wimbledon II,Old Radleians,2,2,5.0,4
17508709,Old Salopians II,Old Epsomians,0,6,0.0,6
17508713,Old Sennockians,Old Citizens,3,6,3.0,9
17526762,Old Alleynians AFC II,Old Stoics,5,8,3.0,13
17527240,Old King's Scholars,Old Amplefordians,1,2,4.0,3
18138971,Old Harrovians II,Old Kimboltonians,0,2,2.0,2
18160886,Old Foresters II,Old Alleynians AFC,1,2,4.0,3
18173874,Old Harrovians III,Old Johnians FC,1,6,0.0,7
18176093,Old Rugbeians,Old Columbans,4,2,3.0,6
18116070,Old Foresters,Worcester College Old Boys,4,1,2.0,5
18141331,Bancroft's School 1st XI,Old Bancroftians AFC,1,6,0.0,7
18139878,Westminster School 1st XI,Old Westminsters,3,2,4.0,5
18139879,Westminster School 2nd XI,Old Westminsters II,2,1,4.0,3
17517333,Lancing Old Boys,Old Carthusians,0,3,2.0,3
17517377,Old Foresters,Old Tonbridgians,5,1,2.0,6
17517362,Old Wykehamists,KCS Old Boys,5,2,2.0,7
17519416,Old Carthusians III,Old Westminsters,3,3,5.0,6
17519480,Old Alleynians AFC,Kings College Wimbledon II,3,1,3.0,4
17508766,Old Epsomians,Old Sennockians,2,1,4.0,3
17527221,Old Harrovians III,Old Westminsters II,2,4,3.0,6
18133107,Old Alleynians AFC II,Old Johnians FC,1,3,3.0,4
17834414,Ampleforth College 1st XI,Old Amplefordians,1,0,3.0,1
18152378,Bradfield College,Old Bradfieldians,2,3,4.0,5
18141496,Rugby School,Old Rugbeians,0,2,2.0,2
17930304,Arthurian League Representative Team,AFC Representative Team,5,5,6.0,10
17517340,Old Etonians,Old Salopians,2,2,5.0,4
17517409,Old Marlburians,Old Chigwellians,0,5,0.0,5
17507345,Old Aldenhamians,Old Harrovians,2,1,4.0,3
17519436,Old Foresters II,Old Westminsters,1,1,4.0,2
17519405,Lancing Old Boys II,Old Carthusians III,5,1,2.0,6
17519406,Old Alleynians AFC,Old Carthusians II,2,1,4.0,3
17519412,Old Etonians II,Old Harrovians II,0,3,2.0,3
17508702,Old Haberdashers,Old Tonbridgians II,4,0,1.0,4
17508715,Old Citizens,Old Chigwellians II,2,3,4.0,5
17508784,Old Epsomians,Old Eastbournians,3,2,4.0,5
17508772,Old Sennockians,Old Salopians II,0,1,3.0,1
17508752,Old Merchant Taylors,Old Aldenhamians II,7,2,0.0,9
17526756,Old Bancroftians AFC,Old Alleynians AFC II,3,1,3.0,4
17526769,Old Wykehamists II,Old Suttonians SV,2,6,2.0,8
17526729,Old Stoics,Old Johnians FC,0,4,1.0,4
17527230,Old Epsomians II,Kings College Wimbledon III,0,1,3.0,1
17527244,Old Shirburnians,Old King's Scholars,1,4,2.0,5
17527207,Kings College Wimbledon III,Old Epsomians II,1,0,3.0,1
18122410,Old Foresters,Old Carthusians,1,2,4.0,3
18133111,Old Tonbridgians,Old Reptonians,2,1,4.0,3
18097367,Old Foresters II,Old Westminsters,2,1,4.0,3
18115441,Old Harrovians III,Old Brentwoods III,3,1,3.0,4
18115121,Old Rugbeians,Old Cholmeleians II,2,0,2.0,2
18101143,Malvern College 1st XI,Old Malvernians,1,2,4.0,3
17526770,Old Wykehamists II,Old Rugbeians,3,2,4.0,5
17517403,Old Foresters,Old Etonians,3,1,3.0,4
17517381,Old Carthusians,Old Marlburians,5,2,2.0,7
17517338,KCS Old Boys,Lancing Old Boys,3,1,3.0,4
17507349,Old Reptonians,Old Cholmeleians,1,1,4.0,2
17507369,Old Malvernians,Old Brentwoods,2,4,3.0,6
17519487,Old Westminsters,Old Carthusians II,3,2,4.0,5
17519464,Old Radleians,Kings College Wimbledon II,1,0,3.0,1
17519449,Old Carthusians III,Old Foresters II,0,2,2.0,2
17508720,Old Chigwellians II,Old Tonbridgians II,1,1,4.0,2
17508767,Old Salopians II,Old Eastbournians,4,3,4.0,7
17508769,Old Aldenhamians II,Old Epsomians,4,1,2.0,5
17526736,Old Bancroftians AFC,Old Johnians FC,2,4,3.0,6
17526747,Old Wykehamists II,Old Stoics,3,2,4.0,5
17526728,Old Merchant Taylors II,Old Rugbeians,2,2,5.0,4
17524118,Old Brentwoods II,Old Columbans,0,5,0.0,5
17524135,Old Foresters III,Old Brentwoods III,1,6,0.0,7
17524103,Old Albanians SA,Old Cholmeleians II,3,3,5.0,6
17527199,Old Amplefordians,Old Shirburnians,0,1,3.0,1
17988379,Old Tonbridgians,Old Salopians,1,0,3.0,1
18083283,Lancing Old Boys II,Old Alleynians AFC,0,9,0.0,9
18083131,Old Kimboltonians,Old Etonians II,3,2,4.0,5
18097639,Old Citizens,Old Harrovians II,1,6,0.0,7
18115149,Old Alleynians AFC II,Old Suttonians SV,7,3,2.0,10
18031867,Old Westminsters Vets,Old Tonbridgians Vets,7,2,0.0,9
17517384,Old Etonians,Old Carthusians,0,3,2.0,3
17517335,Old Tonbridgians,Old Wykehamists,2,3,4.0,5
17517400,Old Salopians,Old Chigwellians,4,1,2.0,5
17507352,Old Reptonians,Old Wellingtonians,3,2,4.0,5
17507328,Old Cholmeleians,Old Brentwoods,1,2,4.0,3
17507304,Old Bradfieldians,Old Berkhamstedians,3,1,3.0,4
17519472,Old Foresters II,Kings College Wimbledon II,3,2,4.0,5
17519461,Lancing Old Boys II,Old Etonians II,2,1,4.0,3
17519448,Old Alleynians AFC,Old Radleians,3,1,3.0,4
17519458,Old Carthusians II,Old Westminsters,4,1,2.0,5
17519485,Old Carthusians III,Old Harrovians II,1,1,4.0,2
17508771,Old Eastbournians,Old Merchant Taylors,2,3,4.0,5
17508712,Old Epsomians,Old Haberdashers,2,1,4.0,3
17508758,Old Sennockians,Old Aldenhamians II,2,3,4.0,5
17526766,Old Wykehamists II,Old Merchant Taylors II,2,8,0.0,10
17526730,Old Alleynians AFC II,Old Bancroftians AFC,1,2,4.0,3
17524111,Old Columbans,Old Albanians SA,5,3,4.0,8
18069253,Old Harrovians III,Old Foresters III,2,2,5.0,4
18069431,Kings College Wimbledon III,Old Stoics,1,2,4.0,3
18052653,Old Cholmeleians II,Old Amplefordians,2,0,2.0,2
18038753,Old Chigwellians III,Old Suttonians SV,3,4,4.0,7
18083215,Old Westminsters II,Old Johnians FC,1,5,2.0,6
18074725,Altis,Old Foresters,2,2,5.0,4
18031182,Old Foresters Vets,Lancing Old Boys Vets,4,3,4.0,7
17517408,Old Chigwellians,Old Etonians,4,5,5.0,9
17517401,KCS Old Boys,Old Marlburians,3,2,4.0,5
17507384,Old Malvernians,Old Harrovians,4,7,3.0,11
17519466,Kings College Wimbledon II,Old Carthusians III,1,2,4.0,3
17508770,Old Chigwellians II,Old Haberdashers,1,0,3.0,1
17508742,Old Citizens,Old Merchant Taylors,2,0,2.0,2
17526768,Old Suttonians SV,Old Johnians FC,1,2,4.0,3
17988377,Lancing Old Boys,Old Foresters,0,2,2.0,2
17988378,Old Carthusians,Old Alleynians AFC,4,1,2.0,5
18009459,Old Westminsters,Old Reptonians,0,3,2.0,3
18083958,Old Harrovians II,Old Sennockians,3,2,4.0,5
18083208,Old Tonbridgians II,Old Foresters II,1,2,4.0,3
18069206,Old King's Scholars,Old Columbans,0,5,0.0,5
18052651,Old Rugbeians,Old Epsomians II,4,1,2.0,5
18052652,Old Merchant Taylors II,Old Brentwoods III,2,3,4.0,5
18031866,Old Bradfieldians Vets,Old Salopians Vets,2,1,4.0,3
18038665,"The King's School, Canterbury",Old King's Scholars,4,1,2.0,5
17517391,Lancing Old Boys,Old Tonbridgians,3,4,4.0,7
17517365,Old Foresters,Old Carthusians,1,1,4.0,2
17517383,Old Salopians,Old Etonians,2,3,4.0,5
17517392,Old Chigwellians,Old Marlburians,3,0,2.0,3
17507376,Old Aldenhamians,Old Brentwoods,3,7,2.0,10
17507325,Old Harrovians,Old Wellingtonians,8,1,0.0,9
17507379,Old Cholmeleians,Old Reptonians,0,4,1.0,4
17507320,Old Bradfieldians,Old Malvernians,6,2,2.0,8
17519424,Old Carthusians II,Old Harrovians II,2,2,5.0,4
17508757,Old Haberdashers,Old Epsomians,5,2,2.0,7
17508768,Old Tonbridgians II,Old Merchant Taylors,1,0,3.0,1
17508788,Old Eastbournians,Old Salopians II,2,2,5.0,4
17526743,Old Bancroftians AFC,Old Stoics,0,4,1.0,4
17526758,Old Wykehamists II,Old Johnians FC,0,7,0.0,7
17524124,Old Brentwoods II,Old Albanians SA,0,2,2.0,2
17524120,Old Foresters III,Old Chigwellians III,0,1,3.0,1
17527200,Old Epsomians II,Old Harrovians III,0,1,3.0,1
18020272,Old Columbans,Old Sennockians,3,4,4.0,7
18052222,Old Merchant Taylors II,Old Alleynians AFC,1,7,0.0,8
18051946,Old Westminsters,Old Rugbeians,2,1,4.0,3
18069130,Old Etonians II,Kings College Wimbledon II,6,1,0.0,7
18052221,Old Alleynians AFC II,Lancing Old Boys II,1,3,3.0,4
18051949,Old Radleians,Old Citizens,2,7,0.0,9
18020266,Old Foresters II,Old Suttonians SV,2,2,5.0,4
18038662,Old Westminsters II,Old Kingstonians KGS,3,1,3.0,4
18035775,KCS Old Boys,Old Actonians Association FC,3,4,4.0,7
17930313,Old Wykehamists Vets,Old Brentwoods Vets,0,2,2.0,2
17966212,Old Malvernians Vets,Old Etonians Vets,3,2,4.0,5
17517372,Old Chigwellians,KCS Old Boys,0,1,3.0,1
17517411,Old Wykehamists,Old Etonians,4,1,2.0,5
17517361,Old Tonbridgians,Old Foresters,1,2,4.0,3
17507332,Old Harrovians,Old Brentwoods,1,4,2.0,5
17507340,Old Reptonians,Old Aldenhamians,6,1,0.0,7
17507356,Old Wellingtonians,Old Berkhamstedians,2,4,3.0,6
17507318,Old Malvernians,Old Cholmeleians,1,1,4.0,2
17519445,Old Radleians,Old Foresters II,1,3,3.0,4
17519478,Old Alleynians AFC,Old Carthusians III,4,1,2.0,5
17519481,Old Carthusians II,Lancing Old Boys II,2,2,5.0,4
17519470,Old Harrovians II,Old Westminsters,1,0,3.0,1
17508738,Old Merchant Taylors,Old Chigwellians II,1,0,3.0,1
17508754,Old Sennockians,Old Tonbridgians II,1,0,3.0,1
17508728,Old Citizens,Old Epsomians,2,0,2.0,2
17526746,Old Rugbeians,Old Merchant Taylors II,3,0,2.0,3
18020273,Kings College Wimbledon II,Old Aldenhamians II,3,2,4.0,5
18038751,Old Albanians SA,Old Stoics,2,3,4.0,5
18038661,Old Bancroftians AFC,Old Harrovians III,1,3,3.0,4
18038752,Old Brentwoods II,Old Johnians FC,2,3,4.0,5
18038755,Old King's Scholars,Old Wykehamists II,5,1,2.0,6
18038754,Old Alleynians AFC II,Old Shirburnians,4,3,4.0,7
18010962,Clapham Old Xaverians,Old Carthusians,1,4,2.0,5
17987962,Old Etonians II,Bealonians,2,0,2.0,2
17517385,Old Wykehamists,Old Chigwellians,4,1,2.0,5
17517373,Old Tonbridgians,Lancing Old Boys,3,1,3.0,4
17517359,Old Marlburians,Old Foresters,1,2,4.0,3
17517407,KCS Old Boys,Old Salopians,1,2,4.0,3
17507367,Old Berkhamstedians,Old Harrovians,3,5,4.0,8
17507385,Old Wellingtonians,Old Reptonians,2,6,2.0,8
17507323,Old Aldenhamians,Old Bradfieldians,2,8,0.0,10
17524130,Old Albanians SA,Old Brentwoods III,3,1,3.0,4
17524122,Old Cholmeleians II,Old Brentwoods II,3,3,5.0,6
17527239,Old Shirburnians,Old Westminsters II,4,2,3.0,6
17527231,Old Harrovians III,Old King's Scholars,1,1,4.0,2
18020267,Old Merchant Taylors II,Old Haberdashers,6,1,0.0,7
18020290,Old Bancroftians AFC,Old Tonbridgians II,1,6,0.0,7
18020268,Old Chigwellians II,Old Kimboltonians,1,3,3.0,4
18020270,Old Westminsters,Old Stoics,6,1,0.0,7
18020262,Old Alleynians AFC,Old Foresters III,5,1,2.0,6
18020263,Old Carthusians II,Old Alleynians AFC II,1,2,4.0,3
18020271,Old Eastbournians,Old Etonians II,0,2,2.0,2
18020275,Old Rugbeians,Old Epsomians,5,2,2.0,7
18020274,Old Salopians II,Old Carthusians III,2,4,3.0,6
18020265,Old Citizens,Old Wykehamists II,4,2,3.0,6
18020260,Old Merchant Taylors,Old Radleians,2,3,4.0,5
17668164,Old Foresters Vets,Old Haileyburians Vets,4,2,3.0,6
17872838,Old Harrovians Vets,Old Reptonians Vets,5,2,2.0,7
17517386,Lancing Old Boys,Old Chigwellians,0,2,2.0,2
17517379,Old Etonians,Old Foresters,0,4,1.0,4
17517414,Old Salopians,Old Wykehamists,1,2,4.0,3
17507346,Old Berkhamstedians,Old Bradfieldians,2,4,3.0,6
17507306,Old Reptonians,Old Harrovians,2,5,2.0,7
17507383,Old Wellingtonians,Old Cholmeleians,2,2,5.0,4
17507333,Old Malvernians,Old Aldenhamians,2,2,5.0,4
17519479,Old Radleians,Old Etonians II,5,2,2.0,7
17519430,Old Alleynians AFC,Old Foresters II,4,3,4.0,7
17519462,Old Carthusians III,Old Carthusians II,1,0,3.0,1
17519476,Kings College Wimbledon II,Old Westminsters,1,3,3.0,4
17508778,Old Chigwellians II,Old Citizens,5,1,2.0,6
17508707,Old Tonbridgians II,Old Eastbournians,2,1,4.0,3
17508760,Old Aldenhamians II,Old Haberdashers,3,1,3.0,4
17508780,Old Epsomians,Old Merchant Taylors,3,2,4.0,5
17526748,Old Johnians FC,Old Suttonians SV,0,0,4.0,0
17526740,Old Rugbeians,Old Bancroftians AFC,8,0,0.0,8
17526744,Old Merchant Taylors II,Old Alleynians AFC II,0,1,3.0,1
17524119,Old Brentwoods III,Old Cholmeleians II,3,1,3.0,4
17524102,Old Columbans,Old Foresters III,2,1,4.0,3
17527228,Old Harrovians III,Old Epsomians II,1,0,3.0,1
17527235,Old King's Scholars,Kings College Wimbledon III,4,2,3.0,6
17527233,Old Westminsters II,Old Amplefordians,2,1,4.0,3
17953163,Queen Mary College Old Boys,KCS Old Boys,3,3,5.0,6
17896317,Old Carthusians,Old Parkonians,3,4,4.0,7
17517397,Old Wykehamists,Lancing Old Boys,0,1,3.0,1
17517390,Old Tonbridgians,Old Chigwellians,3,1,3.0,4
17517336,Old Etonians,Old Marlburians,3,2,4.0,5
17507368,Old Cholmeleians,Old Aldenhamians,5,0,0.0,5
17519425,Old Etonians II,Old Alleynians AFC,0,4,1.0,4
17519426,Old Foresters II,Old Carthusians II,2,1,4.0,3
17519429,Old Westminsters,Lancing Old Boys II,6,1,0.0,7
17519459,Old Carthusians III,Old Radleians,2,4,3.0,6
17508764,Old Chigwellians II,Old Aldenhamians II,2,2,5.0,4
17508725,Old Merchant Taylors,Old Citizens,2,1,4.0,3
17508739,Old Salopians II,Old Haberdashers,4,1,2.0,5
17508762,Old Eastbournians,Old Tonbridgians II,1,1,4.0,2
17526727,Old Alleynians AFC II,Old Suttonians SV,3,2,4.0,5
17526760,Old Merchant Taylors II,Old Stoics,1,5,2.0,6
17524128,Old Columbans,Old Cholmeleians II,4,1,2.0,5
17527198,Kings College Wimbledon III,Old Westminsters II,2,6,2.0,8
17844623,Old Reptonians,Old Sennockians,9,1,0.0,10
17953155,Old Foresters,Icarus,3,1,3.0,4
17964665,Old Minchendenians,Old Carthusians,0,2,2.0,2
17553453,"King's College School, Wimbledon 1st XI",KCS Old Boys,0,6,0.0,6
17553454,"King's College School, Wimbledon 2nd XI",Kings College Wimbledon II,1,3,3.0,4
17793104,St. John's School,Old Johnians FC,0,0,4.0,0
17551072,Old Brentwoods,Brentwood School 1st XI,2,1,4.0,3
17551073,Old Brentwoods II,Brentwood School 2nd XI,4,2,3.0,6
17551074,Old Brentwoods III,Brentwood School 3rd XI,6,0,0.0,6
17551075,Old Brentwoods IV,Brentwood School 4th XI,0,0,4.0,0
17551076,Old Brentwoods Vets,Brentwood School 5th XI,0,0,4.0,0
17984659,Old Epsomians,Old Epsomians II,2,2,5.0,4
17668168,Old Tonbridgians Vets,Old Etonians Vets,2,4,3.0,6
17668167,Old Salopians Vets,Old Chigwellians Vets,2,6,2.0,8
17517363,KCS Old Boys,Old Etonians,3,3,5.0,6
17519474,Old Radleians,Old Alleynians AFC,1,0,3.0,1
17519420,Old Carthusians II,Old Carthusians III,7,1,0.0,8
17508719,Old Aldenhamians II,Old Citizens,2,2,5.0,4
17524109,Old Brentwoods II,Old Foresters III,2,1,4.0,3
17527226,Old Westminsters II,Old Shirburnians,2,5,2.0,7
17854117,Lancing Old Boys,Old Merchant Taylors,5,0,0.0,5
17844626,Old Suttonians SV,Old Westminsters,3,7,2.0,10
17844622,Old Salopians,Old Berkhamstedians,6,0,0.0,6
17844624,Old Tonbridgians,Old Aldenhamians,8,2,0.0,10
17901822,Old Albanians SA,Old Kimboltonians,2,5,2.0,7
17881842,Old Wykehamists,Winchester College 1st XI,1,1,4.0,2
17517345,Old Chigwellians,Old Salopians,3,2,4.0,5
17517376,Lancing Old Boys,Old Wykehamists,4,2,3.0,6
17517367,Old Tonbridgians,KCS Old Boys,0,2,2.0,2
17507312,Old Brentwoods,Old Berkhamstedians,3,2,4.0,5
17507351,Old Harrovians,Old Malvernians,6,2,2.0,8
17519453,Old Foresters II,Lancing Old Boys II,2,0,2.0,2
17519454,Old Harrovians II,Old Carthusians III,1,2,4.0,3
17519455,Old Radleians,Old Carthusians II,5,7,4.0,12
17519450,Old Etonians II,Kings College Wimbledon II,0,3,2.0,3
17508736,Old Aldenhamians II,Old Eastbournians,4,3,4.0,7
17508722,Old Merchant Taylors,Old Epsomians,0,1,3.0,1
17508710,Old Sennockians,Old Chigwellians II,0,2,2.0,2
17526759,Old Johnians FC,Old Rugbeians,3,1,3.0,4
17526761,Old Wykehamists II,Old Bancroftians AFC,2,2,5.0,4
17844627,Old Carthusians,Old Bradfieldians,1,0,3.0,1
17854211,Old Alleynians AFC,Old Etonians,2,0,2.0,2
17792841,Old Suttonians SV,Old Cholmeleians II,6,4,4.0,10
17925484,Old Amplefordians,Old Ardinians,1,1,4.0,2
17787567,Old Aldenhamians,Worcester College Old Boys,0,2,2.0,2
17780304,Putney Saint-Germain,Old Westminsters,6,0,0.0,6
17787579,Old Foresters,Old Kingsburians,7,1,0.0,8
17877649,Spaniards,Old Reptonians,1,0,3.0,1
17517370,Old Foresters,Old Chigwellians,1,0,3.0,1
17517371,Old Salopians,Old Tonbridgians,2,2,5.0,4
17517406,Old Wykehamists,Old Marlburians,5,2,2.0,7
17507371,Old Reptonians,Old Bradfieldians,1,3,3.0,4
17507319,Old Aldenhamians,Old Berkhamstedians,4,3,4.0,7
17507347,Old Malvernians,Old Wellingtonians,4,2,3.0,6
17519451,Old Westminsters,Old Harrovians II,5,0,0.0,5
17519467,Lancing Old Boys II,Old Radleians,0,4,1.0,4
17519439,Old Carthusians II,Old Alleynians AFC,1,1,4.0,2
17508755,Old Chigwellians II,Old Merchant Taylors,4,0,1.0,4
17508751,Old Haberdashers,Old Eastbournians,4,1,2.0,5
17508726,Old Tonbridgians II,Old Sennockians,3,1,3.0,4
17508750,Old Epsomians,Old Citizens,3,6,3.0,9
17508781,Old Salopians II,Old Aldenhamians II,1,1,4.0,2
17526767,Old Bancroftians AFC,Old Rugbeians,0,2,2.0,2
17526742,Old Suttonians SV,Old Alleynians AFC II,4,2,3.0,6
17524131,Old Chigwellians III,Old Brentwoods II,1,1,4.0,2
17524099,Old Columbans,Old Brentwoods III,1,5,2.0,6
17527206,Old Westminsters II,Old Epsomians II,5,0,0.0,5
17801978,Kings College Wimbledon III,Old Foresters III,2,4,3.0,6
17834402,Old Carthusians,Polytechnic,0,3,2.0,3
17834403,Old Thorntonians,Old Etonians,2,0,2.0,2
17862264,Winchmore Hill,Old Brentwoods,1,0,3.0,1
17834404,KCS Old Boys,UCL Academicals,5,1,2.0,6
17817305,Old Etonians II,Old Tenisonians,1,0,3.0,1
17909283,Arthurian League Representative Team,Southern Amateur League Rep XI,1,1,4.0,2
17925483,Old Kingstonians KGS,Old Ardinians,0,0,4.0,0
17792768,Old Kingstonians KGS,Old Ardinians,2,3,4.0,5
17517349,Old Foresters,Lancing Old Boys,4,1,2.0,5
17517350,Old Salopians,Old Marlburians,2,2,5.0,4
17517375,KCS Old Boys,Old Carthusians,1,1,4.0,2
17517351,Old Wykehamists,Old Tonbridgians,0,3,2.0,3
17507296,Old Aldenhamians,Old Cholmeleians,2,4,3.0,6
17507374,Old Reptonians,Old Malvernians,3,1,3.0,4
17507307,Old Bradfieldians,Old Brentwoods,2,1,4.0,3
17507338,Old Harrovians,Old Berkhamstedians,1,5,2.0,6
17519489,Old Foresters II,Old Carthusians III,3,1,3.0,4
17519444,Old Harrovians II,Lancing Old Boys II,2,1,4.0,3
17519422,Old Radleians,Old Westminsters,1,3,3.0,4
17508723,Old Chigwellians II,Old Salopians II,4,0,1.0,4
17508773,Old Tonbridgians II,Old Citizens,1,2,4.0,3
17508747,Old Epsomians,Old Aldenhamians II,1,1,4.0,2
17508749,Old Sennockians,Old Eastbournians,4,2,3.0,6
17508718,Old Merchant Taylors,Old Haberdashers,7,1,0.0,8
17526753,Old Johnians FC,Old Stoics,1,0,3.0,1
17526750,Old Alleynians AFC II,Old Merchant Taylors II,4,2,3.0,6
17526733,Old Rugbeians,Old Wykehamists II,2,0,2.0,2
17524127,Old Brentwoods III,Old Brentwoods II,2,1,4.0,3
17524110,Old Cholmeleians II,Old Chigwellians III,2,4,3.0,6
17527224,Old Westminsters II,Kings College Wimbledon III,1,1,4.0,2
17497894,Eton College 1st XI,Old Etonians,0,3,2.0,3
17497895,Eton College 2nd XI,Old Etonians II,0,3,2.0,3
17517342,Old Salopians,Old Foresters,1,3,3.0,4
17517358,Lancing Old Boys,Old Etonians,1,1,4.0,2
17517344,KCS Old Boys,Old Tonbridgians,1,1,4.0,2
17507300,Old Berkhamstedians,Old Aldenhamians,3,0,2.0,3
17507361,Old Wellingtonians,Old Brentwoods,2,6,2.0,8
17507342,Old Harrovians,Old Bradfieldians,1,2,4.0,3
17519442,Old Westminsters,Old Radleians,2,4,3.0,6
17519443,Old Carthusians III,Old Alleynians AFC,1,5,2.0,6
17519432,Old Etonians II,Lancing Old Boys II,4,2,3.0,6
17519441,Old Harrovians II,Old Foresters II,5,1,2.0,6
17508744,Old Haberdashers,Old Sennockians,2,8,0.0,10
17508745,Old Tonbridgians II,Old Epsomians,1,0,3.0,1
17508743,Old Eastbournians,Old Chigwellians II,1,4,2.0,5
17508741,Old Aldenhamians II,Old Salopians II,1,3,3.0,4
17526764,Old Alleynians AFC II,Old Rugbeians,2,4,3.0,6
17526720,Old Suttonians SV,Old Bancroftians AFC,7,0,0.0,7
17527196,Old King's Scholars,Old Harrovians III,1,7,0.0,8
17527223,Old Shirburnians,Old Amplefordians,6,2,2.0,8
17792840,Old Columbans,Old Johnians FC,2,3,4.0,5
17792824,Old Foresters III,Kings College Wimbledon III,0,0,4.0,0
17792769,Old Wellingburians,Old Kimboltonians,0,6,0.0,6
17787638,Kings Old Boys,Old Brentwoods II,2,0,2.0,2
17787624,Old Manorians,Old Carthusians II,3,2,4.0,5
17802497,Old Wilsonians,Old Carthusians,0,2,2.0,2
17446568,Winchester College 1st XI,Old Wykehamists,2,3,4.0,5
17446569,Winchester College 2nd XI,Old Wykehamists II,1,0,3.0,1
17668169,Old Malvernians Vets,Old Bradfieldians Vets,5,4,5.0,9
17517343,Old Tonbridgians,Old Marlburians,4,0,1.0,4
17517405,Old Salopians,Lancing Old Boys,3,5,4.0,8
17517326,Old Carthusians,Old Wykehamists,0,0,4.0,0
17517360,Old Etonians,Old Chigwellians,1,0,3.0,1
17507381,Old Berkhamstedians,Old Malvernians,3,1,3.0,4
17507311,Old Bradfieldians,Old Cholmeleians,4,1,2.0,5
17507354,Old Brentwoods,Old Harrovians,2,3,4.0,5
17519440,Old Etonians II,Old Carthusians III,1,1,4.0,2
17519437,Old Radleians,Old Harrovians II,3,2,4.0,5
17519457,Lancing Old Boys II,Old Alleynians AFC,2,8,0.0,10
17519400,Kings College Wimbledon II,Old Carthusians II,0,5,0.0,5
17508756,Old Citizens,Old Eastbournians,4,1,2.0,5
17508785,Old Merchant Taylors,Old Salopians II,0,1,3.0,1
17508740,Old Sennockians,Old Epsomians,2,3,4.0,5
17526751,Old Stoics,Old Bancroftians AFC,1,3,3.0,4
17527216,Old Epsomians II,Old Shirburnians,1,7,0.0,8
17527218,Old Westminsters II,Old King's Scholars,3,2,4.0,5
17792844,Old Alleynians AFC II,Old Brentwoods III,2,2,5.0,4
17816220,Old Cholmeleians II,Albanian FC,2,4,3.0,6
17861520,Old Manorians,Old Foresters II,5,3,4.0,8
17854817,Heathrow Seniors,Old Aldenhamians,3,2,4.0,5
17854986,Old Tollingtonians,Old Reptonians,2,3,4.0,5
17851093,UCL Academicals IV,Old Tonbridgians II,11,1,0.0,12
17834447,Waltham Abbey,Old Foresters,3,0,2.0,3
17685554,Old Westminsters Vets,KCS Old Boys Vets,5,2,2.0,7
17517374,Old Wykehamists,Old Foresters,0,4,1.0,4
17517346,Old Marlburians,Old Etonians,1,2,4.0,3
17517396,Old Tonbridgians,Old Salopians,6,1,0.0,7
17517357,KCS Old Boys,Old Chigwellians,2,0,2.0,2
17507353,Old Aldenhamians,Old Malvernians,3,1,3.0,4
17507350,Old Berkhamstedians,Old Brentwoods,3,2,4.0,5
17507375,Old Wellingtonians,Old Bradfieldians,3,4,4.0,7
17519452,Old Etonians II,Old Westminsters,1,1,4.0,2
17519427,Old Harrovians II,Kings College Wimbledon II,2,1,4.0,3
17519469,Old Carthusians II,Old Foresters II,3,0,2.0,3
17519471,Old Carthusians III,Lancing Old Boys II,2,0,2.0,2
17508733,Old Haberdashers,Old Aldenhamians II,4,2,3.0,6
17508735,Old Salopians II,Old Tonbridgians II,2,6,2.0,8
17508731,Old Eastbournians,Old Citizens,0,3,2.0,3
17508732,Old Epsomians,Old Chigwellians II,2,3,4.0,5
17508734,Old Merchant Taylors,Old Sennockians,1,1,4.0,2
17524097,Old Albanians SA,Old Foresters III,2,1,4.0,3
17527250,Old Amplefordians,Old Harrovians III,1,4,2.0,5
17811591,Lancing Old Boys,Old Kimboltonians,3,0,2.0,3
17811587,Old Alleynians AFC,Old Harrovians,4,3,4.0,7
17792817,Old Brentwoods II,Old Stoics,0,4,1.0,4
17792822,Old Brentwoods III,Old Alleynians AFC II,0,2,2.0,2
17792819,Old Cholmeleians II,Old Suttonians SV,4,3,4.0,7
17792818,Old Johnians FC,Old Columbans,2,4,3.0,6
17792815,Old King's Scholars,Old Wykehamists II,0,3,2.0,3
17792842,Old Rugbeians,Old Shirburnians,1,0,3.0,1
17758597,Old Tenisonians,Old Carthusians,1,2,4.0,3
17700027,Old Reptonians,Globe Rangers,3,1,3.0,4
17517337,Lancing Old Boys,Old Marlburians,2,1,4.0,3
17507321,Old Harrovians,Old Reptonians,3,0,2.0,3
17519433,Old Alleynians AFC,Lancing Old Boys II,4,1,2.0,5
17508727,Old Aldenhamians II,Old Tonbridgians II,1,9,0.0,10
17508729,Old Haberdashers,Old Chigwellians II,0,4,1.0,4
17508730,Old Merchant Taylors,Old Eastbournians,2,0,2.0,2
17508746,Old Citizens,Old Salopians II,4,0,1.0,4
17526732,Old Merchant Taylors II,Old Johnians FC,3,5,4.0,8
17526725,Old Stoics,Old Suttonians SV,2,3,4.0,5
17524115,Old Albanians SA,Old Chigwellians III,2,2,5.0,4
17524116,Old Brentwoods II,Old Brentwoods III,3,3,5.0,6
17524117,Old Foresters III,Old Cholmeleians II,4,2,3.0,6
17527211,Old Harrovians III,Old Shirburnians,3,1,3.0,4
17527209,Old Amplefordians,Old Westminsters II,3,1,3.0,4
17527219,Kings College Wimbledon III,Old King's Scholars,2,3,4.0,5
17493089,Old Westminsters,Old Epsomians,9,1,0.0,10
17493100,Old Sennockians,Old Cholmeleians,2,1,4.0,3
17427144,Bank of England,Old Etonians,0,2,2.0,2
17427145,Old Brentwoods,Old Salopians,3,0,2.0,3
17427146,Old Chigwellians,Winchmore Hill,0,1,3.0,1
17427143,Old Carthusians,Old Woodhouseians,9,1,0.0,10
17427218,KCS Old Boys,Old Bromleians,2,1,4.0,3
17736411,Old Sedcopians,Old Berkhamstedians,4,0,1.0,4
17708068,Old Strand Academicals,Old Aldenhamians,3,5,4.0,8
17700026,Old Tollingtonians,Old Malvernians,5,2,2.0,7
17516164,Old Foresters,Hedinghams United,6,1,0.0,7
17713334,Arthurian League Representative Team,Royal Navy Development XI,1,1,4.0,2
17507377,Old Berkhamstedians,Old Wellingtonians,4,0,1.0,4
17507331,Old Cholmeleians,Old Bradfieldians,1,5,2.0,6
17519473,Old Harrovians II,Old Carthusians II,1,2,4.0,3
17519434,Old Carthusians III,Kings College Wimbledon II,0,2,2.0,2
17508753,Old Salopians II,Old Chigwellians II,2,4,3.0,6
17508724,Old Eastbournians,Old Haberdashers,4,3,4.0,7
17508761,Old Citizens,Old Sennockians,4,3,4.0,7
17526716,Old Merchant Taylors II,Old Suttonians SV,1,3,3.0,4
17524112,Old Albanians SA,Old Brentwoods II,2,2,5.0,4
17524113,Old Brentwoods III,Old Foresters III,4,1,2.0,5
17524134,Old Columbans,Old Chigwellians III,8,0,0.0,8
17527236,Old Shirburnians,Old Epsomians II,0,3,2.0,3
17527203,Kings College Wimbledon III,Old Harrovians III,2,4,3.0,6
17493098,Old Aldenhamians,Old Rugbeians,5,3,4.0,8
17493090,Old Bancroftians AFC,Old Reptonians,1,4,2.0,5
17493096,Old Brentwoods,Old Salopians,0,4,1.0,4
17493093,Old Foresters,Old Wykehamists,2,0,2.0,2
17493095,Old Kimboltonians,Lancing Old Boys,1,1,4.0,2
17493099,Old Harrovians,Old Alleynians AFC,1,1,4.0,2
17493097,Old Chigwellians,Old Merchant Taylors,2,3,4.0,5
17493094,Old Radleians,Old Carthusians,1,9,0.0,10
17493102,Old Tonbridgians,Old Malvernians,2,1,4.0,3
17493091,Old Etonians,KCS Old Boys,3,2,4.0,5
17484020,Mill Hill Village,Old Foresters II,0,3,2.0,3
17427445,Old Aldenhamians II,Alleyn Old Boys,2,6,2.0,8
17736469,Old Meadonians,Old Tonbridgians II,4,5,5.0,9
17430489,Old Etonians II,Enfield Old Grammarians,5,2,2.0,7
17493101,Old Bradfieldians,Old Eastbournians,2,0,2.0,2
17517402,Old Chigwellians,Lancing Old Boys,2,0,2.0,2
17517355,Old Salopians,KCS Old Boys,2,1,4.0,3
17517369,Old Etonians,Old Wykehamists,1,2,4.0,3
17517334,Old Marlburians,Old Tonbridgians,2,3,4.0,5
17507298,Old Brentwoods,Old Malvernians,3,1,3.0,4
17507366,Old Wellingtonians,Old Harrovians,0,3,2.0,3
17507335,Old Cholmeleians,Old Berkhamstedians,1,3,3.0,4
17519419,Lancing Old Boys II,Old Harrovians II,2,1,4.0,3
17519421,Old Foresters II,Old Etonians II,1,2,4.0,3
17519418,Kings College Wimbledon II,Old Alleynians AFC,1,3,3.0,4
17508721,Old Haberdashers,Old Salopians II,3,1,3.0,4
17508786,Old Tonbridgians II,Old Chigwellians II,0,3,2.0,3
17508775,Old Citizens,Old Aldenhamians II,3,1,3.0,4
17526718,Old Alleynians AFC II,Old Johnians FC,1,2,4.0,3
17526726,Old Stoics,Old Wykehamists II,4,3,4.0,7
17524096,Old Foresters III,Old Brentwoods II,0,4,1.0,4
17527213,Old King's Scholars,Old Epsomians II,0,3,2.0,3
17493092,Old Amplefordians,Old Suttonians SV,1,4,2.0,5
17667365,Forest Green,Old Westminsters,4,7,3.0,11
17708065,Old Aldenhamians,Egbertian FC,7,4,3.0,11
17483993,Spaniards,Old Foresters,0,6,0.0,6
17667367,The Warren First,Old Sennockians,4,3,4.0,7
17430482,Old Carthusians,Old Owens,2,1,4.0,3
17517395,Old Chigwellians,Old Foresters,0,0,4.0,0
17517353,Lancing Old Boys,Old Salopians,2,2,5.0,4
17517388,Old Marlburians,Old Wykehamists,0,1,3.0,1
17517341,Old Etonians,KCS Old Boys,2,2,5.0,4
17507364,Old Brentwoods,Old Bradfieldians,1,2,4.0,3
17507317,Old Harrovians,Old Aldenhamians,7,0,0.0,7
17507308,Old Cholmeleians,Old Wellingtonians,6,1,0.0,7
17507309,Old Malvernians,Old Reptonians,3,2,4.0,5
17519403,Old Westminsters,Old Carthusians III,0,4,1.0,4
17519417,Old Etonians II,Old Radleians,2,3,4.0,5
17519415,Old Alleynians AFC,Old Harrovians II,3,2,4.0,5
17519414,Kings College Wimbledon II,Lancing Old Boys II,3,1,3.0,4
17508717,Old Epsomians,Old Tonbridgians II,2,3,4.0,5
17508777,Old Haberdashers,Old Merchant Taylors,2,5,2.0,7
17508716,Old Eastbournians,Old Aldenhamians II,4,1,2.0,5
17526723,Old Bancroftians AFC,Old Merchant Taylors II,1,2,4.0,3
17526724,Old Rugbeians,Old Alleynians AFC II,2,1,4.0,3
17526739,Old Johnians FC,Old Wykehamists II,5,2,2.0,7
17524106,Old Brentwoods III,Old Albanians SA,5,1,2.0,6
17524107,Old Chigwellians III,Old Foresters III,1,1,4.0,2
17524108,Old Cholmeleians II,Old Columbans,2,3,4.0,5
17527229,Old Shirburnians,Kings College Wimbledon III,7,1,0.0,8
17527245,Old King's Scholars,Old Westminsters II,0,4,1.0,4
17427353,Old Brentwoods II,Old Aloysians,3,2,4.0,5
17427355,Old Salopians II,Old Minchendenians,2,9,0.0,11
17427354,Old Carthusians II,Old Wokingians,1,1,4.0,2
17552887,Economicals,Old Carthusians,0,3,2.0,3
17497889,Old Tonbridgians,Old Ignatians,1,6,0.0,7
17517332,Old Foresters,Old Marlburians,2,0,2.0,2
17517412,Old Carthusians,Old Chigwellians,5,1,2.0,6
17517413,Old Etonians,Lancing Old Boys,2,1,4.0,3
17517331,KCS Old Boys,Old Wykehamists,1,0,3.0,1
17507315,Old Berkhamstedians,Old Reptonians,4,2,3.0,6
17507305,Old Brentwoods,Old Cholmeleians,5,1,2.0,6
17507330,Old Wellingtonians,Old Malvernians,2,1,4.0,3
17507378,Old Bradfieldians,Old Harrovians,5,3,4.0,8
17519413,Old Foresters II,Old Alleynians AFC,0,0,4.0,0
17519410,Lancing Old Boys II,Old Westminsters,2,3,4.0,5
17519411,Old Carthusians II,Old Radleians,2,2,5.0,4
17519460,Old Harrovians II,Old Etonians II,2,5,2.0,7
17508711,Old Chigwellians II,Old Eastbournians,1,3,3.0,4
17508714,Old Tonbridgians II,Old Aldenhamians II,3,3,5.0,6
17508789,Old Sennockians,Old Merchant Taylors,2,1,4.0,3
17526734,Old Bancroftians AFC,Old Wykehamists II,5,1,2.0,6
17526754,Old Rugbeians,Old Suttonians SV,3,0,2.0,3
17526721,Old Johnians FC,Old Merchant Taylors II,1,2,4.0,3
17526722,Old Stoics,Old Alleynians AFC II,4,4,6.0,8
17524104,Old Brentwoods III,Old Chigwellians III,3,1,3.0,4
17524105,Old Columbans,Old Brentwoods II,1,1,4.0,2
17524133,Old Cholmeleians II,Old Albanians SA,1,2,4.0,3
17527202,Old Amplefordians,Old Epsomians II,3,0,2.0,3
17527212,Old Harrovians III,Kings College Wimbledon III,4,1,2.0,5
17527205,Old King's Scholars,Old Shirburnians,2,2,5.0,4
17427669,UCL Academicals IV,Old Foresters III,9,1,0.0,10
17427159,Shrewsbury School 1st XI,Old Salopians,0,5,0.0,5
17427160,Shrewsbury School 2nd XI,Old Salopians II,1,1,4.0,2
17517329,Lancing Old Boys,Old Foresters,0,3,2.0,3
17517330,Old Marlburians,KCS Old Boys,1,0,3.0,1
17507334,Old Brentwoods,Old Aldenhamians,5,0,0.0,5
17507301,Old Cholmeleians,Old Harrovians,2,2,5.0,4
17519409,Old Alleynians AFC,Old Westminsters,1,1,4.0,2
17519486,Old Etonians II,Old Foresters II,1,1,4.0,2
17519408,Kings College Wimbledon II,Old Harrovians II,2,1,4.0,3
17508774,Old Chigwellians II,Old Sennockians,0,2,2.0,2
17508776,Old Epsomians,Old Salopians II,1,2,4.0,3
17508708,Old Haberdashers,Old Citizens,2,2,5.0,4
17526737,Old Merchant Taylors II,Old Wykehamists II,3,1,3.0,4
17526738,Old Suttonians SV,Old Stoics,0,6,0.0,6
17524100,Old Brentwoods II,Old Cholmeleians II,2,2,5.0,4
17524101,Old Chigwellians III,Old Albanians SA,2,4,3.0,6
17527246,Old Shirburnians,Old Harrovians III,0,3,2.0,3
17527237,Old Amplefordians,Kings College Wimbledon III,3,1,3.0,4
17429937,Old Uffingtonians FC,Old Malvernians,2,3,4.0,5
17429938,Witan,Old Berkhamstedians,2,3,4.0,5
17429936,Old Reptonians,Old Magdalenians,8,0,0.0,8
17430011,Old Tonbridgians II,Old Dorkinians,5,1,2.0,6
17430017,Old Aldenhamians II,Enfield Old Grammarians,0,7,0.0,7
17430018,Old Hamptonians,Old Eastbournians,2,1,4.0,3
17430481,Old Etonians,Bealonians,1,3,3.0,4
17473446,Charterhouse School 1st XI,Old Carthusians,0,5,0.0,5
17473447,Charterhouse School 2nd XI,Old Carthusians II,1,0,3.0,1
17473448,Charterhouse School 3rd XI,Old Carthusians III,5,3,4.0,8
17517327,Old Chigwellians,Old Wykehamists,5,0,0.0,5
17517394,Old Carthusians,KCS Old Boys,4,0,1.0,4
17517328,Old Etonians,Old Tonbridgians,2,3,4.0,5
17517378,Old Marlburians,Old Salopians,1,1,4.0,2
17507365,Old Cholmeleians,Old Malvernians,1,1,4.0,2
17507297,Old Bradfieldians,Old Wellingtonians,6,3,3.0,9
17519407,Old Foresters II,Old Radleians,3,1,3.0,4
17519404,Kings College Wimbledon II,Old Etonians II,1,3,3.0,4
17508704,Old Chigwellians II,Old Epsomians,5,0,0.0,5
17508705,Old Salopians II,Old Citizens,3,4,4.0,7
17508706,Old Sennockians,Old Haberdashers,3,2,4.0,5
17526749,Old Merchant Taylors II,Old Bancroftians AFC,3,3,5.0,6
17526719,Old Stoics,Old Rugbeians,1,3,3.0,4
17526752,Old Suttonians SV,Old Wykehamists II,6,0,0.0,6
17526735,Old Johnians FC,Old Alleynians AFC II,3,3,5.0,6
17524129,Old Foresters III,Old Albanians SA,2,4,3.0,6
17524114,Old Chigwellians III,Old Columbans,1,6,0.0,7
17527227,Old Amplefordians,Old King's Scholars,3,2,4.0,5
17427302,Old Aldenhamians,University of Hertfordshire,7,1,0.0,8
17427304,Old Westminsters,Royal Bank of Scotland,3,2,4.0,5
17427303,Worcester College Old Boys,Lancing Old Boys,4,2,3.0,6
17427443,Old Westminsters II,South Bank Cuaco,2,6,2.0,8
17429943,Old Carthusians II,NUFC Oilers,2,3,4.0,5
17551077,Brentwood School 1st XI,Old Brentwoods,1,1,4.0,2
17551078,Brentwood School 2nd XI,Old Brentwoods II,2,0,2.0,2
17551079,Brentwood School 3rd XI,Old Brentwoods III,3,4,4.0,7
17551080,Brentwood School 4th XI,Old Brentwoods IV,1,6,0.0,7
17551081,Brentwood School 5th XI,Old Brentwoods Vets,6,5,5.0,11
17431845,Old Harrovians,Harrow School 1st XI,5,5,6.0,10
17431846,Old Harrovians II,Harrow School 2nd XI,6,6,6.0,12
17431847,Old Harrovians III,Harrow School 3rd XI,7,7,6.0,14
17517389,Old Carthusians,Lancing Old Boys,6,0,0.0,6
17507362,Old Aldenhamians,Old Reptonians,4,1,2.0,5
17507337,Old Brentwoods,Old Wellingtonians,4,2,3.0,6
17519431,Old Carthusians II,Kings College Wimbledon II,4,3,4.0,7
17519401,Old Harrovians II,Old Alleynians AFC,0,6,0.0,6
17519402,Old Radleians,Lancing Old Boys II,6,0,0.0,6
17508700,Old Aldenhamians II,Old Merchant Taylors,1,3,3.0,4
17508782,Old Tonbridgians II,Old Haberdashers,3,0,2.0,3
17508701,Old Eastbournians,Old Epsomians,1,1,4.0,2
17508703,Old Salopians II,Old Sennockians,2,0,2.0,2
17526715,Old Alleynians AFC II,Old Wykehamists II,1,4,2.0,5
17526731,Old Bancroftians AFC,Old Suttonians SV,2,3,4.0,5
17526717,Old Rugbeians,Old Johnians FC,0,1,3.0,1
17524094,Old Albanians SA,Old Columbans,1,3,3.0,4
17524098,Old Brentwoods II,Old Chigwellians III,5,1,2.0,6
17524095,Old Cholmeleians II,Old Brentwoods III,4,3,4.0,7
17527220,Old Epsomians II,Old Amplefordians,0,2,2.0,2
17527195,Kings College Wimbledon III,Old Shirburnians,1,4,2.0,5
17480715,Malvern College 1st XI,Old Malvernians,1,0,3.0,1
17480716,Malvern College 2nd XI,Old Malvernians II,3,2,4.0,5
17516026,Marlborough College 1st XI,Old Marlburians,1,3,3.0,4
17446566,Lancing College 1st XI,Lancing Old Boys,4,7,3.0,11
17446567,Lancing College 2nd XI,Lancing Old Boys II,0,0,4.0,0
17580207,Old Owens,Old Carthusians,1,7,0.0,8
18580144,Old Carthusians,KCS Old Boys,1,2,4.0,3
18682710,Old Westminsters,Old Carthusians II,3,2,4.0,5
19399380,Old Kimboltonians,Old Shirburnians,0,3,2.0,3
18914064,Old Tonbridgians Vets,Lancing Old Boys Vets,1,6,0.0,7
18580285,Old Bradfieldians,Old Carthusians,2,2,5.0,4
18682887,Old Cholmeleians,Old Harrovians,1,2,4.0,3
18682655,Old Westminsters,Kings College Wimbledon II,1,1,4.0,2
19335286,Old Wokingians,Old Johnians FC,1,2,4.0,3
19335281,Old Alleynians AFC,Alexandra Park FC,7,0,0.0,7
18914053,Old Etonians Vets,Old Harrovians Vets,12,1,1.0,13
18682862,Old Reptonians,Old Cholmeleians,1,2,4.0,3
18638431,Old Wellingtonians,Old Sennockians,6,0,0.0,6
19364282,Old Etonians,Old Carthusians,0,3,2.0,3
19363994,Old Etonians II,Old Westminsters,1,3,3.0,4
19398505,Old Kimboltonians,Old Alleynians AFC II,2,3,4.0,5
19323643,Old Aloysians,Old Bradfieldians,3,0,2.0,3
19335289,Old Johnians FC,London Welsh F.C.,5,4,5.0,9
19323621,Old Westminsters II,Old Kingstonians KGS,1,5,2.0,6
18580296,Old Carthusians,Old Chigwellians,0,0,4.0,0
19323622,Old Kingstonians KGS,Old Pauline,5,0,0.0,5
18970250,Southern Amateur League Rep XI,Arthurian League Representative Team,3,1,3.0,4
19355480,Old Malvernians Vets,Old Brentwoods Vets,2,1,4.0,3
19380521,Old Wellingtonians Vets,Old Carthusians Vets,4,1,2.0,5
18580292,Old Tonbridgians,Old Wykehamists,0,3,2.0,3
18682891,Old Radleians,Old Cholmeleians,3,3,5.0,6
18682730,Old Merchant Taylors,Kings College Wimbledon II,1,3,3.0,4
18682684,Old Harrovians II,Lancing Old Boys II,4,5,5.0,9
18682669,Old Westminsters,Old Citizens,2,1,4.0,3
18638444,Old Sennockians,Old Tonbridgians II,2,1,4.0,3
18682802,Old Columbans,Old Harrovians III,1,1,4.0,2
18580206,Old Brentwoods III,Old Cholmeleians II,7,2,0.0,9
18580142,Old Merchant Taylors II,Old Chigwellians III,2,3,4.0,5
19377158,Old Alleynians AFC II,Old Shirburnians,5,0,0.0,5
19354084,Old Meadonians,Old Carthusians,1,3,3.0,4
19323640,Alexandra Park FC,Old Bradfieldians,0,1,3.0,1
19018395,AFC Representative Team,Arthurian League Representative Team,4,0,1.0,4
18580170,Old Brentwoods,Old Wykehamists,3,1,3.0,4
18580249,Old Salopians,Old Etonians,0,1,3.0,1
18682882,Lancing Old Boys,Old Aldenhamians,7,2,0.0,9
18682878,Old Malvernians,Old Berkhamstedians,3,0,2.0,3
18682662,Old Merchant Taylors,Lancing Old Boys II,2,1,4.0,3
18682658,Old Westminsters,Old Chigwellians II,4,1,2.0,5
18638463,Old Rugbeians,Old Salopians II,6,1,0.0,7
18682770,Old Alleynians AFC II,Old Haberdashers,9,2,0.0,11
18682799,Old Columbans,Old Stoics,5,1,2.0,6
18682801,Old Harrovians III,Old Bancroftians AFC,4,0,1.0,4
18580098,Old Merchant Taylors II,Old Brentwoods III,3,3,5.0,6
18580237,Old Foresters III,Old Cholmeleians II,1,1,4.0,2
19387028,Old Kimboltonians,Old King's Scholars,3,0,2.0,3
19387029,Old Shirburnians,Old Albanians SA,3,1,3.0,4
19341639,New Magdalen,Old Cholmeleians,1,0,3.0,1
19335287,Old Johnians FC,Old Dorkinians,3,2,4.0,5
19390810,Old Kingstonians KGS,South Bank Cuaco,2,2,5.0,4
19323633,Old Wokingians,Old Westminsters II,7,2,0.0,9
18580284,Old Carthusians,Old Wykehamists,2,1,4.0,3
18580166,Old Foresters,Old Bradfieldians,1,1,4.0,2
18682679,Old Carthusians II,Old Chigwellians II,6,1,0.0,7
18682654,Old Merchant Taylors,Old Foresters II,4,1,2.0,5
18682697,Old Westminsters,Old Harrovians II,2,2,5.0,4
18682647,Old Citizens,Old Etonians II,0,2,2.0,2
18638429,Old Tonbridgians II,Old Rugbeians,2,2,5.0,4
18638439,Old Sennockians,Old Salopians II,6,1,0.0,7
18638401,Old Wellingtonians,Old Johnians FC,2,1,4.0,3
18682762,Old Eastbournians,Old Harrovians III,1,1,4.0,2
18682794,Old Columbans,Old Haberdashers,5,0,0.0,5
18580187,Old Kimboltonians,Old Foresters III,4,0,1.0,4
18647624,Old Shirburnians,Old Wykehamists II,1,0,3.0,1
19305744,Brentwood School 1st XI,Old Brentwoods,3,0,2.0,3
19305745,Brentwood School 2nd XI,Old Brentwoods II,0,9,0.0,9
19305746,Brentwood School 3rd XI,Old Brentwoods III,0,3,2.0,3
19335222,St Albans School 1st XI,Old Albanians SA,3,4,4.0,7
19301958,Highgate School 1st XI,Old Cholmeleians,1,3,3.0,4
19301959,Highgate School 2nd XI,Old Cholmeleians II,1,2,4.0,3
19226475,Old Parkonians,Old Carthusians,1,4,2.0,5
19335279,Old Alleynians AFC,Weirside Rangers,3,2,4.0,5
18914062,Old Harrovians Vets,Old Wykehamists Vets,4,3,4.0,7
19277683,Old Wellingtonians Vets,Old Berkhamstedians Vets,2,0,2.0,2
18580301,Old Chigwellians,Old Wykehamists,1,0,3.0,1
18580180,Old Tonbridgians,Old Brentwoods,3,3,5.0,6
18580162,Old Carthusians,Old Etonians,1,1,4.0,2
18682836,Lancing Old Boys,Old Harrovians,2,0,2.0,2
18682853,Old Berkhamstedians,Old Aldenhamians,8,0,0.0,8
18682833,Old Malvernians,Old Reptonians,2,0,2.0,2
18682866,Old Marlburians,Old Cholmeleians,0,2,2.0,2
18682693,Old Westminsters,Old Etonians II,5,1,2.0,6
18682682,Kings College Wimbledon II,Old Carthusians II,0,3,2.0,3
18682707,Old Citizens,Old Harrovians II,6,1,0.0,7
18638424,Old Carthusians III,Old Tonbridgians II,4,5,5.0,9
18638403,Old Epsomians,Old Wellingtonians,1,4,2.0,5
18638426,Old Sennockians,Old Johnians FC,1,0,3.0,1
18682796,Old Columbans,Old Bancroftians AFC,4,2,3.0,6
18682800,Old Haberdashers,Old Eastbournians,4,3,4.0,7
18580149,Old Merchant Taylors II,Old Albanians SA,2,1,4.0,3
18647647,Old Westminsters II,Old Wykehamists II,3,2,4.0,5
19340161,Old Shirburnians,Old Harrovians III,1,1,4.0,2
19247624,Bradfield College,Old Bradfieldians,0,0,4.0,0
19052202,Radley College 1st XI,Old Radleians,0,0,4.0,0
19261529,Forest School 1st XI,Old Foresters,0,0,4.0,0
19261530,Forest School 2nd XI,Old Foresters II,0,0,4.0,0
19261531,Forest School 3rd XI,Old Foresters III,1,5,2.0,6
19175549,Old Wykehamists II,TBC,3,2,4.0,5
19323620,Old Kingstonians KGS,Old Dorkinians,6,0,0.0,6
18647642,Old Shirburnians,Old King's Scholars,3,0,2.0,3
18580235,Old Foresters,Old Carthusians,0,2,2.0,2
18580108,Old Brentwoods,Old Chigwellians,5,2,2.0,7
18682803,Old Aldenhamians,Old Alleynians AFC,1,0,3.0,1
18682849,Old Harrovians,Old Cholmeleians,2,2,5.0,4
18682667,Old Carthusians II,Old Foresters II,2,0,2.0,2
18682692,Old Chigwellians II,Old Harrovians II,0,1,3.0,1
18682711,Kings College Wimbledon II,Lancing Old Boys II,0,1,3.0,1
18682701,Old Westminsters,Old Merchant Taylors,5,1,2.0,6
18638417,Old Johnians FC,Old Rugbeians,1,1,4.0,2
18638453,Old Sennockians,Old Wellingtonians,5,2,2.0,7
18682743,Old Brentwoods II,Old Bancroftians AFC,1,1,4.0,2
18682748,Old Harrovians III,Old Suttonians SV,1,4,2.0,5
18647614,Old Kingstonians KGS,Old King's Scholars,0,3,2.0,3
19325506,Old Carthusians,Old Foresters,2,0,2.0,2
19325450,Old Tonbridgians,Old Etonians,0,1,3.0,1
19306462,Old Etonians II,Old Shirburnians,4,2,3.0,6
19340121,Old Wykehamists II,Old Kimboltonians,0,6,0.0,6
19258862,Old Malvernians Vets,Old Chigwellians Vets,3,1,3.0,4
19099145,Sherborne School 1st XI,Old Shirburnians,0,2,2.0,2
18580209,Old Chigwellians,Old Foresters,2,2,5.0,4
18580304,Old Tonbridgians,KCS Old Boys,2,2,5.0,4
18580299,Old Salopians,Old Wykehamists,0,4,1.0,4
18580272,Old Etonians,Old Brentwoods,2,3,4.0,5
18682872,Old Berkhamstedians,Old Radleians,1,2,4.0,3
18682852,Lancing Old Boys,Old Alleynians AFC,0,2,2.0,2
18682690,Old Foresters II,Old Chigwellians II,1,0,3.0,1
18682696,Old Etonians II,Old Citizens,4,0,1.0,4
18638462,Old Epsomians,Old Aldenhamians II,4,3,4.0,7
18638428,Old Johnians FC,Old Wellingtonians,3,1,3.0,4
18682736,Old Alleynians AFC II,Old Eastbournians,7,1,0.0,8
18682751,Old Columbans,Old Suttonians SV,1,2,4.0,3
18682798,Old Haberdashers,Old Harrovians III,2,5,2.0,7
18682738,Old Stoics,Old Brentwoods II,4,2,3.0,6
18580145,Old Chigwellians III,Old Cholmeleians II,1,1,4.0,2
18580229,Old Kimboltonians,Old Brentwoods III,0,0,4.0,0
18647628,Old Amplefordians,Old Kingstonians KGS,2,4,3.0,6
18647630,Old Berkhamstedians II,Old Westminsters II,3,1,3.0,4
19306271,Old Westminsters,Old Carthusians II,2,2,5.0,4
19308063,Old Carthusians,West Wickham,0,0,4.0,0
19257606,Spaniards,Old Cholmeleians,1,2,4.0,3
19321273,Old Minchendenians,Old King's Scholars,1,0,3.0,1
19340128,Rugby School,Old Rugbeians,1,3,3.0,4
19242034,Bancroft's School 1st XI,Old Bancroftians AFC,0,6,0.0,6
19310826,Malvern College 1st XI,Old Malvernians,0,0,4.0,0
19118841,Lloyds of London Representative Team,Arthurian League Representative Team,1,9,0.0,10
18914052,Old Carthusians Vets,Lancing Old Boys Vets,0,2,2.0,2
18914056,Old Harrovians Vets,Old Tonbridgians Vets,2,1,4.0,3
19218744,Old Foresters Vets,Old Brentwoods Vets,1,2,4.0,3
18580244,Old Bradfieldians,KCS Old Boys,3,3,5.0,6
18580185,Old Foresters,Old Tonbridgians,0,1,3.0,1
18580267,Old Salopians,Old Carthusians,1,7,0.0,8
18682860,Old Malvernians,Old Alleynians AFC,1,4,2.0,5
18682885,Old Reptonians,Old Marlburians,0,2,2.0,2
18682673,Old Foresters II,Old Westminsters,3,3,5.0,6
18682687,Lancing Old Boys II,Old Merchant Taylors,3,2,4.0,5
18682675,Old Carthusians II,Old Citizens,4,2,3.0,6
18682656,Kings College Wimbledon II,Old Etonians II,1,3,3.0,4
18638454,Old Tonbridgians II,Old Epsomians,1,2,4.0,3
18682756,Old Suttonians SV,Old Brentwoods II,5,1,2.0,6
18580089,Old Foresters III,Old Chigwellians III,3,6,3.0,9
19305160,Old Amplefordians,Old Kimboltonians,1,5,2.0,6
19236325,Old Shirburnians,Old King's Scholars,1,0,3.0,1
19306363,Old Alleynians AFC II,Old Stoics,2,1,4.0,3
19306267,Old Merchant Taylors II,Old Wykehamists II,2,4,3.0,6
19236570,Putney Saint-Germain,Old Cholmeleians,0,2,2.0,2
19323619,Old Kingstonians KGS,Old Wokingians,5,0,0.0,5
18914063,Old Tonbridgians Vets,Old Carthusians Vets,1,3,3.0,4
19123061,Old Carthusians Vets,Old Tonbridgians Vets,3,1,3.0,4
19329120,Old Chigwellians Vets,Albanian FC,4,1,2.0,5
18580183,Old Chigwellians,Old Brentwoods,5,1,2.0,6
18580258,Old Tonbridgians,Old Carthusians,1,1,4.0,2
18580269,KCS Old Boys,Old Salopians,2,1,4.0,3
18682848,Old Aldenhamians,Old Radleians,2,2,5.0,4
18682883,Old Berkhamstedians,Old Cholmeleians,4,5,5.0,9
18682874,Old Marlburians,Old Malvernians,3,1,3.0,4
18682695,Old Chigwellians II,Kings College Wimbledon II,1,0,3.0,1
18682728,Lancing Old Boys II,Old Foresters II,2,0,2.0,2
18682659,Old Citizens,Old Merchant Taylors,4,2,3.0,6
18682689,Old Etonians II,Old Harrovians II,2,1,4.0,3
18638409,Old Rugbeians,Old Carthusians III,4,1,2.0,5
18638408,Old Epsomians,Old Salopians II,5,0,0.0,5
18682783,Old Brentwoods II,Old Haberdashers,5,0,0.0,5
18682739,Old Alleynians AFC II,Old Bancroftians AFC,2,0,2.0,2
18682780,Old Suttonians SV,Old Columbans,4,7,3.0,11
18682795,Old Harrovians III,Old Eastbournians,5,1,2.0,6
18580161,Old Brentwoods III,Old Merchant Taylors II,0,0,4.0,0
18580219,Old Kimboltonians,Old Cholmeleians II,3,1,3.0,4
18647652,Old Shirburnians,Old Westminsters II,10,3,1.0,13
18647638,Old Amplefordians,Old Wykehamists II,3,3,5.0,6
19134795,Old Foresters,Old Reptonians,1,0,3.0,1
19158114,Old Westminsters,Old Etonians,2,3,4.0,5
19237300,Old Finchleians,Old King's Scholars,3,1,3.0,4
19118842,Arthurian League Representative Team,Herts Senior County League,3,0,2.0,3
18914059,Old Carthusians Vets,Old Wykehamists Vets,5,0,0.0,5
18580255,Old Foresters,Old Salopians,1,2,4.0,3
18580151,KCS Old Boys,Old Chigwellians,1,0,3.0,1
18682892,Lancing Old Boys,Old Malvernians,2,2,5.0,4
18682876,Old Cholmeleians,Old Reptonians,3,1,3.0,4
18682842,Old Harrovians,Old Berkhamstedians,2,1,4.0,3
18682714,Old Merchant Taylors,Old Harrovians II,2,0,2.0,2
18638412,Old Aldenhamians II,Old Wellingtonians,3,1,3.0,4
18638451,Old Carthusians III,Old Salopians II,1,0,3.0,1
18647622,Old King's Scholars,Old Amplefordians,3,1,3.0,4
19139533,Old Alleynians AFC,Old Tonbridgians,2,3,4.0,5
19256648,Old Shirburnians,Old Epsomians,2,2,5.0,4
19277057,Old Westminsters,Old Rugbeians,3,1,3.0,4
19291446,Old Foresters II,Old Carthusians II,1,3,3.0,4
19256512,Old Merchant Taylors II,Old Bancroftians AFC,3,2,4.0,5
19256717,Old Foresters III,Old Alleynians AFC II,0,6,0.0,6
19236710,Old Harrovians III,Old Haberdashers,5,1,2.0,6
19231270,Old Stoics,Old Berkhamstedians II,2,1,4.0,3
19216981,Old Actonians Association FC,Old Carthusians,0,2,2.0,2
18914058,Lancing Old Boys Vets,Old Harrovians Vets,4,3,4.0,7
18580224,Old Brentwoods,Old Etonians,0,6,0.0,6
18580275,Old Tonbridgians,Old Foresters,0,0,4.0,0
18580271,Old Bradfieldians,Old Chigwellians,1,2,4.0,3
18682844,Lancing Old Boys,Old Reptonians,2,0,2.0,2
18682880,Old Aldenhamians,Old Cholmeleians,1,2,4.0,3
18682834,Old Marlburians,Old Berkhamstedians,0,3,2.0,3
18682873,Old Harrovians,Old Alleynians AFC,3,1,3.0,4
18682727,Old Westminsters,Lancing Old Boys II,4,0,1.0,4
18682723,Old Merchant Taylors,Old Chigwellians II,1,2,4.0,3
18682702,Kings College Wimbledon II,Old Harrovians II,2,2,5.0,4
18682665,Old Citizens,Old Foresters II,5,3,4.0,8
18638423,Old Aldenhamians II,Old Rugbeians,1,3,3.0,4
18638435,Old Epsomians,Old Tonbridgians II,1,0,3.0,1
18682774,Old Columbans,Old Brentwoods II,4,0,1.0,4
18682740,Old Eastbournians,Old Suttonians SV,1,7,0.0,8
18682752,Old Stoics,Old Alleynians AFC II,2,2,5.0,4
18580178,Old Kimboltonians,Old Merchant Taylors II,2,0,2.0,2
18647653,Old King's Scholars,Old Westminsters II,4,2,3.0,6
18647634,Old Shirburnians,Old Berkhamstedians II,3,0,2.0,3
19158182,Old Wykehamists,Old Carthusians,1,4,2.0,5
19197956,Old Carthusians II,Old Carthusians III,2,1,4.0,3
19256882,Old Albanians SA,Old Wykehamists II,1,6,0.0,7
19218971,Albanian FC,Old Chigwellians Vets,1,1,4.0,2
18580175,Old Etonians,Old Wykehamists,1,2,4.0,3
18580212,KCS Old Boys,Old Carthusians,1,1,4.0,2
18682845,Old Alleynians AFC,Old Cholmeleians,4,1,2.0,5
18682879,Old Radleians,Old Aldenhamians,4,2,3.0,6
18682846,Old Berkhamstedians,Old Malvernians,2,0,2.0,2
18638443,Old Johnians FC,Old Salopians II,2,3,4.0,5
18682755,Old Stoics,Old Eastbournians,4,2,3.0,6
18647636,Old King's Scholars,Old Berkhamstedians II,2,0,2.0,2
18647645,Old Berkhamstedians II,Old King's Scholars,1,1,4.0,2
19236453,Old Harrovians III,Old Westminsters,2,2,5.0,4
19197888,Old Foresters II,Old Cholmeleians II,4,1,2.0,5
19256649,Old Suttonians SV,Old Amplefordians,4,7,3.0,11
19092141,Old Etonians Vets,Old Chigwellians Vets,1,2,4.0,3
18580217,Old Bradfieldians,Old Etonians,1,2,4.0,3
18580129,Old Carthusians,Old Brentwoods,4,1,2.0,5
18580158,Old Salopians,Old Foresters,1,2,4.0,3
18682823,Old Aldenhamians,Old Berkhamstedians,0,1,3.0,1
18682886,Old Alleynians AFC,Old Radleians,6,4,4.0,10
18682869,Old Malvernians,Lancing Old Boys,0,3,2.0,3
18682821,Old Marlburians,Old Harrovians,0,5,0.0,5
18682681,Old Merchant Taylors,Old Citizens,2,3,4.0,5
18682688,Old Carthusians II,Old Westminsters,1,1,4.0,2
18682767,Old Alleynians AFC II,Old Stoics,1,2,4.0,3
18682768,Old Brentwoods II,Old Suttonians SV,0,2,2.0,2
18682754,Old Haberdashers,Old Bancroftians AFC,3,2,4.0,5
18682786,Old Harrovians III,Old Columbans,3,0,2.0,3
18580165,Old Chigwellians III,Old Albanians SA,0,1,3.0,1
18647626,Old King's Scholars,Old Kingstonians KGS,5,7,4.0,12
19197858,Old Chigwellians II,Old Johnians FC,3,1,3.0,4
19236306,Old Epsomians,Old Harrovians II,3,1,3.0,4
19197656,Old Tonbridgians II,Old Rugbeians,2,5,2.0,7
19236077,Kings College Wimbledon II,Old Shirburnians,0,1,3.0,1
19197714,Old Etonians II,Old Sennockians,2,1,4.0,3
19071978,Old Wykehamists II,Old Cholmeleians II,3,0,2.0,3
19236711,Old Harrovians IV,Old Amplefordians,1,3,3.0,4
19071976,Old Westminsters II,Old Foresters III,0,1,3.0,1
19071973,Old Merchant Taylors II,Old Eastbournians,4,2,3.0,6
19198516,Old Sedcopians,Old Cholmeleians,3,5,4.0,8
19123164,Old Salopians Vets,Old Wellingtonians Vets,3,3,5.0,6
18580290,Old Foresters,Old Brentwoods,0,0,4.0,0
18580264,Old Etonians,Old Chigwellians,6,0,0.0,6
18580189,Old Wykehamists,KCS Old Boys,0,4,1.0,4
18580221,Old Tonbridgians,Old Salopians,4,1,2.0,5
18580182,Old Carthusians,Old Bradfieldians,2,2,5.0,4
18682890,Old Berkhamstedians,Lancing Old Boys,2,5,2.0,7
18682841,Old Reptonians,Old Radleians,3,1,3.0,4
18682856,Old Aldenhamians,Old Harrovians,0,6,0.0,6
18682858,Old Marlburians,Old Alleynians AFC,1,4,2.0,5
18682671,Lancing Old Boys II,Old Citizens,1,2,4.0,3
18682672,Old Carthusians II,Old Etonians II,1,0,3.0,1
18682653,Old Harrovians II,Old Chigwellians II,2,1,4.0,3
18638406,Old Aldenhamians II,Old Sennockians,0,3,2.0,3
18638425,Old Salopians II,Old Wellingtonians,3,6,3.0,9
18682782,Old Bancroftians AFC,Old Columbans,2,4,3.0,6
18682776,Old Stoics,Old Suttonians SV,2,3,4.0,5
18647621,Old Wykehamists II,Old King's Scholars,2,5,2.0,7
19121964,Old Westminsters,Old Eastbournians,8,0,0.0,8
19045361,Old Epsomians,Old Merchant Taylors,2,1,4.0,3
19106968,Kings College Wimbledon II,Old Albanians SA,4,2,3.0,6
19071975,Old Brentwoods II,Old Kimboltonians,0,3,2.0,3
19071979,Old Chigwellians III,Old Shirburnians,1,4,2.0,5
19102347,Old Harrovians III,Old Kingstonians KGS,4,2,3.0,6
19138011,Old Cholmeleians,Old Sedcopians,1,1,4.0,2
18914054,Old Tonbridgians Vets,Old Wykehamists Vets,7,4,3.0,11
19092140,Old Brentwoods Vets,Old Haileyburians Vets,4,3,4.0,7
19123088,Old Foresters Vets,Lancing Old Boys Vets,3,0,2.0,3
19123029,Old Harrovians Vets,Old Malvernians Vets,2,5,2.0,7
19092153,Old Bradfieldians Vets,Old Reptonians Vets,2,0,2.0,2
19176199,Old Carthusians Vets,Old Pauline,0,2,2.0,2
18580262,Old Bradfieldians,Old Foresters,3,3,5.0,6
18580232,KCS Old Boys,Old Wykehamists,2,0,2.0,2
18580288,Old Etonians,Old Salopians,2,3,4.0,5
18682864,Old Alleynians AFC,Old Aldenhamians,8,0,0.0,8
18682855,Old Radleians,Old Harrovians,2,1,4.0,3
18682859,Old Reptonians,Old Berkhamstedians,1,3,3.0,4
18682871,Lancing Old Boys,Old Cholmeleians,1,1,4.0,2
18682722,Old Harrovians II,Old Foresters II,0,0,4.0,0
18682717,Old Etonians II,Lancing Old Boys II,3,0,2.0,3
18682641,Old Carthusians II,Old Merchant Taylors,3,0,2.0,3
18682716,Old Citizens,Kings College Wimbledon II,2,0,2.0,2
18638421,Old Wellingtonians,Old Aldenhamians II,12,0,0.0,12
18638434,Old Carthusians III,Old Rugbeians,1,1,4.0,2
18638405,Old Salopians II,Old Sennockians,0,4,1.0,4
18682791,Old Haberdashers,Old Alleynians AFC II,2,8,0.0,10
18682787,Old Suttonians SV,Old Stoics,4,2,3.0,6
18682790,Old Eastbournians,Old Columbans,0,3,2.0,3
18682764,Old Harrovians III,Old Brentwoods II,2,2,5.0,4
18580157,Old Merchant Taylors II,Old Cholmeleians II,1,0,3.0,1
18580214,Old Albanians SA,Old Brentwoods III,6,2,2.0,8
18647632,Old Kingstonians KGS,Old Shirburnians,3,4,4.0,7
19200992,Old Thorntonians,Old Carthusians,1,4,2.0,5
19160558,Old Chigwellians Vets,Old Lyonians,4,0,1.0,4
19046311,Epsom College 1st XI,Old Epsomians,0,0,4.0,0
18993523,Westminster School 1st XI,Old Westminsters,1,2,4.0,3
18993524,Westminster School 2nd XI,Old Westminsters II,1,5,2.0,6
19050630,Old King's Scholars,Old Suttonians,3,2,4.0,5
19092143,Old Westminsters Vets,Old Berkhamstedians Vets,1,2,4.0,3
18580133,Old Foresters,Old Wykehamists,3,2,4.0,5
18580179,Old Chigwellians,Old Salopians,0,1,3.0,1
18580100,Old Brentwoods,Old Bradfieldians,4,1,2.0,5
18682888,Old Reptonians,Lancing Old Boys,2,5,2.0,7
18682840,Old Malvernians,Old Marlburians,2,0,2.0,2
18580239,Old Kimboltonians,Old Chigwellians III,3,0,2.0,3
18647648,Old Berkhamstedians II,Old Amplefordians,7,3,2.0,10
19042876,Old Wellingtonians,Old Carthusians II,0,4,1.0,4
19042875,Old Foresters II,Old Columbans,2,1,4.0,3
19106837,Old Merchant Taylors II,Old Chigwellians II,2,3,4.0,5
19090051,Old Harrovians II,Old Westminsters II,4,2,3.0,6
19090416,Old Etonians II,Old Bancroftians AFC,6,0,0.0,6
19042833,Old Johnians FC,Lancing Old Boys II,1,0,3.0,1
19106951,Old Rugbeians,Old Stoics,5,0,0.0,5
19106981,Old Salopians II,Old Harrovians III,2,6,2.0,8
19106949,Old Tonbridgians II,Old Brentwoods II,3,2,4.0,5
19106990,Old Citizens,Old Shirburnians,2,4,3.0,6
19033545,City of London,Old Cholmeleians,0,6,0.0,6
19090693,Old Sennockians,Old Meadonians,5,6,5.0,11
19102433,Old King's Scholars,Wood Green Old Boys,1,0,3.0,1
18337473,Dulwich College 1st XI,Old Alleynians AFC,2,3,4.0,5
18337839,Dulwich College 2nd XI,Old Alleynians AFC II,0,3,2.0,3
19110117,"King's College School, Wimbledon 1st XI",KCS Old Boys,7,0,0.0,7
19110118,"King's College School, Wimbledon 2nd XI",Kings College Wimbledon II,0,0,4.0,0
19088062,Old Suttonians,Old Carthusians,0,4,1.0,4
18682729,Old Harrovians II,Old Carthusians II,1,3,3.0,4
19002205,Old Carthusians,Old Merchant Taylors,7,0,0.0,7
19002215,Old Wykehamists,Old Berkhamstedians,4,2,3.0,6
19002264,Old Brentwoods,Old Etonians,1,3,3.0,4
19137090,Wormley Rovers Vets FC,Old Chigwellians Vets,1,3,3.0,4
18580194,Old Wykehamists,Old Carthusians,0,4,1.0,4
18580279,Old Bradfieldians,Old Brentwoods,6,3,3.0,9
18580102,Old Salopians,Old Chigwellians,1,3,3.0,4
18580297,Old Etonians,KCS Old Boys,1,1,4.0,2
18682837,Old Radleians,Old Malvernians,0,2,2.0,2
18682700,Old Foresters II,Old Carthusians II,1,2,4.0,3
18682686,Kings College Wimbledon II,Old Citizens,0,5,0.0,5
18638450,Old Sennockians,Old Aldenhamians II,3,2,4.0,5
18682750,Old Bancroftians AFC,Old Eastbournians,3,0,2.0,3
18580116,Old Foresters III,Old Kimboltonians,0,6,0.0,6
19002340,Old Foresters,Lancing Old Boys,2,0,2.0,2
19002456,Old Rugbeians,Old Alleynians AFC,1,2,4.0,3
18992915,Old Westminsters,Old Shirburnians,3,2,4.0,5
19090678,Albanian FC,Old Columbans,7,4,3.0,11
18976671,Old Harrovians II,Old Parkonians,1,2,4.0,3
18682818,Old Berkhamstedians,Old Marlburians,1,1,4.0,2
18914065,Old Carthusians Vets,Old Harrovians Vets,3,5,4.0,8
18974096,Old Harrovians Vets,Old Carthusians Vets,5,3,4.0,8
18974097,Lancing Old Boys Vets,Old Wellingtonians Vets,1,1,4.0,2
19026613,Lancing Old Boys Vets,Old Wellingtonians Vets,1,1,4.0,2
19026610,Old Harrovians Vets,Old Carthusians Vets,3,5,4.0,8
19120591,Old Aloysians,Old Chigwellians Vets,1,2,4.0,3
18580246,Old Foresters,Old Chigwellians,2,1,4.0,3
18580211,Old Wykehamists,Old Bradfieldians,2,0,2.0,2
18580203,Old Carthusians,Old Salopians,3,2,4.0,5
18580207,Old Etonians,Old Tonbridgians,1,3,3.0,4
18580252,KCS Old Boys,Old Brentwoods,6,2,2.0,8
18682816,Old Alleynians AFC,Old Berkhamstedians,4,1,2.0,5
18682839,Old Harrovians,Old Aldenhamians,6,1,0.0,7
18682854,Old Malvernians,Old Cholmeleians,1,1,4.0,2
18682850,Old Marlburians,Lancing Old Boys,1,3,3.0,4
18682680,Old Foresters II,Old Harrovians II,2,1,4.0,3
18682678,Lancing Old Boys II,Kings College Wimbledon II,4,2,3.0,6
18682712,Old Citizens,Old Carthusians II,0,1,3.0,1
18682646,Old Chigwellians II,Old Merchant Taylors,1,4,2.0,5
18682705,Old Etonians II,Old Westminsters,4,5,5.0,9
18638446,Old Salopians II,Old Tonbridgians II,2,2,5.0,4
18638455,Old Carthusians III,Old Sennockians,3,5,4.0,8
18638438,Old Epsomians,Old Johnians FC,0,1,3.0,1
18682773,Old Suttonians SV,Old Harrovians III,4,1,2.0,5
18682792,Old Bancroftians AFC,Old Stoics,1,3,3.0,4
18580118,Old Cholmeleians II,Old Brentwoods III,7,0,0.0,7
18647650,Old King's Scholars,Old Shirburnians,1,2,4.0,3
19002272,Old Kimboltonians,Old Reptonians,1,2,4.0,3
18953753,Old Harrovians IV,Old Eastbournians,1,2,4.0,3
18337803,Haberdashers Aske School 1st XI,Old Haberdashers,8,1,0.0,9
18580192,Old Brentwoods,Old Foresters,0,3,2.0,3
18580251,Old Wykehamists,Old Tonbridgians,2,0,2.0,2
18580196,Old Chigwellians,Old Etonians,1,2,4.0,3
18682835,Old Alleynians AFC,Old Marlburians,2,1,4.0,3
18682861,Old Radleians,Lancing Old Boys,0,6,0.0,6
18682851,Old Reptonians,Old Malvernians,5,1,2.0,6
18682668,Old Chigwellians II,Lancing Old Boys II,3,1,3.0,4
18682691,Kings College Wimbledon II,Old Foresters II,1,3,3.0,4
18682708,Old Etonians II,Old Merchant Taylors,4,0,1.0,4
18638464,Old Tonbridgians II,Old Sennockians,1,1,4.0,2
18638419,Old Epsomians,Old Rugbeians,0,3,2.0,3
18638461,Old Wellingtonians,Old Carthusians III,1,2,4.0,3
18682744,Old Haberdashers,Old Columbans,4,7,3.0,11
18580184,Old Cholmeleians II,Old Chigwellians III,5,2,2.0,7
18647629,Old Wykehamists II,Old Westminsters II,2,1,4.0,3
18768237,Old Shirburnians,Old Kimboltonians,3,1,3.0,4
18768236,Old Suttonians SV,Old Harrovians III,0,3,2.0,3
18768238,Old Albanians SA,Old Alleynians AFC II,6,1,0.0,7
18768311,Old Brentwoods II,Old King's Scholars,6,3,3.0,9
18768242,Old Kingstonians KGS,Old Stoics,0,6,0.0,6
18992931,Old Carthusians,Old Minchendenians,3,0,2.0,3
18974093,Old Brentwoods Vets,Old Tonbridgians Vets,3,1,3.0,4
18974098,Old Chigwellians Vets,Old Bradfieldians Vets,5,1,2.0,6
19026598,Old Aldenhamians Vets,Old Berkhamstedians Vets,2,4,3.0,6
19026608,Old Brentwoods Vets,Old Tonbridgians Vets,1,3,3.0,4
19026615,Old Chigwellians Vets,Old Bradfieldians Vets,1,5,2.0,6
19026597,Old Westminsters Vets,Old Wykehamists Vets,5,1,2.0,6
18580226,Old Chigwellians,Old Carthusians,1,3,3.0,4
18580231,Old Wykehamists,Old Salopians,1,3,3.0,4
18580295,Old Bradfieldians,Old Tonbridgians,5,2,2.0,7
18580202,Old Brentwoods,KCS Old Boys,0,2,2.0,2
18682815,Old Aldenhamians,Lancing Old Boys,0,4,1.0,4
18682868,Old Berkhamstedians,Old Harrovians,2,4,3.0,6
18682881,Old Reptonians,Old Alleynians AFC,3,8,0.0,11
18682884,Old Malvernians,Old Radleians,4,3,4.0,7
18682657,Lancing Old Boys II,Old Harrovians II,2,3,4.0,5
18682718,Old Foresters II,Old Merchant Taylors,2,1,4.0,3
18682664,Old Carthusians II,Kings College Wimbledon II,3,2,4.0,5
18638413,Old Salopians II,Old Johnians FC,1,4,2.0,5
18638415,Old Tonbridgians II,Old Wellingtonians,2,1,4.0,3
18638430,Old Epsomians,Old Carthusians III,2,3,4.0,5
18638416,Old Rugbeians,Old Sennockians,2,1,4.0,3
18682734,Old Eastbournians,Old Brentwoods II,6,1,0.0,7
18647635,Old Wykehamists II,Old Kingstonians KGS,2,1,4.0,3
18647612,Old Berkhamstedians II,Old Shirburnians,4,2,3.0,6
18768233,Old Amplefordians,Old Bancroftians AFC,3,3,5.0,6
18768235,Old Cholmeleians II,Old Chigwellians III,4,2,3.0,6
18768241,Old Westminsters II,Old Haberdashers,3,0,2.0,3
18930105,Old Manorians,Old Foresters,3,2,4.0,5
19008385,Old Cholmeleians,Old Tiffinians,2,1,4.0,3
19042966,Old Kingsburians,Old Columbans,0,3,2.0,3
19062184,Southgate County,Old King's Scholars,1,6,0.0,7
18255538,Eton College 1st XI,Old Etonians,3,4,4.0,7
18255539,Eton College 2nd XI,Old Etonians II,1,0,3.0,1
18580171,Old Foresters,KCS Old Boys,0,2,2.0,2
18580260,Old Wykehamists,Old Etonians,3,4,4.0,7
18580131,Old Chigwellians,Old Bradfieldians,3,1,3.0,4
18580282,Old Salopians,Old Tonbridgians,4,1,2.0,5
18682820,Old Aldenhamians,Old Reptonians,0,9,0.0,9
18682829,Old Cholmeleians,Old Berkhamstedians,1,1,4.0,2
18682843,Old Radleians,Old Alleynians AFC,2,2,5.0,4
18682830,Old Harrovians,Old Malvernians,1,2,4.0,3
18682715,Old Chigwellians II,Old Carthusians II,2,1,4.0,3
18682677,Old Harrovians II,Kings College Wimbledon II,2,1,4.0,3
18682676,Old Etonians II,Old Foresters II,1,1,4.0,2
18638411,Old Rugbeians,Old Epsomians,5,2,2.0,7
18638433,Old Tonbridgians II,Old Salopians II,4,3,4.0,7
18682777,Old Brentwoods II,Old Eastbournians,2,3,4.0,5
18682766,Old Suttonians SV,Old Bancroftians AFC,4,3,4.0,7
18682760,Old Alleynians AFC II,Old Columbans,0,2,2.0,2
18682784,Old Stoics,Old Harrovians III,3,5,4.0,8
18580172,Old Brentwoods III,Old Albanians SA,2,4,3.0,6
18580205,Old Chigwellians III,Old Foresters III,1,2,4.0,3
18580124,Old Merchant Taylors II,Old Kimboltonians,2,7,0.0,9
18647643,Old Kingstonians KGS,Old Westminsters II,2,2,5.0,4
18647646,Old Shirburnians,Old Amplefordians,3,1,3.0,4
18647633,Old Berkhamstedians II,Old Wykehamists II,2,5,2.0,7
19045414,National Westminster Bank,Old Sennockians,0,3,2.0,3
18254318,Lancing College 1st XI,Lancing Old Boys,0,5,0.0,5
18697339,Lancing College 2nd XI,Lancing Old Boys II,2,3,4.0,5
19050859,Old Brentwoods,Old Suttonians,1,5,2.0,6
18974100,Old Cholmeleians Vets,Old Haileyburians Vets,4,4,6.0,8
18974094,Old Reptonians Vets,Old Etonians Vets,0,5,0.0,5
18974099,Old Salopians Vets,Old Foresters Vets,0,4,1.0,4
19026632,Old Cholmeleians Vets,Old Haileyburians Vets,4,4,6.0,8
19026609,Old Reptonians Vets,Old Etonians Vets,5,0,0.0,5
19026616,Old Salopians Vets,Old Foresters Vets,4,0,1.0,4
18355829,Old Etonians Vets,Queen Mary College Old Boys,0,5,0.0,5
18580263,Old Wykehamists,Old Brentwoods,5,4,5.0,9
18580164,Old Chigwellians,Old Tonbridgians,1,3,3.0,4
18580169,Old Salopians,KCS Old Boys,2,0,2.0,2
18580281,Old Etonians,Old Foresters,3,1,3.0,4
18682826,Old Berkhamstedians,Old Reptonians,3,3,5.0,6
18682825,Old Alleynians AFC,Old Harrovians,5,1,2.0,6
18682819,Old Cholmeleians,Old Malvernians,1,1,4.0,2
18682828,Old Marlburians,Old Radleians,2,0,2.0,2
18682650,Lancing Old Boys II,Old Etonians II,0,2,2.0,2
18682674,Old Harrovians II,Old Merchant Taylors,2,1,4.0,3
18682698,Old Citizens,Old Chigwellians II,1,1,4.0,2
18638427,Old Aldenhamians II,Old Epsomians,4,4,6.0,8
18638452,Old Rugbeians,Old Johnians FC,1,2,4.0,3
18638440,Old Carthusians III,Old Wellingtonians,2,2,5.0,4
18682763,Old Haberdashers,Old Suttonians SV,4,6,4.0,10
18682746,Old Brentwoods II,Old Alleynians AFC II,1,2,4.0,3
18682749,Old Stoics,Old Bancroftians AFC,6,2,2.0,8
18647631,Old Amplefordians,Old Berkhamstedians II,1,1,4.0,2
18647616,Old Shirburnians,Old Kingstonians KGS,5,5,6.0,10
18929500,Honourable Artillery Company,Old Carthusians II,6,0,0.0,6
19005335,Albanian FC,Old Foresters II,6,1,0.0,7
19006172,Old Carthusians,Enfield Old Grammarians,4,1,2.0,5
18311133,East Barnet Old Grammarians,Old Merchant Taylors II,1,1,4.0,2
19002881,Old King's Scholars,Old Parkonians,6,2,2.0,8
18580286,Old Chigwellians,KCS Old Boys,1,0,3.0,1
18580159,Old Tonbridgians,Old Etonians,2,1,4.0,3
18580300,Old Carthusians,Old Foresters,4,0,1.0,4
18580233,Old Brentwoods,Old Salopians,3,0,2.0,3
18682822,Lancing Old Boys,Old Marlburians,1,2,4.0,3
18682824,Old Reptonians,Old Harrovians,5,1,2.0,6
18682827,Old Malvernians,Old Aldenhamians,2,1,4.0,3
18682724,Kings College Wimbledon II,Old Chigwellians II,0,0,4.0,0
18682670,Old Merchant Taylors,Old Etonians II,0,2,2.0,2
18682685,Old Citizens,Old Westminsters,3,3,5.0,6
18638459,Old Epsomians,Old Sennockians,2,1,4.0,3
18638436,Old Johnians FC,Old Carthusians III,1,1,4.0,2
18638449,Old Rugbeians,Old Tonbridgians II,3,6,3.0,9
18638437,Old Salopians II,Old Aldenhamians II,2,4,3.0,6
18682757,Old Bancroftians AFC,Old Alleynians AFC II,3,0,2.0,3
18682759,Old Suttonians SV,Old Eastbournians,5,2,2.0,7
18682758,Old Brentwoods II,Old Columbans,0,1,3.0,1
18580198,Old Chigwellians III,Old Kimboltonians,2,5,2.0,7
18647641,Old Berkhamstedians II,Old Kingstonians KGS,3,4,4.0,7
18962598,Old Salvatorians,Old Cholmeleians II,5,1,2.0,6
18882948,London Lawyers,Old Cholmeleians,2,4,3.0,6
18882947,Old Alleynians AFC,Clissold Park Rangers,2,2,5.0,4
18883154,Old Berkhamstedians,Spaniards,4,4,6.0,8
18252990,Harrow School 2nd XI,Old Harrovians II,1,3,3.0,4
18252991,Harrow School 3rd XI,Old Harrovians III,1,2,4.0,3
18266153,Winchester College 1st XI,Old Wykehamists,2,1,4.0,3
18266154,Winchester College 2nd XI,Old Wykehamists II,1,1,4.0,2
18682867,Old Aldenhamians,Old Marlburians,2,2,5.0,4
18682870,Old Radleians,Old Reptonians,5,2,2.0,7
18682725,Old Foresters II,Old Etonians II,1,5,2.0,6
18682706,Lancing Old Boys II,Old Chigwellians II,0,2,2.0,2
18682660,Old Carthusians II,Old Harrovians II,2,2,5.0,4
18682720,Kings College Wimbledon II,Old Westminsters,3,1,3.0,4
18638410,Old Johnians FC,Old Tonbridgians II,3,1,3.0,4
18638457,Old Salopians II,Old Epsomians,1,2,4.0,3
18638407,Old Wellingtonians,Old Rugbeians,3,3,5.0,6
18682761,Old Bancroftians AFC,Old Brentwoods II,3,4,4.0,7
18682781,Old Alleynians AFC II,Old Suttonians SV,2,2,5.0,4
18682797,Old Eastbournians,Old Stoics,3,6,3.0,9
18682737,Old Harrovians III,Old Haberdashers,8,0,0.0,8
18580191,Old Albanians SA,Old Merchant Taylors II,4,4,6.0,8
18580173,Old Cholmeleians II,Old Foresters III,2,1,4.0,3
18647651,Old King's Scholars,Old Wykehamists II,0,1,3.0,1
18647627,Old Westminsters II,Old Amplefordians,3,1,3.0,4
18329340,Old Brentwoods,Old Sennockians,5,0,0.0,5
18329337,Old Chigwellians,Old Kimboltonians,0,2,2.0,2
18329214,Old Foresters,Old Bradfieldians,2,0,2.0,2
18974275,Old Wykehamists,KCS Old Boys,2,0,2.0,2
18974429,Old Alleynians AFC,Old Malvernians,4,3,4.0,7
18329339,Old Carthusians,Old Harrovians,3,1,3.0,4
18329341,Old Tonbridgians,Old Salopians,1,0,3.0,1
18569202,Old Sedcopians,Lancing Old Boys,4,1,2.0,5
18576916,Somerville Old Boys,Old Cholmeleians,1,4,2.0,5
18907136,Bealonians,Old Columbans,1,3,3.0,4
18310949,Old Aldenhamians II,Old Minchendenians,1,6,0.0,7
18311124,Old Parkonians,Old Brentwoods III,3,0,2.0,3
18580138,Old Brentwoods,Old Tonbridgians,6,2,2.0,8
18580137,Old Bradfieldians,Old Salopians,1,2,4.0,3
18682877,Old Harrovians,Old Marlburians,2,7,0.0,9
18682703,Old Chigwellians II,Old Foresters II,1,1,4.0,2
18682721,Lancing Old Boys II,Old Carthusians II,1,2,4.0,3
18638432,Old Aldenhamians II,Old Carthusians III,3,5,4.0,8
18638448,Old Johnians FC,Old Epsomians,2,4,3.0,6
18638456,Old Salopians II,Old Rugbeians,1,5,2.0,6
18682771,Old Brentwoods II,Old Stoics,3,1,3.0,4
18682753,Old Alleynians AFC II,Old Harrovians III,1,3,3.0,4
18580122,Old Foresters III,Old Albanians SA,2,0,2.0,2
18647649,Old Kingstonians KGS,Old Wykehamists II,3,5,4.0,8
18329216,Old Berkhamstedians,Old Eastbournians,5,1,2.0,6
18329344,Old Malvernians,Old Alleynians AFC,0,0,4.0,0
18329215,Old Radleians,Old Etonians,0,1,3.0,1
18329343,Old Reptonians,Old Amplefordians,4,0,1.0,4
18329335,Old Columbans,Old Westminsters,2,4,3.0,6
18329338,Old Bancroftians AFC,Old Cholmeleians,3,5,4.0,8
18568661,Old Aloysians,Old Carthusians,1,5,2.0,6
18962502,Old Chigwellians,Old Finchleians,0,4,1.0,4
18906642,Old Sennockians,Shene Old Grammarians,6,2,2.0,8
18954773,Old Minchendenians IV,Old Chigwellians III,6,0,0.0,6
18894443,UCL Academicals V,Old King's Scholars,0,4,1.0,4
18310940,Old Merchant Taylors,Old Tenisonians,1,2,4.0,3
18683193,Old Owens,Old Aldenhamians,4,1,2.0,5
18953918,Old Wilsonians,Old Etonians II,4,1,2.0,5
18310941,Old Harrovians II,East Barnet Old Grammarians,3,0,2.0,3
18311125,Old Minchendenians,Old Merchant Taylors II,2,4,3.0,6
18260215,Old Berkhamstedians Vets,Old Wellingtonians Vets,1,5,2.0,6
18355826,Old Brentwoods Vets,Old Finchleians,3,0,2.0,3
18355828,Old Haileyburians Vets,Old Lyonians,3,1,3.0,4
18580222,Old Wykehamists,Old Foresters,5,1,2.0,6
18580240,Old Tonbridgians,Old Bradfieldians,1,1,4.0,2
18682838,Old Berkhamstedians,Old Alleynians AFC,2,1,4.0,3
18682832,Old Harrovians,Old Radleians,3,2,4.0,5
18682817,Old Marlburians,Old Reptonians,3,1,3.0,4
18682683,Old Chigwellians II,Old Etonians II,3,2,4.0,5
18682663,Lancing Old Boys II,Old Westminsters,1,2,4.0,3
18682644,Old Harrovians II,Old Citizens,2,4,3.0,6
18682726,Old Merchant Taylors,Old Carthusians II,0,3,2.0,3
18638418,Old Aldenhamians II,Old Tonbridgians II,1,6,0.0,7
18638420,Old Sennockians,Old Carthusians III,3,2,4.0,5
18638447,Old Wellingtonians,Old Epsomians,1,2,4.0,3
18682788,Old Bancroftians AFC,Old Suttonians SV,0,0,4.0,0
18682789,Old Brentwoods II,Old Harrovians III,1,1,4.0,2
18682747,Old Eastbournians,Old Haberdashers,3,0,2.0,3
18682765,Old Stoics,Old Columbans,4,2,3.0,6
18580155,Old Chigwellians III,Old Brentwoods III,0,1,3.0,1
18580135,Old Foresters III,Old Merchant Taylors II,3,4,4.0,7
18580136,Old Kimboltonians,Old Albanians SA,2,3,4.0,5
18647640,Old Amplefordians,Old King's Scholars,1,2,4.0,3
18647644,Old Wykehamists II,Old Berkhamstedians II,3,3,5.0,6
18647639,Old Westminsters II,Old Shirburnians,1,3,3.0,4
18329336,Old Aldenhamians,Lancing Old Boys,2,3,4.0,5
18780043,Old Parkonians,Kings College Wimbledon II,3,1,3.0,4
18569309,Southgate County,Old Cholmeleians II,0,5,0.0,5
18854846,Old Foresters II,Hale End Athletic,3,2,4.0,5
18310912,Old Carthusians,Old Stationers,2,1,4.0,3
18355194,Old Brentwoods,Old Etonians,3,2,4.0,5
18580125,Old Salopians,Old Brentwoods,1,0,3.0,1
18580126,Old Tonbridgians,Old Chigwellians,3,2,4.0,5
18580120,Old Etonians,Old Carthusians,1,1,4.0,2
18580117,KCS Old Boys,Old Bradfieldians,2,4,3.0,6
18682812,Lancing Old Boys,Old Radleians,1,2,4.0,3
18682814,Old Cholmeleians,Old Alleynians AFC,3,2,4.0,5
18682813,Old Aldenhamians,Old Malvernians,0,3,2.0,3
18682865,Old Harrovians,Old Reptonians,1,3,3.0,4
18682709,Old Foresters II,Kings College Wimbledon II,7,1,0.0,8
18682652,Old Etonians II,Old Carthusians II,5,3,4.0,8
18682719,Old Harrovians II,Old Westminsters,1,5,2.0,6
18682704,Old Citizens,Lancing Old Boys II,3,1,3.0,4
18638441,Old Johnians FC,Old Sennockians,2,1,4.0,3
18638460,Old Wellingtonians,Old Tonbridgians II,3,3,5.0,6
18638442,Old Carthusians III,Old Epsomians,1,1,4.0,2
18682785,Old Bancroftians AFC,Old Haberdashers,4,1,2.0,5
18682793,Old Alleynians AFC II,Old Brentwoods II,3,3,5.0,6
18580193,Old Brentwoods III,Old Foresters III,1,3,3.0,4
18580103,Old Cholmeleians II,Old Albanians SA,2,3,4.0,5
18647623,Old Westminsters II,Old Kingstonians KGS,6,0,0.0,6
18329334,Old Suttonians SV,Old Shirburnians,1,4,2.0,5
18329342,KCS Old Boys,Old Wykehamists,1,1,4.0,2
18571499,Old Foresters,Southgate County,1,0,3.0,1
18854816,Albanian FC,Old Chigwellians II,4,3,4.0,7
18907192,Shene Old Grammarians,Old Salopians II,1,0,3.0,1
18260211,Old Bradfieldians Vets,Old Westminsters Vets,4,1,2.0,5
18260210,Old Wykehamists Vets,Old Carthusians Vets,1,2,4.0,3
18580114,Old Foresters,Old Etonians,1,0,3.0,1
18580107,Old Bradfieldians,Old Wykehamists,7,3,2.0,10
18580110,Old Carthusians,Old Tonbridgians,3,2,4.0,5
18682809,Old Alleynians AFC,Old Reptonians,1,3,3.0,4
18682863,Lancing Old Boys,Old Berkhamstedians,1,3,3.0,4
18682857,Old Cholmeleians,Old Radleians,1,2,4.0,3
18682811,Old Malvernians,Old Harrovians,0,6,0.0,6
18682847,Old Marlburians,Old Aldenhamians,2,3,4.0,5
18682651,Old Foresters II,Old Citizens,1,3,3.0,4
18682666,Old Harrovians II,Old Etonians II,3,1,3.0,4
18682649,Kings College Wimbledon II,Old Merchant Taylors,1,3,3.0,4
18638445,Old Aldenhamians II,Old Johnians FC,0,9,0.0,9
18638399,Old Rugbeians,Old Wellingtonians,2,1,4.0,3
18638393,Old Tonbridgians II,Old Carthusians III,2,1,4.0,3
18682741,Old Haberdashers,Old Brentwoods II,5,5,6.0,10
18682745,Old Suttonians SV,Old Alleynians AFC II,2,1,4.0,3
18682742,Old Harrovians III,Old Stoics,5,1,2.0,6
18682769,Old Eastbournians,Old Bancroftians AFC,1,3,3.0,4
18580243,Old Albanians SA,Old Kimboltonians,1,7,0.0,8
18580109,Old Brentwoods III,Old Chigwellians III,2,2,5.0,4
18580112,Old Cholmeleians II,Old Merchant Taylors II,3,2,4.0,5
18647619,Old Amplefordians,Old Shirburnians,1,1,4.0,2
18647620,Old Kingstonians KGS,Old Berkhamstedians II,2,0,2.0,2
18647625,Old Westminsters II,Old King's Scholars,1,3,3.0,4
18571170,Old Carthusians II,Old Bromleians,8,0,0.0,8
18350506,Altis,Old Chigwellians,4,1,2.0,5
18350514,Old Parmiterians,Old Columbans,1,6,0.0,7
18887303,Clapham Old Xaverians,Old Epsomians,1,0,3.0,1
18350515,Old Hamptonians,Old Sennockians,1,3,3.0,4
18266290,Shrewsbury School 1st XI,Old Salopians,0,2,2.0,2
18266291,Shrewsbury School 2nd XI,Old Salopians II,0,0,4.0,0
18580303,Old Salopians,Old Bradfieldians,1,2,4.0,3
18580099,KCS Old Boys,Old Etonians,0,3,2.0,3
18682810,Old Cholmeleians,Old Aldenhamians,3,0,2.0,3
18682808,Old Radleians,Old Marlburians,2,3,4.0,5
18682807,Old Harrovians,Lancing Old Boys,5,2,2.0,7
18682648,Old Westminsters,Old Foresters II,3,4,4.0,7
18682661,Old Chigwellians II,Old Citizens,0,1,3.0,1
18638397,Old Sennockians,Old Rugbeians,3,0,2.0,3
18638402,Old Tonbridgians II,Old Aldenhamians II,4,0,1.0,4
18638398,Old Wellingtonians,Old Salopians II,1,3,3.0,4
18682778,Old Harrovians III,Old Alleynians AFC II,6,1,0.0,7
18682772,Old Columbans,Old Eastbournians,6,1,0.0,7
18682779,Old Stoics,Old Haberdashers,4,1,2.0,5
18580254,Old Albanians SA,Old Cholmeleians II,3,1,3.0,4
18580101,Old Brentwoods III,Old Kimboltonians,3,3,5.0,6
18580227,Old Chigwellians III,Old Merchant Taylors II,1,2,4.0,3
18647618,Old Wykehamists II,Old Amplefordians,2,1,4.0,3
18647617,Old Westminsters II,Old Berkhamstedians II,4,0,1.0,4
18861479,Old Owens,Old Brentwoods II,3,2,4.0,5
18350509,Old Berkhamstedians,Old Reptonians,4,3,4.0,7
18350508,Old Malvernians,Old Uffingtonians FC,1,4,2.0,5
18350507,Old Strand Academicals,Old Alleynians AFC,0,3,2.0,3
18259232,Charterhouse School 1st XI,Old Carthusians,0,12,0.0,12
18259233,Charterhouse School 2nd XI,Old Carthusians II,0,0,4.0,0
18259234,Charterhouse School 3rd XI,Old Carthusians III,2,6,2.0,8
18310908,Glyn Old Boys,Old Chigwellians,3,2,4.0,5
18310903,Old Brentwoods,Old Finchleians,6,4,4.0,10
18310930,Enfield Old Grammarians,Old Etonians II,3,4,4.0,7
18310931,Old Blues,Lancing Old Boys II,3,1,3.0,4
18310932,Old Finchleians,Old Merchant Taylors,3,5,4.0,8
18543584,Hullbridge Sports Saturday Reserves,Old Foresters,2,1,4.0,3
18580245,Old Brentwoods,Old Carthusians,1,3,3.0,4
18580095,KCS Old Boys,Old Foresters,2,3,4.0,5
18682831,Old Alleynians AFC,Lancing Old Boys,4,2,3.0,6
18682805,Old Cholmeleians,Old Marlburians,0,1,3.0,1
18682806,Old Radleians,Old Berkhamstedians,2,1,4.0,3
18682643,Old Foresters II,Lancing Old Boys II,3,0,2.0,3
18682645,Old Merchant Taylors,Old Westminsters,0,6,0.0,6
18682713,Old Etonians II,Old Chigwellians II,2,0,2.0,2
18638396,Old Carthusians III,Old Johnians FC,0,4,1.0,4
18682775,Old Eastbournians,Old Alleynians AFC II,0,1,3.0,1
18682735,Old Suttonians SV,Old Haberdashers,7,3,2.0,10
18580092,Old Albanians SA,Old Chigwellians III,3,2,4.0,5
18580147,Old Foresters III,Old Brentwoods III,5,3,4.0,8
18647615,Old Wykehamists II,Old Shirburnians,2,8,0.0,10
18647613,Old Amplefordians,Old Westminsters II,4,2,3.0,6
18350505,Queen Mary College Old Boys,Old Wykehamists,7,5,4.0,12
18350839,Alleyn Old Boys,Kings College Wimbledon II,5,4,5.0,9
18259452,Harrow School 1st XI,Old Harrovians,0,0,4.0,0
18259453,Harrow School 2nd XI,Old Harrovians II,0,0,4.0,0
18259454,Harrow School 3rd XI,Old Harrovians III,0,0,4.0,0
18330181,Kimbolton School 1st XI,Old Kimboltonians,2,4,3.0,6
18914057,Lancing Old Boys Vets,Old Wykehamists Vets,1,1,4.0,2
18580091,Old Wykehamists,Old Chigwellians,1,3,3.0,4
18580084,Old Etonians,Old Bradfieldians,1,1,4.0,2
18580083,KCS Old Boys,Old Tonbridgians,1,0,3.0,1
18682889,Old Alleynians AFC,Old Malvernians,3,2,4.0,5
18682804,Old Cholmeleians,Lancing Old Boys,1,1,4.0,2
18682875,Old Reptonians,Old Aldenhamians,4,0,1.0,4
18682642,Old Chigwellians II,Old Westminsters,0,2,2.0,2
18682694,Old Carthusians II,Lancing Old Boys II,5,0,0.0,5
18682699,Old Etonians II,Kings College Wimbledon II,0,2,2.0,2
18638395,Old Salopians II,Old Carthusians III,4,1,2.0,5
18638458,Old Tonbridgians II,Old Johnians FC,2,2,5.0,4
18638394,Old Rugbeians,Old Aldenhamians II,4,1,2.0,5
18682731,Old Bancroftians AFC,Old Harrovians III,1,1,4.0,2
18682733,Old Haberdashers,Old Stoics,3,7,2.0,10
18682732,Old Columbans,Old Alleynians AFC II,2,2,5.0,4
18580220,Old Merchant Taylors II,Old Foresters III,2,1,4.0,3
18580087,Old Cholmeleians II,Old Kimboltonians,1,1,4.0,2
18647637,Old Kingstonians KGS,Old Amplefordians,3,2,4.0,5
18350504,Southgate County,Old Salopians,3,2,4.0,5
18350511,Old Salvatorians,Old Foresters II,1,3,3.0,4
18506415,Brentwood School 1st XI,Old Brentwoods,2,5,2.0,7
18554530,Brentwood School 2nd XI,Old Brentwoods II,2,2,5.0,4
18506416,Brentwood School 3rd XI,Old Brentwoods III,2,3,4.0,5
18506417,Brentwood School 4th XI,Old Brentwoods Vets,0,0,4.0,0
18252986,Marlborough College 1st XI,Old Marlburians,2,5,2.0,7
18252992,Highgate School 1st XI,Old Cholmeleians,0,3,2.0,3
18252993,Highgate School 2nd XI,Old Cholmeleians II,0,0,4.0,0
18272292,Repton School 1st XI,Old Reptonians,1,1,4.0,2
18773610,Kingston Grammar School 1st XI,Old Kingstonians KGS,1,3,3.0,4
18258792,Old Carthusians,Old Parkonians,5,2,2.0,7
18638196,Old Carthusians,Clapham Rovers,3,0,2.0,3
18638194,Old Carthusians,Ibis Eagles,3,0,2.0,3
21233948,Old Bradfieldians,Old Carthusians,0,2,2.0,2
20556341,Old Malvernians Vets,Old Etonians Vets,1,1,4.0,2
20625192,Old Carthusians,Old Reptonians,3,0,2.0,3
21233947,Old Tonbridgians,Old Bradfieldians,0,1,3.0,1
20584370,Old Columbans,Old Carthusians II,0,1,3.0,1
20625086,Old Kimboltonians,Old Brentwoods II,4,1,2.0,5
20584045,Old Bradfieldians,Old Tonbridgians,1,1,4.0,2
20845917,Old Epsomians,Old Ardinians,2,3,4.0,5
20809547,Old Amplefordians,Old Westminsters II,2,3,4.0,5
20599033,Old Tonbridgians Vets,Old Wellingtonians Vets,2,1,4.0,3
19702949,Old Alleynians AFC,Old Chigwellians,8,4,2.0,12
19702912,Old Foresters,Old Tonbridgians,2,1,4.0,3
19702943,Old Etonians,Old Bradfieldians,3,1,3.0,4
19836193,Old Westminsters,Old Berkhamstedians,2,2,5.0,4
19836248,Old Wykehamists,Old Marlburians,2,0,2.0,2
19750495,Old Rugbeians,Old Foresters II,7,1,0.0,8
19750558,Old Carthusians II,Old Sennockians,5,0,0.0,5
19750553,Old Merchant Taylors,Old Chigwellians II,2,1,4.0,3
19929968,Lancing Old Boys II,Old Epsomians,3,3,5.0,6
19930003,Old Wellingtonians,Old Suttonians SV,3,1,3.0,4
19890744,Old Brentwoods II,Old Alleynians AFC II,2,0,2.0,2
19908675,Old Brentwoods III,Old Cholmeleians II,1,5,2.0,6
20580940,Old Reptonians,Old Carthusians,0,0,4.0,0
20611604,Old Alleynians AFC II,Old Brentwoods II,0,2,2.0,2
19836235,Old Malvernians,Old Radleians,3,2,4.0,5
20585757,Old Carthusians Vets,Old Westminsters Vets,4,1,2.0,5
19702914,Old Chigwellians,Old Foresters,0,2,2.0,2
19702930,Old Tonbridgians,Old Etonians,3,2,4.0,5
19836243,Old Cholmeleians,Old Wykehamists,0,4,1.0,4
19836218,Lancing Old Boys,Old Westminsters,3,3,5.0,6
19750499,Old Rugbeians,Old Aldenhamians,5,2,2.0,7
19750516,Old Carthusians II,Old Harrovians II,4,4,6.0,8
19929967,Old Suttonians SV,Old Columbans,0,1,3.0,1
19930021,Old Wellingtonians,Kings College Wimbledon II,0,1,3.0,1
19929998,Kings College Wimbledon II,Old Wellingtonians,0,1,3.0,1
19926398,Old Westminsters II,Old Kingstonians KGS,5,0,0.0,5
19926427,Old Eastbournians,Old Wykehamists II,1,0,3.0,1
20584265,Old Cholmeleians II,Old Brentwoods II,1,3,3.0,4
20597565,Old Kimboltonians,Old Alleynians AFC III,4,4,6.0,8
20459921,Malvern College 1st XI,Old Malvernians,1,3,3.0,4
20510133,Sherborne School 1st XI,Old Shirburnians,0,2,2.0,2
19836192,Old Reptonians,Old Marlburians,4,7,3.0,11
20018055,Lancing Old Boys Vets,Old Wykehamists Vets,3,3,5.0,6
20478255,Old Foresters Vets,Old Brentwoods Vets,4,4,6.0,8
20533418,Old Wellingtonians Vets,Old Bradfieldians Vets,5,4,5.0,9
19702928,KCS Old Boys,Old Chigwellians,4,1,2.0,5
19702967,Old Etonians,Old Tonbridgians,4,1,2.0,5
19750537,Old Etonians II,Old Rugbeians,1,1,4.0,2
19750556,Old Rugbeians,Old Etonians II,1,0,3.0,1
19750559,Old Harrovians II,Old Aldenhamians,4,2,3.0,6
19930019,Old Carthusians III,Old Columbans,2,4,3.0,6
19929983,Old Johnians FC,Old Tonbridgians II,9,1,0.0,10
19890722,Old Shirburnians,Old Brentwoods II,1,5,2.0,6
19926424,Old Kingstonians KGS,Old Eastbournians,2,2,5.0,4
19926402,Old Berkhamstedians II,Old Wykehamists II,4,2,3.0,6
20570507,Old Amplefordians,Old Alleynians AFC III,1,5,2.0,6
20584027,Old Westminsters II,Old Kimboltonians,0,5,0.0,5
20570527,Old Alleynians AFC II,Old Stoics,5,1,2.0,6
20018066,Old Wykehamists Vets,Old Carthusians Vets,3,0,2.0,3
20536053,Old Westminsters Vets,Old Wykehamists Vets,3,0,2.0,3
20489642,Old Chigwellians Vets,Old Foresters Vets,2,0,2.0,2
19702946,KCS Old Boys,Old Harrovians,3,0,2.0,3
19836203,Old Berkhamstedians,Old Cholmeleians,2,2,5.0,4
19836216,Lancing Old Boys,Old Marlburians,4,2,3.0,6
19836201,Old Malvernians,Old Wykehamists,0,1,3.0,1
19836247,Old Radleians,Old Westminsters,4,3,4.0,7
19750529,Old Etonians II,Old Sennockians,5,0,0.0,5
19750566,Old Chigwellians II,Old Aldenhamians,0,1,3.0,1
19929952,Old Johnians FC,Old Wellingtonians,4,2,3.0,6
19929995,Old Suttonians SV,Old Carthusians III,4,3,4.0,7
19890738,Old Harrovians III,Old Bancroftians AFC,1,6,0.0,7
19890754,Old Stoics,Old Kimboltonians,3,8,0.0,11
19926404,Old Alleynians AFC III,Old Amplefordians,2,0,2.0,2
20388601,Old Bradfieldians,Old Rugbeians,5,1,2.0,6
20554168,Old Harrovians II,Old Columbans,0,1,3.0,1
20554158,Old Epsomians,Old Carthusians II,2,3,4.0,5
20530819,Old Wykehamists II,Old Brentwoods II,3,10,1.0,13
20554170,Old Westminsters II,Old Brentwoods III,4,2,3.0,6
19702913,Old Alleynians AFC,Old Etonians,2,2,5.0,4
19702922,Old Harrovians,Old Etonians,3,1,3.0,4
19836230,Old Berkhamstedians,Old Westminsters,1,3,3.0,4
19836191,Old Reptonians,Old Brentwoods,0,2,2.0,2
19750522,Old Harrovians II,Old Etonians II,2,4,3.0,6
19750555,Old Merchant Taylors,Old Carthusians II,0,6,0.0,6
19930016,Lancing Old Boys II,Old Wellingtonians,4,3,4.0,7
19929984,Old Johnians FC,Old Epsomians,2,2,5.0,4
19929986,Kings College Wimbledon II,Old Columbans,4,4,6.0,8
20446883,Old Kimboltonians,Old Tonbridgians,1,2,4.0,3
20399579,Old Alleynians AFC,Old Carthusians,2,3,4.0,5
20536039,Old Amplefordians,Old Bancroftians AFC,2,2,5.0,4
20537839,Old Merchant Taylors II,Old Alleynians AFC II,0,4,1.0,4
20554810,Old Alleynians AFC III,Old Gregorians,10,3,1.0,13
20554445,Old Cholmeleians II,Old Berkhamstedians II,4,2,3.0,6
20528638,Old Cholmeleians,Hale End Athletic,2,2,5.0,4
20521663,Old Brentwoods II,Alleyn Old Boys,1,3,3.0,4
20521963,Old Etonians Vets,Old Chigwellians Vets,2,1,4.0,3
19702960,Old Tonbridgians,Old Salopians,2,1,4.0,3
19702906,Old Chigwellians,Old Carthusians,1,9,0.0,10
19702950,Old Etonians,Old Harrovians,1,1,4.0,2
19836233,Old Berkhamstedians,Old Marlburians,1,3,3.0,4
19836215,Old Wykehamists,Old Radleians,5,2,2.0,7
19836260,Old Malvernians,Old Brentwoods,1,4,2.0,5
19750491,Old Aldenhamians,Old Chigwellians II,1,1,4.0,2
19750549,Old Etonians II,Old Merchant Taylors,4,1,2.0,5
19929957,Old Johnians FC,Lancing Old Boys II,4,1,2.0,5
19930008,Kings College Wimbledon II,Old Tonbridgians II,1,0,3.0,1
19890779,Old Salopians II,Old Brentwoods II,3,4,4.0,7
20489842,Old Merchant Taylors II,Old Haberdashers,2,5,2.0,7
19926422,Old Westminsters II,Old Amplefordians,0,2,2.0,2
20399622,Old Reptonians,KCS Old Boys,3,1,3.0,4
20492841,Old Eastbournians,Old Harrovians II,0,6,0.0,6
20499004,Old Epsomians,Old Rugbeians,3,1,3.0,4
20521660,Old Kingstonians KGS,Old Gregorians,3,5,4.0,8
20544315,Old Rugbeians II,Old Berkhamstedians II,2,5,2.0,7
20535885,Old Kimboltonians,Old Shirburnians,3,1,3.0,4
20512848,Old King's Scholars,Old Brentwoods III,3,3,5.0,6
19702961,Old Alleynians AFC,Old Salopians,4,1,2.0,5
19702919,KCS Old Boys,Old Tonbridgians,0,0,4.0,0
19702963,Old Foresters,Old Chigwellians,2,2,5.0,4
19836236,Old Berkhamstedians,Old Reptonians,2,1,4.0,3
19836227,Old Westminsters,Old Brentwoods,4,2,3.0,6
19836271,Old Radleians,Old Wykehamists,3,1,3.0,4
19750547,Old Rugbeians,Old Sennockians,2,0,2.0,2
19750538,Old Merchant Taylors,Old Harrovians II,5,5,6.0,10
19750509,Old Foresters II,Old Aldenhamians,2,2,5.0,4
19750543,Old Etonians II,Old Chigwellians II,5,4,5.0,9
19929959,Old Columbans,Old Johnians FC,0,3,2.0,3
19930001,Old Epsomians,Old Carthusians III,3,2,4.0,5
19890725,Old Bancroftians AFC,Old King's Scholars,2,0,2.0,2
19890762,Old Kimboltonians,Old Brentwoods II,1,1,4.0,2
19908630,Old Albanians SA,Old Cholmeleians II,5,3,4.0,8
20492843,Old Alleynians AFC II,Old Carthusians II,1,1,4.0,2
20512843,Old Merchant Taylors II,Old Harrovians III,0,0,4.0,0
20512841,Old Haberdashers,Old Amplefordians,1,4,2.0,5
20512842,Old Shirburnians,Old Eastbournians,2,1,4.0,3
20039309,Polytechnic,Old Carthusians,2,1,4.0,3
20311089,Old Malvernians Vets,Lancing Old Boys Vets,3,2,4.0,5
19702905,Old Bradfieldians,Old Alleynians AFC,1,3,3.0,4
19702941,Old Harrovians,Old Carthusians,2,5,2.0,7
19702904,KCS Old Boys,Old Salopians,6,1,0.0,7
19702942,Old Chigwellians,Old Tonbridgians,3,2,4.0,5
19702901,Old Etonians,Old Foresters,2,1,4.0,3
19836208,Old Brentwoods,Old Berkhamstedians,10,0,0.0,10
19836210,Old Westminsters,Old Radleians,3,1,3.0,4
19836254,Old Reptonians,Lancing Old Boys,1,2,4.0,3
19836225,Old Malvernians,Old Cholmeleians,0,1,3.0,1
19836222,Old Marlburians,Old Wykehamists,1,9,0.0,10
19750515,Old Rugbeians,Old Carthusians II,0,6,0.0,6
19750525,Old Sennockians,Old Merchant Taylors,9,0,0.0,9
19750554,Old Chigwellians II,Old Foresters II,2,2,5.0,4
19929951,Old Johnians FC,Old Suttonians SV,5,2,2.0,7
19929965,Old Columbans,Old Carthusians III,6,1,0.0,7
19929982,Old Epsomians,Old Wellingtonians,4,2,3.0,6
19930013,Old Tonbridgians II,Lancing Old Boys II,8,1,0.0,9
19890745,Old Alleynians AFC II,Old Stoics,2,0,2.0,2
19890790,Old Salopians II,Old Shirburnians,0,1,3.0,1
20489832,Old Albanians SA,Old Haberdashers,3,2,4.0,5
19908607,Old Merchant Taylors II,Old Brentwoods III,1,5,2.0,6
19926392,Old Kingstonians KGS,Old Berkhamstedians II,2,5,2.0,7
20477129,Old Etonians II,Old Tenisonians,3,0,2.0,3
20372574,Bealonians,Old Brentwoods II,1,5,2.0,6
19702929,Old Foresters,Old Salopians,2,2,5.0,4
19702924,KCS Old Boys,Old Bradfieldians,2,3,4.0,5
19702953,Old Etonians,Old Alleynians AFC,2,2,5.0,4
19702907,Old Harrovians,Old Tonbridgians,4,4,6.0,8
19836256,Old Berkhamstedians,Lancing Old Boys,3,3,5.0,6
19836265,Old Westminsters,Old Reptonians,1,3,3.0,4
19836221,Old Wykehamists,Old Malvernians,10,7,3.0,17
19750541,Old Foresters II,Old Etonians II,1,3,3.0,4
19750523,Old Merchant Taylors,Old Aldenhamians,2,3,4.0,5
19929972,Old Columbans,Lancing Old Boys II,4,0,1.0,4
19930002,Old Johnians FC,Kings College Wimbledon II,1,0,3.0,1
19890770,Old Shirburnians,Old Harrovians III,1,2,4.0,3
19890728,Old Alleynians AFC II,Old Bancroftians AFC,1,0,3.0,1
19890768,Old Salopians II,Old Stoics,4,5,5.0,9
19926400,Old Alleynians AFC III,Old Eastbournians,6,2,2.0,8
20447480,Old Rugbeians,Old Kimboltonians,2,1,4.0,3
20487762,Old Gregorians,TBC,3,3,5.0,6
20310986,Old Haileyburians Vets,Old Foresters Vets,1,3,3.0,4
20338556,Old Harrovians Vets,Old Brentwoods Vets,2,4,3.0,6
20241107,Old Carthusians Vets,Old Reptonians Vets,9,3,0.0,12
20348135,Old Salopians Vets,Old Tonbridgians Vets,0,4,1.0,4
19702939,Old Bradfieldians,Old Foresters,10,3,1.0,13
19702970,Old Etonians,Old Salopians,2,0,2.0,2
19702932,Old Harrovians,Old Chigwellians,1,4,2.0,5
19702968,KCS Old Boys,Old Alleynians AFC,5,0,0.0,5
19836253,Old Cholmeleians,Old Berkhamstedians,8,1,0.0,9
19836245,Lancing Old Boys,Old Brentwoods,1,2,4.0,3
19836195,Old Radleians,Old Marlburians,1,1,4.0,2
19836190,Old Malvernians,Old Westminsters,1,8,0.0,9
19750542,Old Aldenhamians,Old Foresters II,3,3,5.0,6
19750570,Old Merchant Taylors,Old Etonians II,0,0,4.0,0
19930017,Old Carthusians III,Kings College Wimbledon II,2,0,2.0,2
19890755,Old Kimboltonians,Old King's Scholars,2,2,5.0,4
19890743,Old Salopians II,Old Bancroftians AFC,1,0,3.0,1
19908658,Old Haberdashers,Old Brentwoods III,1,4,2.0,5
19926408,Old Alleynians AFC III,Old Berkhamstedians II,7,3,2.0,10
19926401,Old Kingstonians KGS,Old Amplefordians,2,3,4.0,5
19926420,Old Westminsters II,Old Wykehamists II,5,0,0.0,5
20447479,Old Alleynians AFC II,Old Johnians FC,3,2,4.0,5
20447481,Old Shirburnians,Old Sennockians,3,6,3.0,9
20447477,Old Cholmeleians II,Old Epsomians,1,6,0.0,7
20447482,Old Eastbournians,Old Suttonians SV,4,3,4.0,7
20391405,Old Harrovians II,Lancing Old Boys II,1,1,4.0,2
20447478,Old Tonbridgians II,Old Columbans,4,4,6.0,8
20372026,Old Carthusians II,Old Brentwoods II,2,0,2.0,2
20372598,Honourable Artillery Company,Old Carthusians,1,0,3.0,1
20398858,Old Wykehamists,Old Reptonians,0,1,3.0,1
20447457,Old Meadonians,Old Rugbeians,3,5,4.0,8
19702897,Old Foresters,Old Carthusians,1,5,2.0,6
19702908,Old Bradfieldians,Old Chigwellians,7,1,0.0,8
19702956,Old Salopians,Old Harrovians,1,1,4.0,2
19836189,Lancing Old Boys,Old Wykehamists,2,2,5.0,4
19836219,Old Cholmeleians,Old Brentwoods,4,4,6.0,8
19836220,Old Radleians,Old Reptonians,1,3,3.0,4
19750482,Old Aldenhamians,Old Etonians II,2,2,5.0,4
19750505,Old Foresters II,Old Sennockians,2,0,2.0,2
19750512,Old Rugbeians,Old Harrovians II,3,1,3.0,4
19750535,Old Carthusians II,Old Chigwellians II,5,0,0.0,5
19929979,Old Tonbridgians II,Old Epsomians,5,2,2.0,7
19890776,Old Brentwoods II,Old Shirburnians,5,1,2.0,6
19890761,Old Bancroftians AFC,Old Stoics,2,0,2.0,2
19908665,Old Brentwoods III,Old Albanians SA,1,6,0.0,7
20289817,Old Kimboltonians,Old Columbans,2,1,4.0,3
19537199,Dulwich College 1st XI,Old Alleynians AFC,3,3,5.0,6
19537200,Dulwich College 2nd XI,Old Alleynians AFC II,0,2,2.0,2
19537201,Dulwich College 3rd XI,Old Alleynians AFC III,0,5,0.0,5
19750572,"King's College School, Wimbledon 1st XI",KCS Old Boys,1,4,2.0,5
19750573,"King's College School, Wimbledon 2nd XI",Kings College Wimbledon II,0,0,4.0,0
19836206,Old Cholmeleians,Lancing Old Boys,5,1,2.0,6
19750494,Old Harrovians II,Old Carthusians II,0,3,2.0,3
19750514,Old Aldenhamians,Old Sennockians,2,0,2.0,2
19890763,Old King's Scholars,Old Shirburnians,2,1,4.0,3
19908644,Old Merchant Taylors II,Old Haberdashers,3,2,4.0,5
20214942,Old Suttonians SV,Old Reptonians,1,5,2.0,6
20242964,Old Alleynians AFC,Old Salopians,1,0,3.0,1
20289951,Old Wykehamists,Old Tonbridgians,1,6,0.0,7
20242720,Old Carthusians,Old Radleians,7,0,0.0,7
20283026,Old Rugbeians,Old Carthusians III,7,1,0.0,8
19702965,Old Alleynians AFC,Old Carthusians,0,2,2.0,2
19836223,Old Reptonians,Old Malvernians,1,0,3.0,1
19836199,Old Wykehamists,Old Brentwoods,2,3,4.0,5
19836226,Old Radleians,Old Berkhamstedians,4,4,6.0,8
19750513,Old Sennockians,Old Etonians II,4,7,3.0,11
19929970,Old Carthusians III,Old Wellingtonians,3,3,5.0,6
19929975,Old Tonbridgians II,Old Columbans,1,3,3.0,4
19890782,Old Kimboltonians,Old Alleynians AFC II,2,3,4.0,5
19890749,Old King's Scholars,Old Stoics,3,1,3.0,4
19890785,Old Harrovians III,Old Shirburnians,0,3,2.0,3
19926413,Old Wykehamists II,Old Berkhamstedians II,2,1,4.0,3
20243298,Old Westminsters,Old Rugbeians,2,3,4.0,5
20242975,Old Foresters,Old Bradfieldians,0,5,0.0,5
20267345,Old Harrovians,KCS Old Boys,2,3,4.0,5
20300167,Old Merchant Taylors,Old Cholmeleians II,2,5,2.0,7
20352526,Kings College Wimbledon II,Old Brentwoods II,2,4,3.0,6
19836209,Old Marlburians,Old Cholmeleians,1,6,0.0,7
20347298,Old Etonians Vets,Old Wykehamists Vets,0,1,3.0,1
20311694,Old Chigwellians Vets,Alleyn Old Boys,1,0,3.0,1
19702971,Old Foresters,Old Harrovians,2,1,4.0,3
19702926,Old Carthusians,Old Tonbridgians,11,1,0.0,12
19702883,Old Chigwellians,KCS Old Boys,0,3,2.0,3
19836224,Old Westminsters,Old Cholmeleians,1,2,4.0,3
19836211,Lancing Old Boys,Old Radleians,2,1,4.0,3
19836246,Old Malvernians,Old Reptonians,1,1,4.0,2
19836237,Old Marlburians,Old Brentwoods,3,6,3.0,9
19750521,Old Foresters II,Old Rugbeians,1,2,4.0,3
19929974,Old Suttonians SV,Old Johnians FC,1,3,3.0,4
19929994,Kings College Wimbledon II,Lancing Old Boys II,5,0,0.0,5
19890750,Old King's Scholars,Old Bancroftians AFC,2,1,4.0,3
19890792,Old Harrovians III,Old Stoics,1,1,4.0,2
19908649,Old Brentwoods III,Old Merchant Taylors II,1,5,2.0,6
19926430,Old Amplefordians,Old Wykehamists II,4,3,4.0,7
19926403,Old Kingstonians KGS,Old Westminsters II,3,3,5.0,6
20290342,Old Columbans,Old Berkhamstedians II,8,2,0.0,10
20283022,Old Kimboltonians,Old Aldenhamians,5,2,2.0,7
20292796,Old Alleynians AFC II,Old Chigwellians II,1,1,4.0,2
20290255,Old Epsomians,Old Albanians SA,5,2,2.0,7
20306901,Old Harrovians II,Old Rugbeians II,9,0,0.0,9
20283021,Old Tonbridgians II,Old Etonians II,2,2,5.0,4
20291884,Old Thorntonians,Old Carthusians II,5,1,2.0,6
20310881,Rob Roy Rovers,Old Wykehamists,1,2,4.0,3
20244681,Old Etonians,Old Minchendenians,3,5,4.0,8
20638917,London Lions Vets,Old Chigwellians Vets,4,2,3.0,6
20278962,Polytechnic,Old Cholmeleians II,6,2,2.0,8
20268291,West Wickham,Old Brentwoods II,2,3,4.0,5
19516920,Old Etonians Vets,Old Berkhamstedians Vets,1,0,3.0,1
20240977,Old Etonians Vets,Old Berkhamstedians Vets,0,1,3.0,1
19702911,Old Alleynians AFC,KCS Old Boys,2,4,3.0,6
19702887,Old Bradfieldians,Old Harrovians,4,6,4.0,10
19702957,Old Tonbridgians,Old Chigwellians,6,0,0.0,6
19836228,Old Wykehamists,Lancing Old Boys,4,0,1.0,4
19836207,Old Radleians,Old Malvernians,1,4,2.0,5
19836214,Old Reptonians,Old Westminsters,1,1,4.0,2
19750486,Old Carthusians II,Old Foresters II,6,1,0.0,7
19750544,Old Merchant Taylors,Old Sennockians,3,1,3.0,4
19929978,Old Columbans,Kings College Wimbledon II,7,2,0.0,9
19929999,Old Carthusians III,Lancing Old Boys II,4,1,2.0,5
19929993,Old Epsomians,Old Suttonians SV,4,2,3.0,6
19929991,Old Wellingtonians,Old Johnians FC,2,5,2.0,7
19890730,Old Shirburnians,Old Bancroftians AFC,7,2,0.0,9
19890736,Old Alleynians AFC II,Old King's Scholars,3,3,5.0,6
19890778,Old Harrovians III,Old Kimboltonians,3,5,4.0,8
19908625,Old Haberdashers,Old Albanians SA,1,6,0.0,7
19908663,Old Merchant Taylors II,Old Cholmeleians II,0,8,0.0,8
19926397,Old Alleynians AFC III,Old Wykehamists II,1,2,4.0,3
19926426,Old Berkhamstedians II,Old Kingstonians KGS,3,4,4.0,7
19926412,Old Eastbournians,Old Amplefordians,2,2,5.0,4
20251034,Old Foresters,Old Dorkinians,0,3,2.0,3
20251035,Winchmore Hill,Old Carthusians,0,5,0.0,5
20271496,Worcester College Old Boys,Old Cholmeleians,2,3,4.0,5
20295319,Old Thorntonians,Old Rugbeians,2,12,1.0,14
20294144,Old Etonians II,Old Owens,3,0,2.0,3
19702936,Old Salopians,Old Etonians,1,3,3.0,4
20018058,Old Wykehamists Vets,Old Harrovians Vets,3,2,4.0,5
19702959,Old Foresters,Old Alleynians AFC,2,0,2.0,2
19702969,Old Carthusians,Old Bradfieldians,2,3,4.0,5
19702937,Old Tonbridgians,Old Harrovians,2,1,4.0,3
19836255,Old Westminsters,Old Marlburians,4,3,4.0,7
19836212,Old Malvernians,Old Berkhamstedians,2,1,4.0,3
19836240,Old Radleians,Old Brentwoods,1,9,0.0,10
19750552,Old Foresters II,Old Carthusians II,1,4,2.0,5
19750510,Old Aldenhamians,Old Merchant Taylors,0,6,0.0,6
19750528,Old Chigwellians II,Old Harrovians II,1,0,3.0,1
19929996,Lancing Old Boys II,Old Johnians FC,1,3,3.0,4
19929955,Old Carthusians III,Old Suttonians SV,0,8,0.0,8
19890789,Old King's Scholars,Old Harrovians III,3,3,5.0,6
19890751,Old Salopians II,Old Kimboltonians,1,0,3.0,1
19890733,Old Stoics,Old Bancroftians AFC,1,1,4.0,2
19908666,Old Cholmeleians II,Old Haberdashers,5,2,2.0,7
19926405,Old Berkhamstedians II,Old Eastbournians,3,2,4.0,5
19926396,Old Kingstonians KGS,Old Wykehamists II,1,4,2.0,5
19926425,Old Alleynians AFC III,Old Westminsters II,4,2,3.0,6
20218639,Hale End Athletic,Old Chigwellians,3,1,3.0,4
20218640,Spaniards,Old Cholmeleians,2,0,2.0,2
20271556,Old Reptonians,IB Albion,2,1,4.0,3
19656412,Eton College 1st XI,Old Etonians,0,0,4.0,0
20321778,Eton College 2nd XI,Old Etonians II,0,0,4.0,0
20256254,Bealonians,Old Columbans,4,4,6.0,8
19465645,Old Wykehamists,Winchester College 1st XI,3,3,5.0,6
20018064,Lancing Old Boys Vets,Old Tonbridgians Vets,3,1,3.0,4
19516921,Old Wykehamists Vets,Old Chigwellians Vets,1,9,0.0,10
19516919,Old Foresters Vets,Old Aldenhamians Vets,9,2,0.0,11
20110877,Old Malvernians Vets,Old Tonbridgians Vets,7,0,0.0,7
20240979,Old Wykehamists Vets,Old Chigwellians Vets,9,1,0.0,10
20240975,Old Foresters Vets,Old Aldenhamians Vets,2,9,0.0,11
20240978,Old Malvernians Vets,Old Tonbridgians Vets,0,7,0.0,7
19702951,Old Salopians,Old Foresters,0,1,3.0,1
19702958,Old Carthusians,Old Chigwellians,4,1,2.0,5
19702964,Old Harrovians,KCS Old Boys,1,4,2.0,5
19836196,Old Reptonians,Old Cholmeleians,3,4,4.0,7
19836238,Old Westminsters,Old Malvernians,2,3,4.0,5
19750508,Old Carthusians II,Old Etonians II,2,0,2.0,2
19929956,Old Columbans,Old Wellingtonians,5,3,4.0,8
19930000,Old Epsomians,Old Johnians FC,1,1,4.0,2
19929985,Old Tonbridgians II,Old Carthusians III,5,1,2.0,6
19930011,Kings College Wimbledon II,Old Suttonians SV,3,2,4.0,5
19890777,Old King's Scholars,Old Alleynians AFC II,0,1,3.0,1
19890767,Old Kimboltonians,Old Harrovians III,4,0,1.0,4
19890735,Old Bancroftians AFC,Old Salopians II,2,2,5.0,4
19890726,Old Stoics,Old Shirburnians,2,4,3.0,6
19926391,Old Amplefordians,Old Westminsters II,1,3,3.0,4
19926421,Old Eastbournians,Old Alleynians AFC III,3,4,4.0,7
20271428,Old Merchant Taylors II,Old Brentwoods II,1,2,4.0,3
19467229,Lancing College 1st XI,Lancing Old Boys,2,3,4.0,5
19467230,Lancing College 2nd XI,Lancing Old Boys II,2,2,5.0,4
20149125,New College Old Boys,Old Wykehamists,1,8,0.0,9
19702935,Old Alleynians AFC,Old Bradfieldians,3,2,4.0,5
20139305,Old Cholmeleians Vets,Lancing Old Boys Vets,2,2,5.0,4
19516918,Old Haileyburians Vets,Old Wellingtonians Vets,7,1,0.0,8
20139263,Old Harrovians Vets,Old Salopians Vets,3,2,4.0,5
20240974,Old Haileyburians Vets,Old Wellingtonians Vets,1,7,0.0,8
20240976,Old Cholmeleians Vets,Lancing Old Boys Vets,2,2,5.0,4
20240980,Old Harrovians Vets,Old Salopians Vets,2,3,4.0,5
19685998,Old Ignatians,Old Chigwellians Vets,1,7,0.0,8
19685999,Old Foresters Vets,Enfield Old Grammarians,8,1,0.0,9
19702944,Old Foresters,KCS Old Boys,0,2,2.0,2
19702927,Old Harrovians,Old Salopians,1,1,4.0,2
19702934,Old Tonbridgians,Old Alleynians AFC,2,2,5.0,4
19702931,Old Carthusians,Old Etonians,3,1,3.0,4
19702920,Old Chigwellians,Old Bradfieldians,2,7,0.0,9
19836200,Old Brentwoods,Old Marlburians,6,1,0.0,7
19836252,Old Reptonians,Old Radleians,3,1,3.0,4
19836269,Old Cholmeleians,Old Westminsters,1,1,4.0,2
19750569,Old Aldenhamians,Old Rugbeians,0,4,1.0,4
19750562,Old Foresters II,Old Merchant Taylors,1,3,3.0,4
19929973,Old Suttonians SV,Old Tonbridgians II,4,1,2.0,5
19929980,Kings College Wimbledon II,Old Johnians FC,1,2,4.0,3
19571044,Old Sennockians,Old Wykehamists,1,2,4.0,3
19571033,Old Malvernians,Old Kimboltonians,1,3,3.0,4
20271412,Old Alleynians AFC III,Old Stoics,2,0,2.0,2
20271421,Old Brentwoods III,Old Berkhamstedians II,2,4,3.0,6
20271425,Old Shirburnians,Old Kingstonians KGS,2,2,5.0,4
20270737,Old Westminsters II,Old Albanians SA,2,2,5.0,4
20270794,Old Amplefordians,Old Alleynians AFC II,1,4,2.0,5
20270792,Old Harrovians III,Old Bancroftians AFC,3,1,3.0,4
20270747,Old King's Scholars,Old Eastbournians,2,3,4.0,5
20270791,Old Salopians II,Old Haberdashers,5,2,2.0,7
20175880,West Wickham,Old Carthusians II,0,3,2.0,3
19685905,Old Etonians II,Old Blues,7,0,0.0,7
20270400,Lancing Old Boys,Lancing Old Boys II,0,0,4.0,0
19750487,Old Chigwellians II,Old Citizens,3,0,2.0,3
20197614,Hale End Athletic,Old Chigwellians Vets,2,4,3.0,6
19702948,Old Tonbridgians,Old Foresters,5,0,0.0,5
19836267,Old Brentwoods,Lancing Old Boys,11,2,1.0,13
19836268,Old Radleians,Old Cholmeleians,1,3,3.0,4
19836198,Old Reptonians,Old Berkhamstedians,0,2,2.0,2
19750550,Old Harrovians II,Old Chigwellians II,6,0,0.0,6
19750530,Old Merchant Taylors,Old Foresters II,3,1,3.0,4
19929988,Lancing Old Boys II,Old Columbans,1,2,4.0,3
19929971,Old Epsomians,Old Tonbridgians II,2,2,5.0,4
19890765,Old Harrovians III,Old Alleynians AFC II,2,0,2.0,2
19890786,Old Kimboltonians,Old Salopians II,3,0,2.0,3
19926410,Old Wykehamists II,Old Kingstonians KGS,1,3,3.0,4
19926394,Old Eastbournians,Old Berkhamstedians II,5,3,4.0,8
19571043,KCS Old Boys,Old Aldenhamians,10,0,0.0,10
20149126,IB Albion,Old Malvernians,8,1,0.0,9
20240915,Old King's Scholars,Bealonians,1,2,4.0,3
20090201,Old Cholmeleians II,South Bank Cuaco,4,2,3.0,6
20198416,Old Minchendenians,Old Brentwoods II,2,4,3.0,6
19702923,Old Salopians,Old Carthusians,2,5,2.0,7
19702962,Old Bradfieldians,Old Etonians,2,1,4.0,3
20018067,KCS Old Boys Vets,Old Wykehamists Vets,4,6,4.0,10
20155295,Old Brentwoods Vets,Old Finchleians,0,5,0.0,5
19702899,Old Etonians,Old Chigwellians,4,1,2.0,5
19702945,Old Harrovians,Old Alleynians AFC,5,5,6.0,10
19702916,Old Tonbridgians,KCS Old Boys,2,2,5.0,4
19836257,Old Marlburians,Old Radleians,2,1,4.0,3
19750532,Old Foresters II,Old Chigwellians II,0,4,1.0,4
19750502,Old Harrovians II,Old Merchant Taylors,4,2,3.0,6
19750539,Old Carthusians II,Old Aldenhamians,4,1,2.0,5
19929987,Lancing Old Boys II,Old Carthusians III,1,5,2.0,6
19929969,Old Suttonians SV,Kings College Wimbledon II,3,2,4.0,5
19930014,Old Wellingtonians,Old Epsomians,2,2,5.0,4
19890791,Old Alleynians AFC II,Old Brentwoods II,4,1,2.0,5
19890775,Old King's Scholars,Old Salopians II,4,2,3.0,6
19890752,Old Stoics,Old Harrovians III,3,1,3.0,4
19908616,Old Albanians SA,Old Brentwoods III,2,3,4.0,5
19908614,Old Haberdashers,Old Cholmeleians II,2,2,5.0,4
19926399,Old Wykehamists II,Old Eastbournians,2,2,5.0,4
19926407,Old Westminsters II,Old Berkhamstedians II,2,3,4.0,5
19571034,Old Rugbeians,Old Bancroftians AFC,5,1,2.0,6
19571045,Old Bradfieldians,Old Shirburnians,4,0,1.0,4
19571038,Old Carthusians,Old Kingstonians KGS,9,0,0.0,9
19571037,Old Salopians,Lancing Old Boys,7,1,0.0,8
19571032,Old Columbans,Old Brentwoods,1,0,3.0,1
19977638,Old Foresters,Wake Green Amateur,7,0,0.0,7
20175986,Old Reptonians,Southgate County,6,3,3.0,9
20149124,Globe Rangers,Old Cholmeleians,0,1,3.0,1
19750551,Old Etonians II,Old Citizens,3,2,4.0,5
20176044,Old Sennockians,Glyn Old Boys,0,2,2.0,2
19685996,Old Foresters Vets,Old Owens,6,1,0.0,7
19702952,Old Carthusians,Old Harrovians,3,1,3.0,4
19702885,Old Salopians,Old Bradfieldians,0,2,2.0,2
19836204,Old Wykehamists,Old Westminsters,5,2,2.0,7
19836242,Old Brentwoods,Old Malvernians,4,2,3.0,6
19750527,Old Carthusians II,Old Rugbeians,4,1,2.0,5
19930020,Old Epsomians,Lancing Old Boys II,3,2,4.0,5
19929977,Old Johnians FC,Old Carthusians III,7,1,0.0,8
19929990,Old Tonbridgians II,Old Suttonians SV,1,3,3.0,4
19890784,Old Brentwoods II,Old Bancroftians AFC,2,1,4.0,3
19890756,Old Shirburnians,Old Salopians II,1,0,3.0,1
19926395,Old Wykehamists II,Old Westminsters II,2,5,2.0,7
19926418,Old Alleynians AFC III,Old Kingstonians KGS,6,2,2.0,8
19571031,Old Berkhamstedians,Old Tonbridgians,0,2,2.0,2
19571036,Old Foresters,Old Marlburians,2,1,4.0,3
19571040,Old Amplefordians,Old Radleians,4,5,5.0,9
19571046,Old Reptonians,Old Eastbournians,8,0,0.0,8
19571039,Old Alleynians AFC,Old Merchant Taylors,4,1,2.0,5
19836020,Old Tollingtonians,Old Cholmeleians,1,3,3.0,4
19836021,Old Woodhouseians,Lancing Old Boys,5,0,0.0,5
19836019,Old Chigwellians,New College Old Boys,3,3,5.0,6
19685904,Old Finchleians,Old Foresters II,6,5,5.0,11
19685903,Old Harrovians II,Old Minchendenians,3,4,4.0,7
19685978,Old King's Scholars,Old Lyonians,3,4,4.0,7
20194991,Mill Hill Village,Old Columbans,3,4,4.0,7
20179671,IB Albion,KCS Old Boys,5,3,4.0,8
20195923,Kings College Wimbledon II,Rapid Chingford,1,5,2.0,6
19702898,Old Bradfieldians,Old Tonbridgians,2,2,5.0,4
19702917,Old Carthusians,KCS Old Boys,1,2,4.0,3
19836232,Old Cholmeleians,Old Radleians,2,2,5.0,4
19836258,Old Reptonians,Old Wykehamists,2,1,4.0,3
19836213,Old Marlburians,Old Berkhamstedians,6,0,0.0,6
19750565,Old Carthusians II,Old Merchant Taylors,2,1,4.0,3
19750571,Old Sennockians,Old Chigwellians II,2,1,4.0,3
19750488,Old Etonians II,Old Harrovians II,1,2,4.0,3
19930010,Old Suttonians SV,Lancing Old Boys II,1,1,4.0,2
19930006,Kings College Wimbledon II,Old Carthusians III,1,2,4.0,3
19930018,Old Columbans,Old Epsomians,5,1,2.0,6
19890771,Old Kimboltonians,Old Bancroftians AFC,5,1,2.0,6
19890734,Old Alleynians AFC II,Old Harrovians III,10,2,0.0,12
19890740,Old Stoics,Old Salopians II,7,0,0.0,7
19908643,Old Cholmeleians II,Old Brentwoods III,9,2,0.0,11
19926414,Old Amplefordians,Old Kingstonians KGS,5,3,4.0,8
19571041,Old Westminsters,Old Chigwellians,4,2,3.0,6
19571035,Old Etonians,Old Harrovians,0,3,2.0,3
19835282,Alleyn Old Boys,Old Salopians,3,1,3.0,4
20114559,Old Rugbeians,Sinjun Grammarians,3,0,2.0,3
20189275,Lancing Old Boys,Old Blues,1,1,4.0,2
19892303,Gas Recreation FC,Old Foresters,3,1,3.0,4
19685997,Old Brentwoods Vets,Old Haileyburians Vets,0,5,0.0,5
19702894,Old Alleynians AFC,Old Tonbridgians,2,0,2.0,2
19702895,Old Bradfieldians,KCS Old Boys,1,5,2.0,6
19702954,Old Carthusians,Old Foresters,2,0,2.0,2
19702896,Old Chigwellians,Old Harrovians,1,5,2.0,6
19836202,Old Westminsters,Lancing Old Boys,6,7,5.0,13
19836194,Old Wykehamists,Old Cholmeleians,1,1,4.0,2
19836251,Old Marlburians,Old Malvernians,1,1,4.0,2
19750563,Old Harrovians II,Old Rugbeians,3,1,3.0,4
19750493,Old Chigwellians II,Old Merchant Taylors,2,0,2.0,2
19750501,Old Etonians II,Old Foresters II,5,3,4.0,8
19929961,Lancing Old Boys II,Kings College Wimbledon II,0,2,2.0,2
19929962,Old Suttonians SV,Old Epsomians,6,1,0.0,7
19929963,Old Tonbridgians II,Old Johnians FC,3,0,2.0,3
19929964,Old Wellingtonians,Old Carthusians III,4,2,3.0,6
19890783,Old King's Scholars,Old Brentwoods II,1,4,2.0,5
19890769,Old Kimboltonians,Old Stoics,4,2,3.0,6
19890753,Old Bancroftians AFC,Old Shirburnians,0,2,2.0,2
19908635,Old Brentwoods III,Old Haberdashers,2,8,0.0,10
19908650,Old Cholmeleians II,Old Albanians SA,5,4,5.0,9
19926431,Old Berkhamstedians II,Old Westminsters II,1,3,3.0,4
19926417,Old Wykehamists II,Old Alleynians AFC III,0,5,0.0,5
19926415,Old Eastbournians,Old Kingstonians KGS,3,1,3.0,4
20100477,Blackheath Wanderers (Youth) First Team,Old Citizens,3,2,4.0,5
19836177,Reigatians,Old Carthusians II,1,4,2.0,5
20109553,Old Aldenhamians,Old Reptonians,0,5,0.0,5
19685751,Old Brentwoods,Old Etonians,3,4,4.0,7
20018606,Old Wilsonians,Old Sennockians,0,5,0.0,5
20019670,Albanian FC,Old Aldenhamians II,2,5,2.0,7
20018063,KCS Old Boys Vets,Old Carthusians Vets,5,3,4.0,8
19516916,Old Carthusians Vets,KCS Old Boys Vets,3,5,4.0,8
19516915,Old Harrovians Vets,Old Reptonians Vets,6,3,3.0,9
19516914,Old Westminsters Vets,Old Cholmeleians Vets,2,4,3.0,6
19702909,Old Carthusians,Old Alleynians AFC,4,1,2.0,5
19702892,Old Harrovians,Old Foresters,3,2,4.0,5
19702893,Old Salopians,Old Chigwellians,3,2,4.0,5
19702938,KCS Old Boys,Old Etonians,0,0,4.0,0
19836205,Old Brentwoods,Old Westminsters,1,4,2.0,5
19836182,Old Marlburians,Old Reptonians,4,2,3.0,6
19836239,Lancing Old Boys,Old Berkhamstedians,2,0,2.0,2
19750534,Old Rugbeians,Old Merchant Taylors,3,2,4.0,5
19750496,Old Aldenhamians,Old Harrovians II,1,3,3.0,4
19750498,Old Etonians II,Old Carthusians II,1,2,4.0,3
19750506,Old Chigwellians II,Old Sennockians,1,2,4.0,3
19929981,Old Suttonians SV,Old Wellingtonians,3,2,4.0,5
19929960,Old Carthusians III,Old Epsomians,0,2,2.0,2
19929966,Old Tonbridgians II,Kings College Wimbledon II,5,0,0.0,5
19890748,Old Alleynians AFC II,Old Salopians II,8,3,0.0,11
19890773,Old Harrovians III,Old Brentwoods II,1,3,3.0,4
19890739,Old Shirburnians,Old Kimboltonians,2,3,4.0,5
19908628,Old Cholmeleians II,Old Merchant Taylors II,7,2,0.0,9
19926419,Old Amplefordians,Old Eastbournians,2,2,5.0,4
19926411,Old Westminsters II,Old Alleynians AFC III,2,3,4.0,5
19852906,Spaniards,Old Malvernians,3,3,5.0,6
19871158,Old Wykehamists,London Welsh F.C.,3,1,3.0,4
19908652,Old Chigwellians III,Old Albanians SA,1,3,3.0,4
20019666,Somerville Old Boys,Old Columbans,2,3,4.0,5
19702891,Old Foresters,Old Etonians,0,2,2.0,2
19702890,Old Alleynians AFC,Old Harrovians,7,0,0.0,7
19702903,Old Tonbridgians,Old Bradfieldians,4,1,2.0,5
19836234,Old Brentwoods,Old Reptonians,8,0,0.0,8
19836187,Old Cholmeleians,Old Malvernians,2,1,4.0,3
19836188,Old Wykehamists,Old Berkhamstedians,3,0,2.0,3
19836244,Old Marlburians,Lancing Old Boys,1,1,4.0,2
19750490,Old Foresters II,Old Harrovians II,3,6,3.0,9
19750564,Old Sennockians,Old Aldenhamians,3,3,5.0,6
19929958,Lancing Old Boys II,Old Suttonians SV,1,5,2.0,6
19930012,Old Johnians FC,Old Columbans,7,2,0.0,9
19930015,Old Wellingtonians,Old Tonbridgians II,1,4,2.0,5
19890758,Old Bancroftians AFC,Old Harrovians III,0,2,2.0,2
19890747,Old King's Scholars,Old Kimboltonians,2,5,2.0,7
19890757,Old Stoics,Old Alleynians AFC II,3,5,4.0,8
19908610,Old Merchant Taylors II,Old Albanians SA,2,4,3.0,6
19926429,Old Berkhamstedians II,Old Alleynians AFC III,2,5,2.0,7
19926406,Old Wykehamists II,Old Amplefordians,2,3,4.0,5
19926409,Old Eastbournians,Old Westminsters II,2,2,5.0,4
19494153,Charterhouse School 1st XI,Old Carthusians,0,5,0.0,5
19494155,Charterhouse School 1st XI,Old Carthusians III,1,3,3.0,4
19494154,Charterhouse School 2nd XI,Old Carthusians II,0,0,4.0,0
19493580,Chigwell School 1st XI,Old Chigwellians,0,3,2.0,3
19493581,Chigwell School 2nd XI,Old Chigwellians II,0,0,4.0,0
19493582,Chigwell School 3rd XI,Old Chigwellians III,0,0,4.0,0
19657706,Shrewsbury School 1st XI,Old Salopians,1,2,4.0,3
19657707,Shrewsbury School 2nd XI,Old Salopians II,1,4,2.0,5
19843671,Old Dorkinians,Old Rugbeians,3,5,4.0,8
19685876,Old Etonians II,Old Merchant Taylors,4,1,2.0,5
19835953,Old Brentwoods II,Wood Green Old Boys,7,1,0.0,8
20080998,KCS Old Boys,West Fulham,4,2,3.0,6
19702925,Old Alleynians AFC,Old Foresters,3,3,5.0,6
19702915,Old Harrovians,Old Bradfieldians,4,3,4.0,7
19702933,Old Salopians,KCS Old Boys,1,3,3.0,4
19702889,Old Tonbridgians,Old Carthusians,0,2,2.0,2
19702888,Old Chigwellians,Old Etonians,2,5,2.0,7
19836259,Old Berkhamstedians,Old Radleians,3,3,5.0,6
19836185,Lancing Old Boys,Old Cholmeleians,3,2,4.0,5
19836186,Old Marlburians,Old Westminsters,4,3,4.0,7
19750561,Old Chigwellians II,Old Etonians II,3,0,2.0,3
19750503,Old Aldenhamians,Old Carthusians II,3,2,4.0,5
19929992,Old Carthusians III,Old Tonbridgians II,0,3,2.0,3
19929989,Old Epsomians,Kings College Wimbledon II,3,2,4.0,5
19930022,Old Wellingtonians,Old Columbans,2,3,4.0,5
19890746,Old Harrovians III,Old Salopians II,1,1,4.0,2
19908602,Old Albanians SA,Old Merchant Taylors II,3,0,2.0,3
19926423,Old Amplefordians,Old Berkhamstedians II,0,2,2.0,2
19926432,Old Kingstonians KGS,Old Alleynians AFC III,1,4,2.0,5
19926416,Old Westminsters II,Old Eastbournians,4,0,1.0,4
19527717,Brentwood School 1st XI,Old Brentwoods,2,6,2.0,8
19527718,Brentwood School 2nd XI,Old Brentwoods II,4,1,2.0,5
19527719,Brentwood School 3rd XI,Old Brentwoods III,6,1,0.0,7
19527952,Brentwood School 4th XI,Old Brentwoods Vets,0,0,4.0,0
19465643,Kimbolton School 1st XI,Old Kimboltonians,1,1,4.0,2
19835276,Old Foresters II,Old Suttonians,0,5,0.0,5
19835954,Old Cholmeleians II,Southgate County,2,1,4.0,3
19702966,Old Bradfieldians,Old Salopians,6,4,4.0,10
19702884,Old Etonians,Old Carthusians,1,1,4.0,2
19702918,Old Chigwellians,Old Alleynians AFC,1,4,2.0,5
19836266,Old Berkhamstedians,Old Malvernians,4,0,1.0,4
19836250,Old Brentwoods,Old Cholmeleians,0,2,2.0,2
19836184,Old Radleians,Lancing Old Boys,2,3,4.0,5
19750484,Old Rugbeians,Old Chigwellians II,1,2,4.0,3
19750531,Old Etonians II,Old Aldenhamians,5,1,2.0,6
19750485,Old Sennockians,Old Carthusians II,1,2,4.0,3
19930007,Old Columbans,Old Suttonians SV,1,3,3.0,4
19930009,Old Carthusians III,Old Johnians FC,3,6,3.0,9
19929954,Old Tonbridgians II,Old Wellingtonians,2,2,5.0,4
19929953,Kings College Wimbledon II,Old Epsomians,1,1,4.0,2
19890732,Old Brentwoods II,Old Salopians II,2,1,4.0,3
19890731,Old Alleynians AFC II,Old Shirburnians,9,0,0.0,9
19890723,Old Bancroftians AFC,Old Kimboltonians,2,5,2.0,7
19890787,Old Stoics,Old King's Scholars,3,2,4.0,5
19908633,Old Haberdashers,Old Merchant Taylors II,5,1,2.0,6
19926428,Old Amplefordians,Old Alleynians AFC III,4,1,2.0,5
19493595,Harrow School 1st XI,Old Harrovians,0,0,4.0,0
19493596,Harrow School 2nd XI,Old Harrovians II,0,0,4.0,0
19493597,Harrow School 3rd XI,Old Harrovians III,0,0,4.0,0
19977735,Kingston Grammar School 1st XI,Old Kingstonians KGS,5,3,4.0,8
19465664,Marlborough College 1st XI,Old Marlburians,3,7,2.0,10
19908646,Old Chigwellians III,Old Cholmeleians II,0,3,2.0,3
19628666,Old Berkhamstedians,Old Wykehamists,2,4,3.0,6
19654754,Eton College 1st XI,Old Etonians,1,3,3.0,4
19654755,Eton College 2nd XI,Old Etonians II,0,0,4.0,0
19516394,Forest School 1st XI,Old Foresters,0,4,1.0,4
19465668,Highgate School 1st XI,Old Cholmeleians,0,0,4.0,0
19465667,Repton School 1st XI,Old Reptonians,0,0,4.0,0
19541041,Old Epsomians,Old Whitgiftians,0,0,4.0,0
19795577,Old Merchant Taylors,Old Harrovians II,2,1,4.0,3
19942080,Old Suttonians SV,Old Rugbeians,4,2,3.0,6
19835052,Old Brentwoods,Old Brentwoods II,1,0,3.0,1
19988208,Old Aldenhamians,Old Albanians SA,4,4,6.0,8
19510834,Old Carthusians,Old Parkonians,2,4,3.0,6
19631430,Old King's Scholars,Old Amplefordians,4,2,3.0,6
19585167,Old Sennockians,St Lawrence,1,2,4.0,3
19520373,Old Reptonians,Old Malvernians,4,1,2.0,5
19538134,Old Alleynians AFC,Old Marlburians,3,1,3.0,4
19720101,Nottsborough FC,Old Carthusians,3,6,3.0,9
19668988,Lancing Old Boys,Old Kingstonians KGS,3,0,2.0,3
19799263,Old Harrovians,Old Tonbridgians,3,2,4.0,5
19856315,Old Suttonians SV,Old Berkhamstedians,0,4,1.0,4
19786697,Old Westminsters II,Old Berkhamstedians II,2,6,2.0,8
19710413,Old King's Scholars,Old Shirburnians,1,1,4.0,2
19835513,Old Malvernians,Old Etonians,2,4,3.0,6
19538119,Old Alleynians AFC,Old Harrovians,3,2,4.0,5
19538125,Old Alleynians AFC II,Old Rugbeians,1,0,3.0,1
19585166,Old Sennockians,Old Harrovians II,2,3,4.0,5
19737980,Old Westminsters,Old Reptonians,1,4,2.0,5
19668987,Lancing Old Boys,Corinthian-Casuals,4,1,2.0,5
19744940,Old Brentwoods,Old Foresters,5,4,5.0,9
19705488,Old Carthusians,Old Hamptonians,2,2,5.0,4
19628665,Old Wykehamists,Lancing Old Boys,4,1,2.0,5
19538115,Old Tonbridgians II,Old Alleynians AFC II,1,1,4.0,2
19753384,Old Carthusians II,Old Carthusians III,3,1,3.0,4
19538114,Old Tonbridgians,Old Alleynians AFC,1,3,3.0,4
19538110,Old Alleynians AFC,Old Malvernians,4,1,2.0,5
19629479,Old Rugbeians,Old Carthusians III,1,4,2.0,5
19538109,Old Alleynians AFC,Old Hamptonians,1,2,4.0,3
19523240,Old Reptonians,Vauxhall Invitational XI,3,1,3.0,4
20312078,Old Wellingtonians Vets,Old Aldenhamians Vets,1,0,3.0,1
21754725,Kimbolton School 1st XI,Old Kimboltonians,0,5,0.0,5
21770948,Shrewsbury School 1st XI,Old Salopians,1,0,3.0,1
21762661,Old Rugbeians,Jersey Royals,4,0,1.0,4
21833221,Haberdashers Aske School 1st XI,Old Haberdashers,0,2,2.0,2
21771050,Brentwood School 1st XI,Old Brentwoods,0,2,2.0,2
21771052,Brentwood School 3rd XI,Old Brentwoods III,2,8,0.0,10
21770842,Forest School 1st XI,Old Foresters,0,7,0.0,7
21809896,Kings College Wimbledon II,Old Johnians,1,3,3.0,4
21762666,Old Reptonians,Old Alleynians,1,7,0.0,8
21755810,Old Reptonians,KCS Old Boys,1,8,0.0,9
21805099,Old Alleynians,Yorxeter FC,2,1,4.0,3
21803838,Old Etonians,Actonians Association,0,1,3.0,1
21766754,Old Etonians,Old Ardinians,5,1,2.0,6
21734201,Old Westminsters II,Old Haberdashers,0,1,3.0,1
21747760,Old Merchant Taylors' II,Old Barryians,2,2,5.0,4
21728449,Old Chigwellians Vets,Old Brentwoods Vets,3,1,3.0,4
21728392,Old Foresters Vets,Old Westminsters Vets,4,1,2.0,5
21734237,Old Salopians,Old Foresters,2,4,3.0,6
21727383,Old Ardinians,Kings College Wimbledon II,2,1,4.0,3
21727101,Old Cholmeleians II,Old Albanians SA,0,2,2.0,2
21727221,Old Salopians,KCS Old Boys,3,2,4.0,5
21727552,Old Alleynians,Old Foresters,0,3,2.0,3
21731849,Old Cholmeleians,Old Berkhamstedians,2,3,4.0,5
21727288,Old Aldenhamians,Old Epsomians,1,2,4.0,3
21725124,Old Westminsters II,Old King's Scholars,5,1,2.0,6
21724203,Old Carthusians,Winchmore Hill,3,0,2.0,3
21707604,Old Brentwoods Vets,KCS Old Boys Vets,3,1,3.0,4
21698893,Old Harrovians Vets,Old Chigwellians Vets,1,4,2.0,5
21695239,Old Foresters Vets,Old Carthusians Vets,4,3,4.0,7
21674719,Old Reptonians,Old Foresters,1,2,4.0,3
21674327,KCS Old Boys,Old Tonbridgians,3,2,4.0,5
21710124,Old Salopians,Old Rugbeians,1,1,4.0,2
21710032,Old Radleians,Old Berkhamstedians,0,2,2.0,2
21706369,Old Kimboltonians,Old Ardinians,1,5,2.0,6
21706312,Old Stoics,Old Albanians SA,1,2,4.0,3
21703815,Old Aldenhamians,Old Merchant Taylors,0,0,4.0,0
21703813,Old Columbans,Old Epsomians,1,7,0.0,8
21445857,Old Brentwoods Vets,Lancing Old Boys Vets,3,1,3.0,4
21686362,KCS Old Boys Vets,Old Etonians Vets,1,0,3.0,1
21675046,Old Salopians,Old Kimboltonians,3,2,4.0,5
21684714,Old Alleynians,Old Wykehamists,5,3,4.0,8
21673262,Old Westminsters,Old Brentwoods,2,2,5.0,4
21696607,Old Ardinians,Old Alleynians II,4,2,3.0,6
21696315,Old Chigwellians II,Kings College Wimbledon II,1,4,2.0,5
21696355,Old Wellingtonians,Old Albanians SA,2,3,4.0,5
21696416,Old Cholmeleians II,Old Brentwoods III,2,1,4.0,3
21703694,Old Merchant Taylors,Old Aldenhamians,1,6,0.0,7
21703693,Old Epsomians,Old Columbans,0,3,2.0,3
21699795,Old Amplefordians,Old Haberdashers,0,6,0.0,6
21698964,Old Merchant Taylors' II,Old Westminsters II,1,2,4.0,3
21699802,Old Reptonians,KCS Old Boys,2,2,5.0,4
21438422,Old Chigwellians Vets,Old Cholmeleians Vets,4,0,1.0,4
21687868,Old Cholmeleians,Old Chigwellians,2,0,2.0,2
21687858,Old Kimboltonians,Old Radleians,2,1,4.0,3
21667574,Old Epsomians,Old Ardinians,0,0,4.0,0
21687857,Old Chigwellians II,Old Aldenhamians,3,2,4.0,5
21689061,Old Shirburnians,Old Brentwoods III,1,3,3.0,4
21689112,Old Wellingtonians,Old Ardinians,3,0,2.0,3
21684904,Old Cholmeleians II,Old Kingstonians KGS,6,1,0.0,7
21687878,Old Stoics,Old Alleynians AFC III,3,1,3.0,4
21675100,West Wickham,Old Carthusians,3,3,5.0,6
21679793,Old Alleynians,KCS Old Boys,1,3,3.0,4
21256212,KCS Old Boys Vets,Old Foresters Vets,4,1,2.0,5
21437616,Old Etonians Vets,Old Haileyburians Vets,6,0,0.0,6
21437596,Old Harrovians Vets,Old Salopians Vets,9,0,0.0,9
21406911,Old Cholmeleians,Old Wykehamists,2,2,5.0,4
21679851,Old Alleynians,Old Rugbeians,8,1,0.0,9
21681939,Old Chigwellians,Old Chigwellians II,3,3,5.0,6
21667573,Old Kimboltonians,Old Sennockians,3,1,3.0,4
21674232,Old Radleians,Old Etonians II,4,3,4.0,7
21674308,Old Aldenhamians,Old Columbans,4,4,6.0,8
21675328,Old Harrovians II,Kings College Wimbledon II,3,5,4.0,8
21671794,Old Wykehamists II,Old Wellingtonians,0,1,3.0,1
21672549,Old Amplefordians,Old Brentwoods III,0,8,0.0,8
21668178,Old Albanians SA,Old King's Scholars,2,0,2.0,2
21674371,Old Cholmeleians II,Old Haberdashers,1,1,4.0,2
21680825,Old Reptonians,Old Kingstonians KGS,3,0,2.0,3
21678830,Nottsborough FC,Old Carthusians,1,1,4.0,2
21256057,Old Tonbridgians Vets,Old Chigwellians Vets,1,2,4.0,3
21406910,Old Etonians,Old Salopians,0,1,3.0,1
21406912,Old Foresters,Lancing Old Boys,5,1,2.0,6
21436680,Old Kimboltonians,Old Malvernians,5,3,4.0,8
21406907,Old Sennockians,Old Tonbridgians,0,6,0.0,6
21667576,Old Carthusians II,Old Alleynians II,3,3,5.0,6
21667572,Old Harrovians II,Old Suttonians SV,5,1,2.0,6
21667571,Old Aldenhamians,Old Tonbridgians II,5,1,2.0,6
21667569,Old Chigwellians II,Old Carthusians III,2,0,2.0,2
21667570,Old Merchant Taylors,Old Radleians,1,5,2.0,6
21668155,Old Brentwoods IV,Old Haberdashers,1,5,2.0,6
21668156,Old Kingstonians KGS,Old Westminsters II,3,2,4.0,5
21668175,Old Alleynians AFC III,Old Eastbournians,3,2,4.0,5
21671804,Old Ardinians,Lancing Old Boys II,5,3,4.0,8
21668176,Old Merchant Taylors' II,Old Shirburnians,1,3,3.0,4
21669403,Old Stoics,Old Harrovians III,2,0,2.0,2
21668837,Old Albanians SA,Old Cholmeleians II,1,2,4.0,3
21661353,Old Carthusians,Alleyn Old Boys,1,0,3.0,1
21668349,Old Brentwoods III,Brymans Park FC,3,2,4.0,5
21642349,Old Reptonians,Old Alleynians,4,3,4.0,7
21578354,Old Westminsters Vets,Old Wykehamists Veterans,2,1,4.0,3
21663350,Old Brentwoods Vets,Old Salvatorians,2,3,4.0,5
21578671,Old Ardinians,Old Carthusians,3,3,5.0,6
21593993,Old Kimboltonians,Old Reptonians,1,1,4.0,2
21604063,Old Alleynians,Old Tonbridgians,3,3,5.0,6
21618999,Old Etonians,Old Wykehamists,3,1,3.0,4
21624510,Old Malvernians,Old Marlburians,2,6,2.0,8
21578339,Old Salopians,Old Bradfieldians,0,0,4.0,0
21604062,Old Tonbridgians II,Old Alleynians II,0,10,0.0,10
21660216,Old Wykehamists II,Old Ardinians,4,3,4.0,7
21661033,Old Aldenhamians,Old Albanians SA,0,0,4.0,0
21572653,Old Chigwellians,Old Foresters,2,1,4.0,3
21529887,Old Alleynians,Old Etonians,2,5,2.0,7
21617052,Old Chigwellians,Old Reptonians,4,1,2.0,5
21525058,Old Salopians,Old Ardinians,0,4,1.0,4
21578891,Old Salopians II,Old Ardinians,0,0,4.0,0
21579330,Kings College Wimbledon II,Old Alleynians II,3,1,3.0,4
21572648,Old Brentwoods,Old Foresters,0,7,0.0,7
21578992,Bank of England,Old Carthusians,0,3,2.0,3
21604073,Old Alleynians II,Old Etonians II,2,3,4.0,5
21590466,Old Alleynians,Old Kimboltonians,0,3,2.0,3
21401154,Old Westminsters Vets,Lancing Old Boys Vets,13,12,6.0,25
21400621,Old Wykehamists Veterans,Old Haileyburians Vets,2,1,4.0,3
21371288,Old Salopians,Old Westminsters,4,2,3.0,6
21379374,Old Epsomians,Old Carthusians III,3,1,3.0,4
21393888,Old Eastbournians,Old Kingstonians KGS,2,4,3.0,6
21406906,Old Reptonians,Old Bradfieldians,3,1,3.0,4
21256060,Old Westminsters Vets,Lancing Old Boys Vets,0,3,2.0,3
21367055,Old Bradfieldians,Old Alleynians,4,5,5.0,9
21371153,Old Carthusians,Old Wykehamists,6,2,2.0,8
21371179,Old Harrovians,Old Brentwoods,4,4,6.0,8
21371167,Old Etonians,KCS Old Boys,1,1,4.0,2
21371208,Old Rugbeians,Old Westminsters,1,3,3.0,4
21371165,Old Berkhamstedians,Old Reptonians,1,7,0.0,8
21371246,Lancing Old Boys,Old Salopians,1,3,3.0,4
21371143,Old Chigwellians,Old Marlburians,4,4,6.0,8
21371352,Old Carthusians II,Old Etonians II,0,2,2.0,2
21393050,Old Harrovians III,Old Stoics,3,2,4.0,5
21367895,Old Cholmeleians II,Old Wellingtonians,6,3,3.0,9
21386277,Old Haberdashers,Old Bancroftians,7,0,0.0,7
21393877,Old Kingstonians KGS,Old Berkhamstedians II,0,2,2.0,2
21393878,Old Salopians II,Old Wykehamists II,2,1,4.0,3
21256034,Old Wykehamists Veterans,Old Haileyburians Vets,1,2,4.0,3
21256037,Old Salopians Vets,Old Bradfieldians Vets,4,3,4.0,7
21243539,Old Malvernians Vets,Old Foresters Vets,5,5,6.0,10
21371315,Old Alleynians,Old Brentwoods,0,3,2.0,3
21371320,Old Foresters,Old Carthusians,1,4,2.0,5
21371364,Old Brentwoods,Old Alleynians,2,1,4.0,3
21371373,Old Wykehamists,Old Etonians,0,2,2.0,2
21371158,Old Harrovians,Old Bradfieldians,1,6,0.0,7
21371287,Old Rugbeians,Old Malvernians,3,1,3.0,4
21371155,Old Cholmeleians,Old Berkhamstedians,1,2,4.0,3
21371169,Lancing Old Boys,Old Westminsters,3,4,4.0,7
21367058,Old Marlburians,Old Reptonians,5,1,2.0,6
21371385,Old Salopians,Old Chigwellians,2,1,4.0,3
21367066,Old Johnians,Old Chigwellians II,4,2,3.0,6
21367068,Old Etonians II,Old Radleians,5,2,2.0,7
21379375,Old Alleynians II,Old Brentwoods II,2,0,2.0,2
21379371,Old Brentwoods II,Old Alleynians II,0,2,2.0,2
21379413,Old Carthusians III,Old Foresters II,7,1,0.0,8
21379407,Old Suttonians SV,Kings College Wimbledon II,0,2,2.0,2
21379372,Kings College Wimbledon II,Old Suttonians SV,1,1,4.0,2
21393927,Old Westminsters II,Old Ardinians,3,2,4.0,5
21393884,Old Ardinians,Old Westminsters II,2,0,2.0,2
21406905,Old Aldenhamians,Old Kimboltonians,1,2,4.0,3
21434552,Old Haberdashers,Inter London,9,4,1.0,13
21312329,Lancing Old Boys Vets,Old Carthusians Vets,3,2,4.0,5
21256058,Old Reptonians Vets,Old Brentwoods Vets,1,3,3.0,4
21401152,Old Reptonians Vets,Old Brentwoods Vets,3,1,3.0,4
21336875,Old Bradfieldians,Old Wykehamists,4,5,5.0,9
21336874,Old Etonians,Old Tonbridgians,4,2,3.0,6
21336877,Lancing Old Boys,Old Rugbeians,0,2,2.0,2
21336878,Old Cholmeleians,Old Reptonians,1,2,4.0,3
21336876,Old Marlburians,Old Westminsters,3,3,5.0,6
21336882,Old Columbans,Old Merchant Taylors,6,2,2.0,8
21336884,Old Harrovians II,Old Carthusians II,0,2,2.0,2
21336886,Old Johnians,Old Etonians II,1,1,4.0,2
21350025,Old Carthusians III,Old Suttonians SV,3,3,5.0,6
21350024,Old Foresters II,Old Epsomians,1,1,4.0,2
21350023,Old Alleynians II,Old Tonbridgians II,1,0,3.0,1
21336893,Old Cholmeleians II,Old King's Scholars,4,1,2.0,5
21336892,Old Harrovians III,Old Alleynians AFC III,3,4,4.0,7
21336894,Old Wellingtonians,Lancing Old Boys II,4,0,1.0,4
21336891,Old Shirburnians,Old Stoics,3,1,3.0,4
21336897,Old Brentwoods IV,Old Haberdashers,1,9,0.0,10
21336896,Old Merchant Taylors' II,Old Brentwoods III,2,4,3.0,6
21336899,Old Wykehamists II,Old Eastbournians,8,2,0.0,10
21336898,Old Salopians II,Old Kingstonians KGS,1,5,2.0,6
21406797,Old Kimboltonians,Old Aldenhamians,1,1,4.0,2
21406800,Old Malvernians,Old Harrovians,2,0,2.0,2
21406803,Old Sennockians,Old Berkhamstedians,5,3,4.0,8
21406793,Old Amplefordians,KCS Old Boys,1,7,0.0,8
20904102,Old Ardinians,Old Blues,0,2,2.0,2
21308093,Old Harrovians,KCS Old Boys,0,1,3.0,1
21316391,Old Rugbeians,Old Berkhamstedians,2,2,5.0,4
21308101,Old Johnians,Old Harrovians II,5,0,0.0,5
21308098,Old Radleians,Old Carthusians II,2,2,5.0,4
21308099,Old Chigwellians II,Old Sennockians,1,1,4.0,2
21308100,Old Etonians II,Old Aldenhamians,3,1,3.0,4
21308104,Old Carthusians III,Old Epsomians,2,0,2.0,2
21308102,Old Alleynians II,Old Foresters II,3,2,4.0,5
21308103,Old Tonbridgians II,Old Brentwoods II,2,4,3.0,6
21318805,Lancing Old Boys II,Old King's Scholars,2,3,4.0,5
21308106,Old Cholmeleians II,Old Alleynians AFC III,2,3,4.0,5
21308107,Old Shirburnians,Old Harrovians III,3,1,3.0,4
21312402,Old Albanians SA,Old Merchant Taylors' II,4,0,1.0,4
21316766,Old Eastbournians,Old Berkhamstedians II,3,1,3.0,4
21406799,Old Kingstonians KGS,Lancing Old Boys,1,2,4.0,3
21406795,Old Wykehamists,Old Brentwoods,2,1,4.0,3
21406805,Old Alleynians,Old Columbans,4,1,2.0,5
21406796,Old Foresters,Old Bancroftians,10,0,0.0,10
21406808,Old Merchant Taylors,Old Etonians,0,7,0.0,7
21406807,Old Chigwellians,Old Tonbridgians,3,4,4.0,7
21406802,Old Westminsters,Old Suttonians SV,3,6,3.0,9
20904736,Brent,Old Reptonians,0,5,0.0,5
20904734,Old Lyonians,Old Cholmeleians,1,7,0.0,8
21234796,Bank of England,Old Ardinians,4,2,3.0,6
21233985,Old Bradfieldians,Old Carthusians,0,2,2.0,2
21288960,Old Brentwoods,KCS Old Boys,3,2,4.0,5
21288876,Old Wykehamists,Old Harrovians,9,1,0.0,10
21273452,Old Etonians,Old Foresters,1,2,4.0,3
21288962,Old Tonbridgians,Old Alleynians,1,1,4.0,2
21306172,Old Chigwellians,Old Berkhamstedians,2,2,5.0,4
21293735,Old Westminsters,Old Malvernians,3,1,3.0,4
21279435,Old Columbans,Old Etonians II,1,1,4.0,2
21273462,Old Sennockians,Old Carthusians II,0,4,1.0,4
21273637,Old Foresters II,Old Carthusians III,3,0,2.0,3
21273638,Old Kimboltonians,Old Tonbridgians II,7,0,0.0,7
21273573,Old Alleynians II,Old Suttonians SV,6,0,0.0,6
21288862,Old Alleynians AFC III,Old Wellingtonians,3,4,4.0,7
21288859,Old Harrovians III,Lancing Old Boys II,2,3,4.0,5
21279763,Old Albanians SA,Old Brentwoods III,1,3,3.0,4
21286452,Old Merchant Taylors' II,Old Brentwoods IV,6,1,0.0,7
21279773,Old Wykehamists II,Old Westminsters II,2,1,4.0,3
21279772,Old Salopians II,Old Amplefordians,0,1,3.0,1
21406801,Old Salopians,Old Shirburnians,4,0,1.0,4
21406794,Old Carthusians,Old Rugbeians,4,0,1.0,4
21406804,Old Eastbournians,Old Bradfieldians,0,10,0.0,10
21406798,Old Radleians,Old Cholmeleians,1,2,4.0,3
20906970,Old Bancroftians,Little Heath,3,2,4.0,5
21257264,Old Cholmeleians II,Old Manorians,5,2,2.0,7
20906971,Old Haberdashers,Pembroke Old Boys,7,0,0.0,7
20876632,Glyn Old Boys,Old Ardinians,4,2,3.0,6
20877196,Old King's Scholars,Alleyn Old Boys,0,5,0.0,5
21255384,Old Epsomians,UCC Diaspora 1st XI,1,2,4.0,3
21254207,Old Wykehamists,KCS Old Boys,2,0,2.0,2
21254208,Old Brentwoods,Old Tonbridgians,1,4,2.0,5
21254205,Old Foresters,Old Bradfieldians,0,1,3.0,1
21254206,Old Harrovians,Old Alleynians,0,7,0.0,7
21254204,Old Etonians,Old Carthusians,2,4,3.0,6
21260715,Old Chigwellians,Old Malvernians,6,0,0.0,6
21254213,Old Cholmeleians,Old Salopians,0,1,3.0,1
21260714,Old Westminsters,Old Reptonians,2,3,4.0,5
21266386,Old Aldenhamians,Old Harrovians II,2,2,5.0,4
21255698,Old Etonians II,Old Carthusians II,2,3,4.0,5
21265359,Old Sennockians,Old Columbans,0,1,3.0,1
21266387,Old Merchant Taylors,Old Radleians,0,3,2.0,3
21255694,Old Brentwoods II,Old Suttonians SV,5,1,2.0,6
21255696,Old Kimboltonians,Old Foresters II,4,1,2.0,5
21266591,Old Alleynians II,Old Epsomians,2,0,2.0,2
21255695,Old Tonbridgians II,Kings College Wimbledon II,2,1,4.0,3
21266432,Old King's Scholars,Old Alleynians AFC III,1,3,3.0,4
21266171,Lancing Old Boys II,Old Shirburnians,1,5,2.0,6
21255704,Old Cholmeleians II,Old Stoics,4,3,4.0,7
21266433,Old Wellingtonians,Old Harrovians III,0,0,4.0,0
21255708,Old Bancroftians,Old Haberdashers,3,1,3.0,4
21255707,Old Brentwoods III,Old Brentwoods IV,10,4,1.0,14
21255706,Old Merchant Taylors' II,Old Albanians SA,0,6,0.0,6
21255710,Old Ardinians,Old Eastbournians,7,0,0.0,7
21263465,Old Wykehamists II,Old Berkhamstedians II,2,2,5.0,4
20904024,Old Rugbeians,Alleyn Old Boys,1,3,3.0,4
21260374,Galleywood Reserves,Old Chigwellians II,2,1,4.0,3
21234337,Old Foresters,Old Alleynians,6,2,2.0,8
21234336,Old Bradfieldians,Old Harrovians,6,1,0.0,7
21234338,Old Tonbridgians,Old Carthusians,1,3,3.0,4
21059824,Old Berkhamstedians,Lancing Old Boys,1,1,4.0,2
21234342,Old Reptonians,Old Chigwellians,1,3,3.0,4
21234341,Old Malvernians,Old Salopians,2,2,5.0,4
21234339,Old Westminsters,Old Marlburians,1,2,4.0,3
21234718,Old Johnians,Old Aldenhamians,3,1,3.0,4
21234717,Old Sennockians,Old Harrovians II,2,2,5.0,4
21234719,Old Etonians II,Old Merchant Taylors,2,2,5.0,4
21234720,Old Chigwellians II,Old Carthusians II,1,6,0.0,7
21235348,Old Epsomians,Old Tonbridgians II,3,4,4.0,7
21234466,Old Brentwoods II,Old Foresters II,6,2,2.0,8
21234467,Kings College Wimbledon II,Old Kimboltonians,3,1,3.0,4
21234726,Old Harrovians III,Old King's Scholars,3,3,5.0,6
21234733,Old Brentwoods III,Old Merchant Taylors' II,7,1,0.0,8
21234734,Old Bancroftians,Old Brentwoods IV,8,1,0.0,9
21234732,Old Haberdashers,Old Albanians SA,1,2,4.0,3
21234784,Old Berkhamstedians II,Old Eastbournians,2,5,2.0,7
21234785,Old Kingstonians KGS,Old Amplefordians,7,0,0.0,7
21234786,Old Wykehamists II,Old Salopians II,3,2,4.0,5
21256059,Old Cholmeleians Vets,Old Carthusians Vets,3,1,3.0,4
21256036,Old Wellingtonians Vets,KCS Old Boys Vets,1,3,3.0,4
21401153,Old Cholmeleians Vets,Old Carthusians Vets,1,3,3.0,4
21400623,Old Wellingtonians Vets,KCS Old Boys Vets,3,1,3.0,4
20877326,Old Malvernians Vets,Old Etonians Vets,1,1,4.0,2
20955564,KCS Old Boys,Old Alleynians,0,2,2.0,2
20952166,Old Wykehamists,Old Foresters,0,1,3.0,1
21181606,Old Etonians,Old Brentwoods,3,3,5.0,6
20952167,Old Tonbridgians,Old Harrovians,5,0,0.0,5
20963334,Old Cholmeleians,Lancing Old Boys,2,0,2.0,2
20951252,Old Berkhamstedians,Old Malvernians,2,2,5.0,4
20951251,Old Marlburians,Old Rugbeians,7,3,2.0,10
20963335,Old Westminsters,Old Salopians,4,1,2.0,5
21194948,Old Aldenhamians,Old Radleians,2,3,4.0,5
21194949,Old Columbans,Old Carthusians II,0,2,2.0,2
21137811,Old Sennockians,Old Johnians,0,2,2.0,2
20951723,Old Etonians II,Old Harrovians II,2,2,5.0,4
21202679,Old Foresters II,Old Tonbridgians II,0,1,3.0,1
20952900,Old Epsomians,Old Kimboltonians,1,2,4.0,3
21202678,Kings College Wimbledon II,Old Alleynians II,1,3,3.0,4
21194953,Old Alleynians AFC III,Old Harrovians III,6,3,3.0,9
21195216,Old Stoics,Old Shirburnians,0,1,3.0,1
21194923,Old Cholmeleians II,Lancing Old Boys II,7,3,2.0,10
21194925,Old Albanians SA,Old Bancroftians,3,0,2.0,3
21194951,Old Wykehamists II,Old Amplefordians,1,2,4.0,3
21194950,Old Berkhamstedians II,Old Westminsters II,1,3,3.0,4
21194927,Weirside Rangers,Old Ardinians,2,3,4.0,5
20904031,Old Carthusians,Old Reptonians,3,0,2.0,3
20948443,Old Carthusians,Old Harrovians,10,0,0.0,10
20948442,Old Etonians,Old Alleynians,0,2,2.0,2
20948440,Old Foresters,KCS Old Boys,1,2,4.0,3
20948441,Old Brentwoods,Old Wykehamists,1,5,2.0,6
20951131,Old Malvernians,Lancing Old Boys,3,2,4.0,5
21135003,Old Salopians,Old Marlburians,0,0,4.0,0
20951133,Old Chigwellians,Old Westminsters,2,0,2.0,2
21093172,Old Aldenhamians,Old Etonians II,0,1,3.0,1
20942024,Old Chigwellians II,Old Radleians,1,3,3.0,4
21093173,Old Merchant Taylors,Old Harrovians II,2,0,2.0,2
20951894,Old Foresters II,Kings College Wimbledon II,2,1,4.0,3
20951896,Old Alleynians II,Old Carthusians III,3,3,5.0,6
20951895,Old Suttonians SV,Old Tonbridgians II,3,2,4.0,5
20953861,Old Alleynians AFC III,Old King's Scholars,4,2,3.0,6
20953863,Old Stoics,Lancing Old Boys II,4,1,2.0,5
20953862,Old Wellingtonians,Old Shirburnians,2,5,2.0,7
21093237,Old Brentwoods IV,Old Albanians SA,0,19,1.0,19
21093236,Old Haberdashers,Old Merchant Taylors' II,4,1,2.0,5
21093312,Old Berkhamstedians II,Old Wykehamists II,3,3,5.0,6
21093311,Old Ardinians,Old Kingstonians KGS,2,0,2.0,2
21064094,Old Westminsters II,Old Amplefordians,3,5,4.0,8
21087743,Old Tonbridgians,Old Bradfieldians,0,1,3.0,1
20904027,Old Reptonians,Hale End Athletic,0,1,3.0,1
20942096,Old Columbans,Old Carthusians II,0,1,3.0,1
21061046,Old Kimboltonians,Old Brentwoods II,4,1,2.0,5
20877215,Old Carthusians Vets,Old Tonbridgians Vets,3,1,3.0,4
20952505,Old Wykehamists,Old Alleynians,1,3,3.0,4
20921997,Old Brentwoods,Old Carthusians,1,3,3.0,4
21079977,KCS Old Boys,Old Bradfieldians,3,4,4.0,7
20952504,Old Tonbridgians,Old Foresters,0,1,3.0,1
20929926,Old Rugbeians,Old Salopians,1,3,3.0,4
20929928,Old Marlburians,Old Malvernians,2,3,4.0,5
21059557,Old Chigwellians,Old Cholmeleians,1,6,0.0,7
21048854,Old Johnians,Old Columbans,4,0,1.0,4
21002540,Old Aldenhamians,Old Carthusians II,1,0,3.0,1
20941968,Old Chigwellians II,Old Harrovians II,1,1,4.0,2
20951887,Old Kimboltonians,Old Alleynians II,1,4,2.0,5
20951886,Old Epsomians,Old Foresters II,3,0,2.0,3
20951885,Old Brentwoods II,Old Carthusians III,3,2,4.0,5
21054388,Lancing Old Boys II,Old Alleynians AFC III,2,3,4.0,5
21048828,Old Harrovians III,Old Cholmeleians II,0,12,0.0,12
21048829,Old Brentwoods IV,Old Brentwoods III,0,8,0.0,8
21048841,Old Eastbournians,Old Westminsters II,1,1,4.0,2
21048840,Old Salopians II,Old Ardinians,0,4,1.0,4
20878195,Old Etonians II,Glyn Old Boys,0,1,3.0,1
20958953,Old Harrovians II,Old Radleians,1,1,4.0,2
20921996,Old Etonians,Old Harrovians,3,3,5.0,6
20921995,Old Carthusians,KCS Old Boys,3,0,2.0,3
20976860,Old Chigwellians,Lancing Old Boys,1,1,4.0,2
20923091,Old Salopians,Old Berkhamstedians,2,2,5.0,4
20923089,Old Rugbeians,Old Cholmeleians,2,1,4.0,3
20923088,Old Reptonians,Old Marlburians,3,1,3.0,4
20927568,Old Merchant Taylors,Old Chigwellians II,3,1,3.0,4
20923107,Old Columbans,Old Radleians,1,1,4.0,2
20923108,Old Etonians II,Old Johnians,3,1,3.0,4
20923116,Old Epsomians,Old Alleynians II,4,3,4.0,7
20923114,Old Carthusians III,Kings College Wimbledon II,2,5,2.0,7
20923115,Old Tonbridgians II,Old Kimboltonians,2,1,4.0,3
20923125,Old Wellingtonians,Old Cholmeleians II,3,4,4.0,7
20923172,Old Merchant Taylors' II,Old Haberdashers,2,1,4.0,3
20923171,Old Bancroftians,Old Albanians SA,3,1,3.0,4
20976210,Old Berkhamstedians II,Old Salopians II,2,3,4.0,5
20923214,Old Amplefordians,Old Ardinians,2,7,0.0,9
20923215,Old Eastbournians,Old Wykehamists II,1,4,2.0,5
20877459,Old Hamptonians,Old Alleynians,4,0,1.0,4
20997846,Old Harrovians III,Old Stoics,1,1,4.0,2
20904032,Old Bradfieldians,Old Tonbridgians,1,1,4.0,2
20929684,Old Harrovians,Old Alleynians,1,1,4.0,2
20880184,Old Epsomians,Kings College Wimbledon II,1,4,2.0,5
20921702,Nottsborough FC,Old Carthusians,2,1,4.0,3
22420457,Old Brentwoods,Old Bradfieldians,2,1,4.0,3
22425376,Old Salopians II,Old Wykehamists II,0,0,4.0,0
23141556,Old Etonians,Old Reptonians,1,7,0.0,8
23135237,Old Alleynians II,Old Etonians II,0,6,0.0,6
23135967,Old Haberdashers,Old Shirburnians,4,2,3.0,6
23137198,KCS Old Boys Vets,Old Harrovians Vets,6,1,0.0,7
23147809,Old Chigwellians Vets Blues,Old Foresters Vets,3,2,4.0,5
22420438,KCS Old Boys,Old Brentwoods,6,1,0.0,7
22420196,Old Reptonians,Old Salopians,6,1,0.0,7
23127734,Old Amplefordians,Old Berkhamstedians II,1,2,4.0,3
23128487,Arthurian League Representative Team,AFC Representative Team,2,3,4.0,5
22420380,Old Etonians,Old Bradfieldians,2,1,4.0,3
23089112,Old Bradfieldians,Old Etonians,1,2,4.0,3
22657575,Arthurian League Representative Team,Lloyds of London Representative Team,1,1,4.0,2
23128397,Old Tonbridgians Vets,Old Wellingtonians Vets,5,2,2.0,7
22420376,Old Brentwoods,Old Foresters,1,4,2.0,5
22420283,Old Bradfieldians,Old Harrovians,6,1,0.0,7
22420301,Old Berkhamstedians,Old Marlburians,4,7,3.0,11
22420464,Old Westminsters,Old Chigwellians,4,1,2.0,5
22420299,Old Alleynians II,Old Merchant Taylors',13,1,1.0,14
22420300,Old Alleynians III,Old Kimboltonians,2,2,5.0,4
23128257,Old Ardinians,Old Etonians II,1,1,4.0,2
23117072,Old Cheltonians,Old Haberdashers,1,1,4.0,2
23116426,Old Shirburnians,Old Wellingtonians,4,1,2.0,5
22425335,Old Ardinians II,Old Salopians II,0,0,4.0,0
22420469,Old Etonians,Old Brentwoods,0,3,2.0,3
22420416,Old Bradfieldians,Old Wykehamists,5,0,0.0,5
22420399,KCS Old Boys,Old Foresters,0,1,3.0,1
22420507,Old Berkhamstedians,Old Reptonians,0,1,3.0,1
22420225,Old Cholmeleians,Old Chigwellians,5,2,2.0,7
22420229,Old Salopians,Old Westminsters,1,1,4.0,2
22420347,Old Aldenhamians,Old Sennockians,2,1,4.0,3
22420404,Old Chigwellians II,Old Harrovians II,3,3,5.0,6
22420262,Old Merchant Taylors',Old Johnians,2,0,2.0,2
22420177,Old Brentwoods II,Old Epsomians,0,3,2.0,3
22425369,Old Wellingtonians,Old Ardinians,0,3,2.0,3
23116708,Old Berkhamstedians II,Old Haberdashers,3,2,4.0,5
23116710,Old Amplefordians,Old Brentwoods III,2,2,5.0,4
22572000,Old Alleynians AFC,Beder FC,10,10,7.0,20
23116709,Old Brentwoods III,Old Amplefordians,0,0,4.0,0
23116707,Old Haberdashers,Old Berkhamstedians II,0,0,4.0,0
21871132,Radley College 1st XI,Old Radleians,10,10,7.0,20
22420442,Old Bradfieldians,Old Carthusians,0,3,2.0,3
22420439,Old Alleynians,Old Foresters,4,3,4.0,7
22420372,KCS Old Boys,Old Tonbridgians,0,1,3.0,1
22420227,Old Malvernians,Lancing Old Boys,0,1,3.0,1
22420295,Old Westminsters,Old Rugbeians,3,2,4.0,5
22420172,Old Alleynians II,Old Etonians II,0,7,0.0,7
22420462,Old Merchant Taylors',Old Chigwellians II,2,2,5.0,4
22420424,Old Sennockians,Old Harrovians II,1,2,4.0,3
23068337,Old Tonbridgians II,Old Cholmeleians II,0,3,2.0,3
22425444,Old King's Scholars,Old Stoics,1,5,2.0,6
22196864,Old Haberdashers,Old Cheltonians,1,1,4.0,2
22425354,Old Berkhamstedians II,Old Eastbournians,6,1,0.0,7
22425315,Old Salopians II,Old Westminsters II,0,8,0.0,8
23101937,Old Wykehamists II,Old Ardinians,1,2,4.0,3
23056802,Lancing Old Boys II,Old Wellingtonians,1,6,0.0,7
23098141,Old Brentwoods,Brentwood School 1st XI,1,2,4.0,3
23098142,Old Brentwoods II,Brentwood School 2nd XI,0,10,0.0,10
23098143,Old Brentwoods III,Brentwood School 3rd XI,3,0,2.0,3
23098144,Old Brentwoods IV,Brentwood School 4th XI,0,10,0.0,10
23098145,Old Brentwoods Vets,Brentwood School 5th XI,0,10,0.0,10
22985980,Stowe School,Old Stoics,4,5,5.0,9
22420362,Old Carthusians,Old Harrovians,2,2,5.0,4
22420264,Old Reptonians,Old Westminsters,1,1,4.0,2
22420356,Old Radleians,Old Chigwellians II,1,2,4.0,3
22420313,Old Alleynians II,Old Aldenhamians,4,1,2.0,5
23068338,Old Tonbridgians II,Old Brentwoods II,3,0,2.0,3
22425357,Old Shirburnians,Old King's Scholars,1,1,4.0,2
22425304,Old Berkhamstedians II,Old Kingstonians,4,3,4.0,7
22425412,Old Salopians II,Old Eastbournians,2,2,5.0,4
22425432,Old Westminsters II,Old Wykehamists II,0,0,4.0,0
23073027,Old Merchant Taylors',Old Ardinians,0,5,0.0,5
23053369,Cheltenham College 1st XI,Old Cheltonians,3,4,4.0,7
22978237,"King's College School, Wimbledon 1st XI",KCS Old Boys,1,3,3.0,4
22978306,"King's College School, Wimbledon 2nd XI",Kings College Wimbledon II,0,4,1.0,4
22815829,Malvern College 1st XI,Old Malvernians,2,3,4.0,5
23073461,Old Parkonians,Old Brentwoods III,2,0,2.0,2
22942648,Old Etonians Vets,KCS Old Boys Vets,0,0,4.0,0
23068563,Old Foresters Vets,Old Chigwellians Vets Blues,4,1,2.0,5
22420437,Old Wykehamists,Old Tonbridgians,2,2,5.0,4
22420458,Old Carthusians,Old Foresters,13,0,1.0,13
22420315,Old Berkhamstedians,Lancing Old Boys,3,5,4.0,8
22420261,Old Marlburians,Old Malvernians,3,0,2.0,3
22420423,Old Salopians,Old Cholmeleians,1,3,3.0,4
22420334,Old Johnians,Old Etonians II,3,1,3.0,4
22420173,Old Alleynians II,Old Harrovians II,8,0,0.0,8
22420443,Old Carthusians II,Old Merchant Taylors',3,2,4.0,5
22420230,Old Sennockians,Old Radleians,1,1,4.0,2
22420407,Old Kimboltonians,Old Brentwoods II,4,1,2.0,5
22425393,Old Ardinians,Lancing Old Boys II,4,1,2.0,5
22196859,Old Brentwoods IV,Old Brentwoods III,0,2,2.0,2
22425414,Old Amplefordians,Old Eastbournians,3,4,4.0,7
23038168,Old Chigwellians,Old Reptonians,1,3,3.0,4
23038167,Old Etonians,Old Bradfieldians,5,5,6.0,10
23013924,Old Shirburnians,Old King's Scholars,3,1,3.0,4
22986391,Old Haberdashers,Old Albanians SA,2,1,4.0,3
22921507,Old Bradfieldians Vets,Old Wellingtonians Vets,1,3,3.0,4
23007844,Sherborne School 1st XI,Old Shirburnians,10,0,0.0,10
22420253,Old Foresters,Old Carthusians,0,1,3.0,1
22420171,Old Alleynians,Old Brentwoods,4,1,2.0,5
22420231,Old Wykehamists,KCS Old Boys,4,1,2.0,5
22420364,Old Etonians,Old Tonbridgians,4,1,2.0,5
22420350,Old Chigwellians,Old Cholmeleians,0,8,0.0,8
22420425,Old Westminsters,Old Berkhamstedians,1,0,3.0,1
22420431,Old Etonians II,Old Aldenhamians,4,2,3.0,6
22420474,Old Sennockians,Old Merchant Taylors',7,1,0.0,8
22420187,Old Carthusians II,Old Chigwellians II,4,5,5.0,9
22420290,Old Harrovians II,Old Johnians,5,7,4.0,12
22425400,Old Harrovians III,Lancing Old Boys II,1,0,3.0,1
22425390,Old Wellingtonians,Old Stoics,3,2,4.0,5
22425426,Old Ardinians II,Old Eastbournians,3,1,3.0,4
23039047,Old Alleynians II,Old Brentwoods II,7,1,0.0,8
23052033,Old Berkhamstedians II,Old Ardinians,0,3,2.0,3
22947975,Old Tonbridgians Vets,Old Carthusians Vets,1,0,3.0,1
22420478,Old Wykehamists,Old Harrovians,4,3,4.0,7
22420275,Old Foresters,Old Alleynians,1,2,4.0,3
22420401,Old Carthusians,Old Etonians,7,1,0.0,8
22420524,Old Reptonians,Old Chigwellians,2,0,2.0,2
22420409,Old Rugbeians,Old Cholmeleians,1,9,0.0,10
22420305,Old Chigwellians II,Old Radleians,3,0,2.0,3
22420496,Old Etonians II,Old Merchant Taylors',6,0,0.0,6
22420355,Old Johnians,Old Carthusians II,10,0,0.0,10
22425349,Old Albanians SA,Old Stoics,2,0,2.0,2
22425319,Old King's Scholars,Old Wellingtonians,4,1,2.0,5
22425318,Old Brentwoods IV,Old Haberdashers,2,2,5.0,4
22425364,Old Ardinians II,Old Kingstonians,2,1,4.0,3
22940669,Lancing Old Boys II,Old Wykehamists II,2,0,2.0,2
22940021,Aldenham School 1st XI,Old Aldenhamians,10,0,0.0,10
22942224,Westminster School 1st XI,Old Westminsters,3,3,5.0,6
22941909,Westminster School 2nd XI,Old Westminsters II,3,1,3.0,4
22420515,Old Wykehamists,Old Brentwoods,1,7,0.0,8
22420448,Old Harrovians,Old Tonbridgians,1,2,4.0,3
22420481,Old Berkhamstedians,Old Malvernians,3,3,5.0,6
22420506,Lancing Old Boys,Old Rugbeians,2,2,5.0,4
22425423,Old King's Scholars,Old Albanians SA,1,2,4.0,3
22425305,Old Cheltonians,Old Brentwoods III,2,7,0.0,9
22425322,Old Westminsters II,Old Amplefordians,1,3,3.0,4
22800286,Old Salopians,Old Chigwellians,1,2,4.0,3
22800463,Old Shirburnians,Old Reptonians,1,3,3.0,4
22940489,Old Kimboltonians,Old Etonians II,5,6,5.0,11
22952164,Old Alleynians II,Old Johnians,2,2,5.0,4
22940692,Old Harrovians II,Old Brentwoods II,1,4,2.0,5
22420414,Old Alleynians,Old Tonbridgians,8,2,0.0,10
22420296,Old Wykehamists,Old Foresters,3,3,5.0,6
22420441,Old Berkhamstedians,Old Chigwellians,1,6,0.0,7
22420367,Old Reptonians,Old Cholmeleians,1,4,2.0,5
22420268,Lancing Old Boys,Old Marlburians,3,2,4.0,5
22420204,Old Malvernians,Old Rugbeians,0,3,2.0,3
22420427,Old Alleynians II,Old Radleians,0,1,3.0,1
22420420,Old Johnians,Old Merchant Taylors',4,0,1.0,4
22420287,Old Chigwellians II,Old Carthusians II,5,4,5.0,9
22420288,Old Etonians II,Old Sennockians,2,1,4.0,3
22420498,Old Harrovians II,Old Aldenhamians,4,4,6.0,8
22420460,Old Cholmeleians II,Old Kimboltonians,5,4,5.0,9
22420360,Kings College Wimbledon II,Old Alleynians III,2,1,4.0,3
22425392,Old Shirburnians,Old Wellingtonians,4,2,3.0,6
22425358,Old Amplefordians,Old Kingstonians,1,2,4.0,3
22800454,Old Bradfieldians,Old Brentwoods,5,2,2.0,7
22800342,Old Etonians,KCS Old Boys,4,3,4.0,7
22913381,Old King's Scholars,Old Brentwoods IV,1,0,3.0,1
22919699,Old Carthusians,Winchmore Hill,0,1,3.0,1
22420432,Old Foresters,Old Brentwoods,4,1,2.0,5
22420245,KCS Old Boys,Old Alleynians,1,0,3.0,1
22420393,Old Harrovians,Old Etonians,1,2,4.0,3
22420388,Old Berkhamstedians,Old Cholmeleians,0,2,2.0,2
22420426,Lancing Old Boys,Old Malvernians,1,2,4.0,3
22420451,Old Marlburians,Old Reptonians,5,3,4.0,8
22420430,Old Chigwellians,Old Salopians,4,3,4.0,7
22420271,Old Chigwellians II,Old Aldenhamians,2,3,4.0,5
22420309,Old Harrovians II,Old Sennockians,1,0,3.0,1
22420322,Old Johnians,Old Radleians,2,1,4.0,3
22420218,Old Merchant Taylors',Old Carthusians II,1,2,4.0,3
22420185,Old Alleynians III,Old Brentwoods II,2,5,2.0,7
22420484,Old Epsomians,Old Kimboltonians,2,2,5.0,4
22425361,Old King's Scholars,Lancing Old Boys II,1,0,3.0,1
22425415,Old Ardinians,Old Wellingtonians,5,0,0.0,5
22425345,Old Eastbournians,Old Wykehamists II,2,4,3.0,6
22425445,Old Westminsters II,Old Ardinians II,3,4,4.0,7
22918830,Old Albanians SA,Old Kingstonians,3,0,2.0,3
22939858,Old Cheltonians,Old Berkhamstedians II,4,1,2.0,5
22783125,Civil Service,Old Carthusians,2,1,4.0,3
22750544,Old Brentwoods III,Old Finchleians,3,1,3.0,4
22769569,Old Etonians II,Old Owens,3,4,4.0,7
22420302,Old Brentwoods,Old Wykehamists,6,3,3.0,9
22420327,KCS Old Boys,Old Carthusians,1,3,3.0,4
22420419,Old Harrovians,Old Foresters,2,1,4.0,3
22420310,Old Tonbridgians,Old Etonians,1,4,2.0,5
22420421,Old Malvernians,Old Reptonians,0,5,0.0,5
22420250,Old Cholmeleians,Old Westminsters,4,2,3.0,6
22420480,Old Alleynians II,Old Sennockians,4,1,2.0,5
22420494,Old Carthusians II,Old Radleians,1,3,3.0,4
22420485,Old Etonians II,Old Chigwellians II,8,0,0.0,8
22420487,Old Harrovians II,Old Merchant Taylors',3,0,2.0,3
22420406,Old Johnians,Old Aldenhamians,4,0,1.0,4
22420314,Old Alleynians III,Old Epsomians,1,1,4.0,2
23068610,Old Kimboltonians,Old Tonbridgians II,10,0,0.0,10
22420428,Old Brentwoods II,Kings College Wimbledon II,3,1,3.0,4
22425348,Lancing Old Boys II,Old Harrovians III,2,2,5.0,4
22425401,Old Stoics,Old Ardinians,0,4,1.0,4
22425378,Old Wellingtonians,Old Albanians SA,1,7,0.0,8
22425299,Old Haberdashers,Old Brentwoods IV,3,1,3.0,4
22425403,Old Westminsters II,Old Berkhamstedians II,1,1,4.0,2
22761650,Old Cholmeleians II,Old Wykehamists II,2,3,4.0,5
22744106,Old Etonians Vets,Lancing Old Boys Vets,5,2,2.0,7
22560643,Old Malvernians Vets,Old Foresters Vets,0,2,2.0,2
22570654,Old Tonbridgians Vets,Old Harrovians Vets,0,0,4.0,0
22420284,Old Brentwoods,KCS Old Boys,2,4,3.0,6
22420378,Old Carthusians,Old Alleynians,4,3,4.0,7
22420359,Old Wykehamists,Old Bradfieldians,0,3,2.0,3
22420510,Old Foresters,Old Tonbridgians,3,4,4.0,7
22420228,Old Reptonians,Old Berkhamstedians,5,0,0.0,5
22420395,Old Marlburians,Old Rugbeians,2,2,5.0,4
22420403,Old Chigwellians,Old Malvernians,7,1,0.0,8
22420202,Old Cholmeleians,Old Salopians,3,2,4.0,5
22420504,Old Westminsters,Lancing Old Boys,1,0,3.0,1
22420374,Old Aldenhamians,Old Carthusians II,5,1,2.0,6
22420236,Old Epsomians,Old Cholmeleians II,3,3,5.0,6
22425301,Lancing Old Boys II,Old Wellingtonians,2,4,3.0,6
22425408,Old Ardinians II,Old Amplefordians,2,4,3.0,6
22425331,Old Eastbournians,Old Kingstonians,6,1,0.0,7
22425368,Old Salopians II,Old Berkhamstedians II,3,3,5.0,6
22783114,Old Kimboltonians,Old Shirburnians,5,0,0.0,5
22783115,Old Chigwellians II,Old Brentwoods II,1,1,4.0,2
22831215,Old Etonians II,Old Radleians,1,0,3.0,1
22782968,Old Harrovians II,Old Westminsters II,7,1,0.0,8
22896325,Old Johnians,Kings College Wimbledon II,3,1,3.0,4
22491640,Old Wykehamists II,Old Stoics,4,2,3.0,6
22816234,Old Harrovians III,Old Cheltonians,2,2,5.0,4
22750538,Old Etonians,Old Finchleians,0,1,3.0,1
22708415,KCS Old Boys Vets,Old Cholmeleians Vets,6,1,0.0,7
22784721,Old Aldenhamians Vets,Old Bradfieldians Vets,1,8,0.0,9
22420486,Old Foresters,Old Etonians,3,6,3.0,9
22420238,Old Harrovians,Old Alleynians,3,5,4.0,8
22420254,Old Rugbeians,Old Marlburians,4,0,1.0,4
22420375,Old Berkhamstedians,Old Salopians,2,4,3.0,6
22420297,Lancing Old Boys,Old Cholmeleians,3,1,3.0,4
22420477,Old Westminsters,Old Reptonians,1,1,4.0,2
22420263,Old Radleians,Old Harrovians II,5,4,5.0,9
22420467,Old Carthusians II,Old Alleynians II,1,3,3.0,4
22420523,Old Merchant Taylors',Old Aldenhamians,0,4,1.0,4
22420452,Old Sennockians,Old Etonians II,1,5,2.0,6
22420392,Old Chigwellians II,Old Johnians,1,3,3.0,4
22420335,Old Kimboltonians,Kings College Wimbledon II,0,0,4.0,0
22420174,Old Alleynians III,Old Cholmeleians II,3,2,4.0,5
22425442,Old Ardinians,Old Shirburnians,0,4,1.0,4
22425413,Old Stoics,Old King's Scholars,5,3,4.0,8
22491651,Old Salopians II,Old Berkhamstedians II,3,4,4.0,7
22804870,Old Albanians SA,Old Westminsters II,2,2,5.0,4
22820187,Old Wellingtonians,Old Brentwoods III,3,2,4.0,5
22772286,Old Carthusians,Nottsborough FC,2,1,4.0,3
22695584,Old Carthusians Vets,Old Salopians Vets,9,2,0.0,11
22708255,Old Wellingtonians Vets,Old Reptonians Vets,5,1,2.0,6
22420493,Old Bradfieldians,Old Foresters,4,3,4.0,7
22420326,Old Wykehamists,Old Carthusians,0,7,0.0,7
22420316,Old Brentwoods,Old Tonbridgians,3,1,3.0,4
22420273,Old Etonians,Old Harrovians,7,3,2.0,10
22420357,Old Rugbeians,Old Westminsters,1,0,3.0,1
22420181,Old Reptonians,Old Malvernians,6,2,2.0,8
22420479,Lancing Old Boys,Old Chigwellians,3,4,4.0,7
22420472,Old Radleians,Old Etonians II,4,2,3.0,6
22420233,Old Carthusians II,Old Aldenhamians,3,1,3.0,4
22420242,Old Chigwellians II,Old Merchant Taylors',3,2,4.0,5
22420516,Kings College Wimbledon II,Old Cholmeleians II,3,2,4.0,5
23068608,Old Tonbridgians II,Old Kimboltonians,2,3,4.0,5
22425297,Old Ardinians,Old Harrovians III,6,0,0.0,6
22425386,Old Stoics,Lancing Old Boys II,2,1,4.0,3
22425402,Old Wellingtonians,Old King's Scholars,5,0,0.0,5
22425314,Old Brentwoods III,Old Millhillians,4,3,4.0,7
22425320,Old Kingstonians,Old Salopians II,1,7,0.0,8
22425302,Old Amplefordians,Old Wykehamists II,4,1,2.0,5
22425303,Old Ardinians II,Old Westminsters II,2,2,5.0,4
22484868,Old Albanians SA,Old Johnians,4,4,6.0,8
22701416,Old Vaughanians,Old Cholmeleians,3,0,2.0,3
22856198,Old Harrovians II,Old Harrovians Select XI,4,4,6.0,8
22788770,Dulwich College 1st XI,Old Alleynians,1,5,2.0,6
22788761,Dulwich College 2nd XI,Old Alleynians II,0,0,4.0,0
22788762,Dulwich College 3rd XI,Old Alleynians III,0,0,4.0,0
22595669,Epsom College 1st XI,Old Epsomians,5,5,6.0,10
22420369,Old Sennockians,Old Chigwellians II,3,2,4.0,5
22425328,Old Wellingtonians,Lancing Old Boys II,11,1,0.0,12
22604848,Old Bradfieldians,Old Ardinians,5,3,4.0,8
22644903,Old Brentwoods,Old Tonbridgians,3,2,4.0,5
22604682,Old Berkhamstedians,Old Reptonians,1,6,0.0,7
22604671,KCS Old Boys,Old Wykehamists,4,2,3.0,6
22576243,Old Alleynians,Old Chigwellians,3,4,4.0,7
22645128,Old Etonians,Lancing Old Boys,2,1,4.0,3
22668194,Old Merchant Taylors',Old Brentwoods III,4,3,4.0,7
22695586,Old Wykehamists Veterans,Old Bradfieldians Vets,0,6,0.0,6
22733161,Old Foresters Vets,Old Ignatians,3,1,3.0,4
22420466,Old Bradfieldians,Old Alleynians,2,7,0.0,9
22420358,Old Tonbridgians,Old Harrovians,2,1,4.0,3
22420412,KCS Old Boys,Old Etonians,0,4,1.0,4
22420346,Lancing Old Boys,Old Berkhamstedians,3,3,5.0,6
22420294,Old Salopians,Old Reptonians,2,4,3.0,6
22420508,Old Chigwellians,Old Marlburians,7,1,0.0,8
22425312,Old Wykehamists II,Old Eastbournians,4,0,1.0,4
22425311,Old Kingstonians,Old Ardinians II,3,3,5.0,6
22762677,Old Carthusians II,Old Brentwoods II,1,2,4.0,3
22666996,Old Haberdashers,Old Suttonians SV,3,1,3.0,4
22484875,Old Aldenhamians,Kings College Wimbledon II,2,6,2.0,8
22699327,Old Epsomians,Old Shirburnians,1,2,4.0,3
22484867,Old Etonians II,Old Alleynians III,9,0,0.0,9
22677005,Old Harrovians II,Old Stoics,5,0,0.0,5
22677163,Old Westminsters II,Old Sennockians,3,2,4.0,5
22729792,Old Foresters,Old Hamptonians,1,7,0.0,8
22729793,South Bank Cuaco,Old Carthusians,2,3,4.0,5
22729794,West Wickham,Old Brentwoods,6,1,0.0,7
22769240,Merchant Taylors School 1st XI,Old Merchant Taylors',5,0,0.0,5
22733158,Old Parkonians,Old King's Scholars,8,0,0.0,8
21871298,Kimbolton School 1st XI,Old Kimboltonians,0,0,4.0,0
22420210,KCS Old Boys,Old Harrovians,1,2,4.0,3
22420199,Old Alleynians,Old Etonians,1,1,4.0,2
22420410,Old Tonbridgians,Old Brentwoods,5,2,2.0,7
22420304,Old Chigwellians,Old Westminsters,0,4,1.0,4
22420182,Old Reptonians,Old Marlburians,5,0,0.0,5
22420323,Old Malvernians,Old Cholmeleians,2,2,5.0,4
22420368,Old Salopians,Old Rugbeians,1,1,4.0,2
22420456,Old Alleynians II,Old Johnians,2,5,2.0,7
22420408,Old Radleians,Old Merchant Taylors',3,1,3.0,4
22420413,Old Aldenhamians,Old Chigwellians II,3,0,2.0,3
22420249,Old Carthusians II,Old Sennockians,2,4,3.0,6
23073606,Old Brentwoods II,Old Tonbridgians II,0,4,1.0,4
22420447,Old Cholmeleians II,Old Epsomians,0,3,2.0,3
22425418,Old Shirburnians,Old Stoics,5,0,0.0,5
22425337,Old Wellingtonians,Old Harrovians III,1,1,4.0,2
22425416,Old Brentwoods III,Old Haberdashers,4,1,2.0,5
22425293,Old Kingstonians,Old Eastbournians,1,1,4.0,2
22425420,Old Ardinians II,Old Wykehamists II,2,5,2.0,7
22425419,Old Amplefordians,Old Salopians II,8,3,0.0,11
22678737,Old Brentwoods IV,Bank of England,1,1,4.0,2
22701453,Bealonians,Old Etonians II,0,3,2.0,3
22420361,Old Alleynians,Old Bradfieldians,5,4,5.0,9
22420490,KCS Old Boys,Old Wykehamists,2,1,4.0,3
22420417,Old Carthusians,Old Brentwoods,1,0,3.0,1
22420383,Old Rugbeians,Old Chigwellians,3,7,2.0,10
22420373,Lancing Old Boys,Old Reptonians,0,2,2.0,2
22420269,Old Carthusians II,Old Johnians,0,1,3.0,1
22420265,Old Sennockians,Old Alleynians II,2,2,5.0,4
22420274,Old Etonians II,Old Harrovians II,1,3,3.0,4
22420461,Old Epsomians,Old Brentwoods II,4,2,3.0,6
23073611,Old Tonbridgians II,Kings College Wimbledon II,4,0,1.0,4
22425439,Old Ardinians,Old Stoics,4,0,1.0,4
22425375,Old Kingstonians,Old Berkhamstedians II,0,4,1.0,4
22425380,Old Amplefordians,Old Westminsters II,2,1,4.0,3
22581805,Albanian FC,Old Brentwoods III,0,6,0.0,6
22581801,Old Brentwoods IV,Old Parkonians,0,1,3.0,1
22679836,Bealonians,Old Etonians,1,3,3.0,4
22676921,Old Foresters,Civil Service,1,3,3.0,4
22420491,Old Alleynians,Old Harrovians,11,1,0.0,12
22420176,Old Bradfieldians,KCS Old Boys,0,2,2.0,2
22420365,Old Malvernians,Old Westminsters,3,4,4.0,7
22420325,Old Salopians,Old Marlburians,1,4,2.0,5
22420270,Old Chigwellians,Old Berkhamstedians,3,0,2.0,3
22420468,Old Cholmeleians,Old Rugbeians,3,2,4.0,5
22420470,Old Johnians,Old Chigwellians II,4,1,2.0,5
22420382,Old Merchant Taylors',Old Alleynians II,1,6,0.0,7
22420384,Kings College Wimbledon II,Old Kimboltonians,2,5,2.0,7
22420285,Old Brentwoods II,Old Cholmeleians II,2,1,4.0,3
23073613,Old Tonbridgians II,Old Epsomians,1,1,4.0,2
22425395,Old Shirburnians,Old Albanians SA,2,2,5.0,4
22425370,Lancing Old Boys II,Old Ardinians,0,4,1.0,4
22425422,Old Harrovians III,Old Stoics,1,2,4.0,3
22425362,Old Wykehamists II,Old Westminsters II,5,4,5.0,9
22425306,Old Eastbournians,Old Salopians II,2,5,2.0,7
22425436,Old Amplefordians,Old Berkhamstedians II,2,3,4.0,5
22708546,Old Brentwoods,Weirside Rangers,3,1,3.0,4
22649059,Old Carthusians,Dorkinians,1,0,3.0,1
22649060,Old Foresters,Cambridge Heath,2,1,4.0,3
21871307,Eton College 1st XI,Old Etonians,3,3,5.0,6
22661537,Eton College 2nd XI,Old Etonians II,5,0,0.0,5
22307167,Old Wilsonians,Old King's Scholars,3,4,4.0,7
22552406,Old Wykehamists,Winchester College 1st XI,2,0,2.0,2
21916688,Old Wellingtonians Vets,Old Chigwellians Vets Blues,3,5,4.0,8
22420282,Old Alleynians,Old Carthusians,1,1,4.0,2
22420389,Old Bradfieldians,Old Tonbridgians,1,4,2.0,5
22420203,Old Foresters,Old Wykehamists,0,0,4.0,0
22420319,Old Etonians,KCS Old Boys,4,2,3.0,6
22420333,Old Harrovians,Old Brentwoods,1,5,2.0,6
22420278,Old Rugbeians,Old Malvernians,1,2,4.0,3
22420454,Lancing Old Boys,Old Salopians,6,5,5.0,11
22420436,Old Westminsters,Old Marlburians,2,2,5.0,4
22420488,Old Radleians,Old Johnians,2,3,4.0,5
22420178,Old Harrovians II,Old Carthusians II,0,5,0.0,5
22420499,Old Kimboltonians,Old Alleynians III,3,0,2.0,3
22420505,Kings College Wimbledon II,Old Brentwoods II,5,4,5.0,9
23073609,Old Epsomians,Old Tonbridgians II,6,1,0.0,7
22425363,Old Albanians SA,Old Harrovians III,2,2,5.0,4
22425300,Old Stoics,Old Wellingtonians,4,2,3.0,6
22425391,Old King's Scholars,Old Ardinians,1,4,2.0,5
22425440,Old Berkhamstedians II,Old Wykehamists II,5,1,2.0,6
22425429,Old Kingstonians,Old Westminsters II,4,2,3.0,6
22425325,Old Eastbournians,Old Ardinians II,5,2,2.0,7
22484105,Old Brentwoods IV,Old Shirburnians,0,3,2.0,3
22518161,Old Aldenhamians,Globe Rangers,2,4,3.0,6
22518160,Old Cholmeleians,Earlsfield FC,5,1,2.0,6
22683241,Old Haberdashers,West Wickham,3,3,5.0,6
22543051,Old Pauline,Old Chigwellians II,6,5,5.0,11
22642727,Bealonians,Old Merchant Taylors',8,0,0.0,8
22543141,Mill Hill Village,Old Reptonians,4,1,2.0,5
22646643,Old Cholmeleians II,Albanian FC,2,2,5.0,4
22666482,Southern Amateur League Rep XI,Arthurian League Representative Team,3,1,3.0,4
21874502,Lancing College 1st XI,Lancing Old Boys,1,4,2.0,5
22420307,Old Foresters,Old Harrovians,7,0,0.0,7
22420517,Old Alleynians,KCS Old Boys,7,2,0.0,9
22420465,Old Wykehamists,Old Etonians,2,2,5.0,4
22420280,Old Tonbridgians,Old Carthusians,4,2,3.0,6
22420328,Old Berkhamstedians,Old Westminsters,2,0,2.0,2
22420324,Old Reptonians,Old Rugbeians,2,2,5.0,4
22420500,Old Malvernians,Old Chigwellians,2,3,4.0,5
22420293,Old Marlburians,Old Cholmeleians,3,4,4.0,7
22420353,Old Etonians II,Old Alleynians II,4,2,3.0,6
22420344,Old Johnians,Old Harrovians II,3,3,5.0,6
22420260,Old Kimboltonians,Old Epsomians,2,0,2.0,2
22420272,Old Cholmeleians II,Old Alleynians III,4,1,2.0,5
22425290,Old Albanians SA,Old Ardinians,2,7,0.0,9
22484119,Old Wykehamists II,Old Cheltonians,4,3,4.0,7
22484118,Old Harrovians III,Old Westminsters II,2,3,4.0,5
22484111,Old Merchant Taylors' II,Old Eastbournians,3,2,4.0,5
22484109,St Edwards OSE,Old Kingstonians,2,0,2.0,2
22484117,Old Amplefordians,Old Stoics,2,5,2.0,7
22642695,South Bank Cuaco,Old Brentwoods IV,2,3,4.0,5
21871130,Shrewsbury School 1st XI,Old Salopians,0,0,4.0,0
21871131,Shrewsbury School 2nd XI,Old Salopians II,0,0,4.0,0
22306984,Albanian FC,Old Aldenhamians,1,0,3.0,1
22581824,Bealonians,Old Brentwoods,3,0,2.0,3
22603871,Kings College Wimbledon II,Old Meadonians,1,6,0.0,7
22420332,Old Foresters,Old Bradfieldians,3,5,4.0,8
22420482,Old Carthusians,Old Wykehamists,3,2,4.0,5
22420340,Old Tonbridgians,Old Alleynians,2,2,5.0,4
22420518,Old Berkhamstedians,Old Rugbeians,1,3,3.0,4
22420422,Old Marlburians,Old Chigwellians,5,0,0.0,5
22420247,Old Aldenhamians,Old Harrovians II,3,1,3.0,4
22420445,Old Chigwellians II,Old Alleynians II,1,2,4.0,3
22420252,Old Etonians II,Old Johnians,2,4,3.0,6
22420526,Old Sennockians,Old Carthusians II,3,2,4.0,5
22420440,Old Alleynians III,Kings College Wimbledon II,1,0,3.0,1
22425394,Old King's Scholars,Old Harrovians III,0,1,3.0,1
22425321,Old Stoics,Old Albanians SA,0,5,0.0,5
22425295,Old Wykehamists II,Old Salopians II,2,5,2.0,7
22425435,Old Kingstonians,Old Amplefordians,0,6,0.0,6
22425434,Old Ardinians II,Old Berkhamstedians II,0,4,1.0,4
22425338,Old Westminsters II,Old Eastbournians,2,0,2.0,2
22029904,Lancing Old Boys,Old Malvernians,8,1,0.0,9
22029899,Old Brentwoods,Old Harrovians,2,1,4.0,3
22029900,Old Salopians,Old Kimboltonians,4,0,1.0,4
22029893,Old Merchant Taylors',Old Shirburnians,1,2,4.0,3
22306989,Old Brentwoods II,Old Parkonians,2,2,5.0,4
22306417,Old Etonians,Old Lyonians,4,2,3.0,6
22543140,Old Woodhouseians,Old Cholmeleians,3,1,3.0,4
22543142,Old Kingsburians,Old Cholmeleians II,2,4,3.0,6
22603870,KCS Old Boys,Economicals,3,3,5.0,6
22420345,Old Marlburians,Lancing Old Boys,4,1,2.0,5
22420244,Old Salopians,Old Chigwellians,5,2,2.0,7
22420321,Old Harrovians II,Old Chigwellians II,1,2,4.0,3
22420223,Old Alleynians II,Old Carthusians II,1,1,4.0,2
22420240,Old Merchant Taylors',Old Etonians II,1,4,2.0,5
22420502,Old Sennockians,Old Johnians,2,1,4.0,3
23073605,Old Alleynians III,Old Tonbridgians II,1,2,4.0,3
22420379,Old Epsomians,Kings College Wimbledon II,1,4,2.0,5
22425438,Old King's Scholars,Old Shirburnians,3,3,5.0,6
22425313,Lancing Old Boys II,Old Stoics,1,4,2.0,5
22425437,Old Harrovians III,Old Albanians SA,1,3,3.0,4
22196856,Old Brentwoods IV,Old Cheltonians,2,4,3.0,6
22425343,Old Wykehamists II,Old Berkhamstedians II,1,5,2.0,6
22425352,Old Westminsters II,Old Salopians II,2,4,3.0,6
22029901,Old Bradfieldians,Old Kingstonians,8,0,0.0,8
22029895,Old Foresters,Old Tonbridgians,0,2,2.0,2
22029898,Old Cholmeleians,Old Rugbeians,4,1,2.0,5
22029894,Old Radleians,Old Reptonians,2,5,2.0,7
22029903,Old Wykehamists,Old Eastbournians,6,2,2.0,8
22029892,Old Aldenhamians,Old Berkhamstedians,1,4,2.0,5
22029902,Old Westminsters,Old Ardinians,1,2,4.0,3
22410220,Old Haberdashers,Old Parkonians,6,1,0.0,7
22410199,Old Brentwoods II,Old Kingsburians,1,3,3.0,4
22455817,Crouch End Vampires,Old Brentwoods,1,4,2.0,5
22543139,Latymer Old Boys,Old Malvernians,8,2,0.0,10
22420175,Old Bradfieldians,Old Etonians,5,4,5.0,9
22420381,Old Harrovians,Old Wykehamists,2,6,2.0,8
22420463,Old Tonbridgians,KCS Old Boys,3,0,2.0,3
22420241,Old Rugbeians,Old Reptonians,0,2,2.0,2
22420366,Old Marlburians,Old Berkhamstedians,2,4,3.0,6
22420525,Old Salopians,Old Malvernians,6,2,2.0,8
22420489,Old Westminsters,Old Cholmeleians,1,1,4.0,2
22420385,Old Aldenhamians,Old Alleynians II,2,3,4.0,5
22420363,Old Carthusians II,Old Harrovians II,1,3,3.0,4
22420520,Old Etonians II,Old Radleians,9,0,0.0,9
23073604,Kings College Wimbledon II,Old Tonbridgians II,2,1,4.0,3
22420232,Old Brentwoods II,Old Alleynians III,5,1,2.0,6
22425379,Old Albanians SA,Old King's Scholars,3,1,3.0,4
22425294,Old Shirburnians,Old Harrovians III,4,2,3.0,6
22196857,Old Haberdashers,Old Brentwoods III,3,4,4.0,7
22425387,Old Berkhamstedians II,Old Ardinians II,3,1,3.0,4
22425388,Old Kingstonians,Old Wykehamists II,4,0,1.0,4
22425340,Old Eastbournians,Old Amplefordians,6,3,3.0,9
22029896,Old Sennockians,Old Chigwellians,1,7,0.0,8
22455816,Alexandra Park FC,Old Carthusians,2,4,3.0,6
22455818,Old Foresters,Old Garchonians,2,0,2.0,2
22455819,South Bank Cuaco,Old Alleynians,2,2,5.0,4
21872200,Lancing Old Boys Vets,Old Bradfieldians Vets,3,1,3.0,4
22420519,Old Brentwoods,Old Etonians,2,2,5.0,4
22420267,Old Wykehamists,Old Alleynians,2,1,4.0,3
22420528,Old Carthusians,KCS Old Boys,4,2,3.0,6
22420511,Old Harrovians,Old Bradfieldians,0,8,0.0,8
22420292,Old Malvernians,Old Berkhamstedians,1,3,3.0,4
22420446,Old Cholmeleians,Lancing Old Boys,2,0,2.0,2
22420391,Old Chigwellians,Old Reptonians,4,2,3.0,6
22420281,Old Westminsters,Old Salopians,3,3,5.0,6
22420180,Old Radleians,Old Sennockians,5,2,2.0,7
22420194,Old Johnians,Old Alleynians II,2,2,5.0,4
22420336,Old Merchant Taylors',Old Harrovians II,2,1,4.0,3
22420298,Old Aldenhamians,Old Etonians II,1,4,2.0,5
22420483,Old Cholmeleians II,Old Brentwoods II,6,1,0.0,7
23073612,Old Tonbridgians II,Old Alleynians III,5,7,4.0,12
22425330,Lancing Old Boys II,Old Albanians SA,0,2,2.0,2
22425308,Old Harrovians III,Old King's Scholars,3,1,3.0,4
22196838,Old Cheltonians,Old Brentwoods IV,2,2,5.0,4
22425316,Old Wykehamists II,Old Ardinians II,1,4,2.0,5
22425365,Old Eastbournians,Old Westminsters II,2,4,3.0,6
22425441,Old Salopians II,Old Amplefordians,2,5,2.0,7
22455821,Old Ardinians,Old Parmiterians,0,3,2.0,3
22134304,Old Foresters,Chelmsford City Reserves,1,2,4.0,3
21870904,Marlborough College 1st XI,Old Marlburians,3,3,5.0,6
22306427,Old Chigwellians II,Old Finchleians,2,3,4.0,5
22420212,Old Bradfieldians,Old Brentwoods,1,1,4.0,2
22420216,Old Etonians,Old Wykehamists,3,3,5.0,6
22420220,Old Tonbridgians,Old Foresters,3,3,5.0,6
22420434,Old Rugbeians,Old Berkhamstedians,4,1,2.0,5
22420211,Lancing Old Boys,Old Westminsters,1,5,2.0,6
22420501,Old Marlburians,Old Salopians,4,2,3.0,6
22420459,Old Cholmeleians,Old Malvernians,5,0,0.0,5
22420342,Old Chigwellians II,Old Etonians II,3,2,4.0,5
22420449,Old Harrovians II,Old Radleians,2,1,4.0,3
22420277,Old Merchant Taylors',Old Sennockians,4,2,3.0,6
22420215,Old Epsomians,Old Alleynians III,3,4,4.0,7
22420224,Old Brentwoods II,Old Kimboltonians,2,2,5.0,4
22425296,Old Albanians SA,Old Shirburnians,3,1,3.0,4
22425428,Old Harrovians III,Old Wellingtonians,2,2,5.0,4
22425324,Old Cheltonians,Old Haberdashers,1,4,2.0,5
22425443,Old Eastbournians,Old Berkhamstedians II,1,2,4.0,3
22425385,Old Salopians II,Old Ardinians II,1,6,0.0,7
22425347,Old Westminsters II,Old Kingstonians,0,3,2.0,3
22410175,London Welsh F.C.,Old Chigwellians,3,4,4.0,7
22410176,Old Vaughanians,Old Reptonians,4,2,3.0,6
22410213,Old Finchleians,Old King's Scholars,4,1,2.0,5
22464899,Charterhouse School 1st XI,Old Carthusians,1,6,0.0,7
22464900,Charterhouse School 2nd XI,Old Carthusians II,0,0,4.0,0
22464901,Charterhouse School 3rd XI,Old Carthusians III,1,6,0.0,7
21872179,Old Etonians Vets,Old Carthusians Vets,1,0,3.0,1
22420354,Old Foresters,KCS Old Boys,2,2,5.0,4
22420200,Old Brentwoods,Old Harrovians,2,0,2.0,2
22420201,Old Carthusians,Old Tonbridgians,4,1,2.0,5
22420352,Old Etonians,Old Alleynians,3,2,4.0,5
22420206,Old Reptonians,Lancing Old Boys,4,0,1.0,4
22420450,Old Malvernians,Old Salopians,2,1,4.0,3
22420205,Old Marlburians,Old Westminsters,2,1,4.0,3
22420239,Old Harrovians II,Old Alleynians II,0,2,2.0,2
22420179,Old Merchant Taylors',Old Radleians,7,2,0.0,9
22420207,Old Sennockians,Old Aldenhamians,7,2,0.0,9
22425289,Lancing Old Boys II,Old King's Scholars,6,0,0.0,6
22425405,Old Harrovians III,Old Ardinians,1,6,0.0,7
22425334,Old Wellingtonians,Old Shirburnians,2,9,0.0,11
22425407,Old Wykehamists II,Old Kingstonians,4,2,3.0,6
22425291,Old Amplefordians,Old Ardinians II,4,3,4.0,7
22410190,Albanian FC,Old Cholmeleians II,4,2,3.0,6
22410189,East Barnet Old Grammarians,Old Chigwellians II,1,3,3.0,4
21870903,Haberdashers Aske School 1st XI,Old Haberdashers,0,2,2.0,2
22420191,Old Etonians,Old Foresters,2,1,4.0,3
22420184,KCS Old Boys,Old Bradfieldians,6,0,0.0,6
22420186,Old Brentwoods,Old Alleynians,1,1,4.0,2
22420193,Old Harrovians,Old Carthusians,0,9,0.0,9
22420197,Old Tonbridgians,Old Wykehamists,3,3,5.0,6
22420183,Old Rugbeians,Old Salopians,1,4,2.0,5
22420188,Old Chigwellians,Lancing Old Boys,0,0,4.0,0
22420189,Old Cholmeleians,Old Berkhamstedians,4,3,4.0,7
22420198,Old Westminsters,Old Malvernians,4,1,2.0,5
22420513,Old Radleians,Old Alleynians II,1,5,2.0,6
22420170,Old Aldenhamians,Old Merchant Taylors',2,3,4.0,5
22420394,Old Harrovians II,Old Etonians II,0,11,0.0,11
22420190,Old Cholmeleians II,Kings College Wimbledon II,3,4,4.0,7
22425276,Lancing Old Boys II,Old Shirburnians,2,5,2.0,7
22425284,Old Ardinians,Old King's Scholars,6,0,0.0,6
22425283,Old Albanians SA,Old Wellingtonians,5,3,4.0,8
22425287,Old Stoics,Old Harrovians III,5,1,2.0,6
22196825,Old Brentwoods III,Old Cheltonians,6,4,4.0,10
22425285,Old Berkhamstedians II,Old Amplefordians,1,2,4.0,3
22425286,Old Salopians II,Old Kingstonians,1,4,2.0,5
22421285,Old Alleynians,Old Wykehamists,1,2,4.0,3
22421284,Old Etonians,Old Carthusians,1,2,4.0,3
22420338,Old Rugbeians,Lancing Old Boys,2,0,2.0,2
22420471,Old Malvernians,Old Marlburians,1,1,4.0,2
22420473,Old Salopians,Old Berkhamstedians,1,2,4.0,3
22420330,Old Cholmeleians,Old Reptonians,0,1,3.0,1
22420455,Old Aldenhamians,Old Radleians,4,1,2.0,5
22420492,Old Alleynians II,Old Chigwellians II,0,2,2.0,2
22420320,Old Etonians II,Old Carthusians II,13,1,1.0,14
22420433,Old Johnians,Old Sennockians,4,0,1.0,4
22420246,Kings College Wimbledon II,Old Epsomians,0,1,3.0,1
23073607,Old Cholmeleians II,Old Tonbridgians II,5,0,0.0,5
22425377,Old Stoics,Old Shirburnians,0,2,2.0,2
22425344,Old Berkhamstedians II,Old Salopians II,2,0,2.0,2
21871123,Brentwood School 1st XI,Old Brentwoods,0,0,4.0,0
21871124,Brentwood School 2nd XI,Old Brentwoods II,0,0,4.0,0
21871125,Brentwood School 3rd XI,Old Brentwoods III,0,0,4.0,0
21871126,Brentwood School 4th XI,Old Brentwoods IV,0,0,4.0,0
21871127,Brentwood School 5th XI,Old Brentwoods Vets,0,0,4.0,0
21926256,Kingston Grammar School 1st XI,Old Kingstonians,3,4,4.0,7
21871128,Westminster School 1st XI,Old Westminsters,0,0,4.0,0
21871129,Westminster School 2nd XI,Old Westminsters II,0,0,4.0,0
22421247,Old Brentwoods,Old Carthusians,0,3,2.0,3
22421248,Old Harrovians,KCS Old Boys,0,5,0.0,5
22421246,Old Tonbridgians,Old Bradfieldians,4,2,3.0,6
22420397,Old Salopians,Lancing Old Boys,2,5,2.0,7
22420235,Old Cholmeleians,Old Marlburians,1,2,4.0,3
22420258,Old Chigwellians,Old Rugbeians,4,2,3.0,6
22420396,Old Radleians,Old Carthusians II,2,1,4.0,3
22420222,Old Aldenhamians,Old Johnians,1,4,2.0,5
22420214,Old Chigwellians II,Old Sennockians,1,3,3.0,4
22420512,Old Kimboltonians,Old Cholmeleians II,2,4,3.0,6
22425383,Old Harrovians III,Old Shirburnians,0,1,3.0,1
22196903,Old Brentwoods III,Old Brentwoods IV,12,0,0.0,12
22425329,Old Wykehamists II,Old Amplefordians,0,1,3.0,1
22278370,Old Ardinians,Old Ardinians II,0,0,4.0,0
21870896,West Wickham,Old Alleynians AFC,0,0,4.0,0
22173775,West Wickham III,Old Alleynians III,0,0,4.0,0
21870883,Eton College 1st XI,Old Etonians,0,0,4.0,0
21870884,Eton College 2nd XI,Old Etonians II,0,0,4.0,0
21870881,Forest School 1st XI,Old Foresters,0,0,4.0,0
21870882,Forest School 2nd XI,Old Foresters II,0,0,4.0,0
21870895,Repton School 1st XI,Old Reptonians,0,0,4.0,0
22236126,Old Malvernians,Old Rugbeians,4,1,2.0,5
21870879,Highgate School 1st XI,Old Cholmeleians,0,0,4.0,0
21870880,Highgate School 2nd XI,Old Cholmeleians II,0,0,4.0,0
22229769,Old Harrovians II,Old Radleians,2,2,5.0,4
21871231,Old Reptonians,Old Wykehamists,0,0,4.0,0
21890839,KCS Old Boys,KCS Old Boys Vets,0,0,4.0,0
21988171,Corinthian-Casuals,Lancing Old Boys,0,0,4.0,0
21871230,KCS Old Boys,Kings College Wimbledon II,5,5,6.0,10
21891282,Old Berkhamstedians,Old Alleynians II,0,0,4.0,0
21871256,NUFC Oilers,Old Reptonians,2,3,4.0,5
21871220,Old Salopians,Old Alleynians AFC,0,0,4.0,0
21894738,Kings College Wimbledon II,Old Johnians,0,0,4.0,0
21871210,Old Reptonians,Old Alleynians AFC,1,7,0.0,8
21871209,Old Reptonians,KCS Old Boys,0,0,4.0,0
21870364,Old Berkhamstedians,Old Suttonians,2,3,4.0,5
24215482,Old Foresters,Old Chigwellians,2,3,4.0,5
24222178,Kings College Wimbledon II,Old Tonbridgians II,4,0,1.0,4
24222284,Old Haberdashers,Old Brentwoods III,1,2,4.0,3
24254080,Old Eastbournians,Old Brentwoods IV,0,0,4.0,0
24239849,Old Alleynians,Old Carthusians,1,0,3.0,1
24215477,Lancing Old Boys,Old Rugbeians,2,1,4.0,3
24140992,Old Malvernians,Old Etonians II,0,5,0.0,5
24220997,Old Radleians,Old Aldenhamians,2,4,3.0,6
24239881,Old Cholmeleians II,Old Chigwellians II,5,2,2.0,7
24220982,Old Harrovians II,Old Sennockians,3,0,2.0,3
24222176,Kings College Wimbledon II,Old Carthusians II,6,2,2.0,8
24222119,Old Brentwoods II,Old Alleynians III,1,9,0.0,10
24222144,Old Ardinians,Old Epsomians,5,3,4.0,8
24140975,Old Brentwoods II,Old Tonbridgians II,1,3,3.0,4
24210550,Old Haberdashers,Old Berkhamstedians II,6,2,2.0,8
24222262,Old Amplefordians,Old Stoics,15,1,1.0,16
24640005,Old Cholmeleians Vets,Old Etonians Vets,2,3,4.0,5
24642893,KCS Old Boys Vets,Old Salopians Vets,4,2,3.0,6
24222616,Old Carthusians,Old Wykehamists,5,1,2.0,6
23786198,Old Aldenhamians,Old Cholmeleians II,1,0,3.0,1
24222177,Old Epsomians,Old Tonbridgians II,0,0,4.0,0
24140987,Old Kingstonians,Old Eastbournians,2,1,4.0,3
24220966,Old Radleians,Old Etonians II,2,3,4.0,5
24621038,Old Cholmeleians Vets,Old Foresters Vets,4,3,4.0,7
24620901,Old Wykehamists Vets,Old Salopians Vets,2,7,0.0,9
24222641,KCS Old Boys,Old Wykehamists,3,4,4.0,7
24140962,Old Brentwoods,Old Cholmeleians,3,2,4.0,5
24140972,Old Rugbeians,Old Johnians,5,2,2.0,7
24215479,Old Berkhamstedians,Old Westminsters,2,5,2.0,7
24220971,Old Chigwellians II,Old Aldenhamians,2,3,4.0,5
24220953,Old Sennockians,Old Malvernians,0,2,2.0,2
24222139,Old Ardinians,Old Merchant Taylors,2,1,4.0,3
23786220,Kings College Wimbledon II,Old Brentwoods II,6,2,2.0,8
24222118,Old Epsomians,Old Shirburnians,2,2,5.0,4
23786219,Old Tonbridgians II,Old Carthusians II,1,1,4.0,2
24141012,Old Stoics,Old Wellingtonians,2,8,0.0,10
23786229,Old Brentwoods IV,Old Cheltonians,2,0,2.0,2
24602105,Old Carthusians,Old Reptonians,0,0,4.0,0
24615264,Old Alleynians II,Old Kimboltonians,2,1,4.0,3
24602203,Old Haberdashers,Old Brentwoods III,4,2,3.0,6
24621039,Lancing Old Boys Vets,Old Etonians Vets,0,6,0.0,6
24220942,Old Malvernians,Old Aldenhamians,2,5,2.0,7
24220943,Old Sennockians,Old Radleians,0,4,1.0,4
24215451,Old Cholmeleians,Old Bradfieldians,4,2,3.0,6
24215465,Old Reptonians,Old Carthusians,0,2,2.0,2
24215440,Old Brentwoods,Old Etonians,5,1,2.0,6
24215402,KCS Old Boys,Old Alleynians,3,6,3.0,9
24239812,Lancing Old Boys,Old Berkhamstedians,1,2,4.0,3
24239814,Old Foresters,Old Rugbeians,1,0,3.0,1
24215561,Old Westminsters,Old Salopians,4,0,1.0,4
24220981,Old Alleynians II,Old Malvernians,3,3,5.0,6
24220945,Old Aldenhamians,Old Kimboltonians,1,2,4.0,3
24220979,Old Cholmeleians II,Old Radleians,0,1,3.0,1
24220955,Old Sennockians,Old Etonians II,3,1,3.0,4
24222195,Old Shirburnians,Kings College Wimbledon II,4,2,3.0,6
24222130,Old Merchant Taylors,Old Carthusians II,2,3,4.0,5
24222196,Old Ardinians,Old Albanians,3,3,5.0,6
23785745,Old Brentwoods III,Old Stoics,4,0,1.0,4
24222263,Old Haberdashers,Old Harrovians III,7,1,0.0,8
24222368,Lancing Old Boys II,Old Westminsters II,0,5,0.0,5
24222430,Old Brentwoods IV,Old Kingstonians,3,1,3.0,4
24222360,Old Eastbournians,Old Oundelians,3,1,3.0,4
24220972,Old Alleynians II,Old Etonians II,0,3,2.0,3
24221876,Old Brentwoods,Old Alleynians,3,1,3.0,4
24222161,Old Alleynians III,Kings College Wimbledon II,1,6,0.0,7
24239842,Old Cholmeleians,Old Carthusians,1,4,2.0,5
24222288,Old King's Scholars,Old Haberdashers,2,5,2.0,7
24620898,Old Salopians Vets,Old Malvernians Vets,4,0,1.0,4
24613318,Old Salopians Vets,Old Malvernians Vets,4,0,1.0,4
24215414,Old Bradfieldians,KCS Old Boys,2,3,4.0,5
24215471,Old Wykehamists,Old Alleynians,1,7,0.0,8
24222630,Old Carthusians,Old Reptonians,3,1,3.0,4
24215449,Old Cholmeleians,Old Brentwoods,2,1,4.0,3
24215533,Old Marlburians,Old Chigwellians,2,1,4.0,3
24215498,Old Foresters,Old Harrovians,3,1,3.0,4
24215564,Old Westminsters,Old Rugbeians,2,1,4.0,3
24220969,Old Malvernians,Old Chigwellians II,3,2,4.0,5
24222124,Kings College Wimbledon II,Old Epsomians,1,2,4.0,3
24254085,Old Carthusians II,Old Alleynians III,5,2,2.0,7
24222114,Old Merchant Taylors,Old Ardinians,1,2,4.0,3
24222191,Old Tonbridgians II,Old Brentwoods II,3,4,4.0,7
24222292,Old Brentwoods III,Old King's Scholars,7,2,0.0,9
24222356,Old Eastbournians,Old Cheltonians,1,4,2.0,5
24587665,Old Kimboltonians,Old Etonians II,3,2,4.0,5
24572429,Old Alleynians II,Old Cholmeleians II,3,1,3.0,4
24222639,Old Carthusians,KCS Old Boys,1,0,3.0,1
24215466,Old Tonbridgians,Old Alleynians,2,0,2.0,2
24215543,Old Rugbeians,Old Harrovians,3,5,4.0,8
24215563,Old Westminsters,Old Johnians,3,5,4.0,8
24220976,Old Kimboltonians,Old Cholmeleians II,2,1,4.0,3
24220958,Old Alleynians II,Old Chigwellians II,4,6,4.0,10
24239884,Old Malvernians,Old Sennockians,3,2,4.0,5
24220947,Old Etonians II,Old Harrovians II,2,1,4.0,3
24222188,Old Ardinians,Kings College Wimbledon II,4,2,3.0,6
24222182,Old Carthusians II,Old Epsomians,5,0,0.0,5
24222111,Old Albanians,Old Tonbridgians II,6,2,2.0,8
24222283,Old Wellingtonians,Old King's Scholars,0,0,4.0,0
24240047,Old Brentwoods III,Old Amplefordians,5,1,2.0,6
24222426,Old Cheltonians,Old Eastbournians,1,0,3.0,1
24222428,Old Kingstonians,Lancing Old Boys II,12,2,1.0,14
24510057,Old Foresters,Old Reptonians,1,2,4.0,3
24572183,Old Haberdashers,Old Westminsters II,3,2,4.0,5
24555119,Old Amplefordians,Old Brentwoods III,1,5,2.0,6
24442748,Old Aldenhamians Vets,Old Etonians Vets,0,5,0.0,5
24215470,Old Wykehamists,Old Cholmeleians,1,5,2.0,6
24215453,Old Etonians,Old Reptonians,2,5,2.0,7
24215515,Old Harrovians,Old Johnians,1,7,0.0,8
24215557,Old Westminsters,Old Marlburians,3,1,3.0,4
24140993,Old Cholmeleians II,Old Kimboltonians,3,1,3.0,4
24220962,Old Harrovians II,Old Aldenhamians,3,2,4.0,5
24222186,Old Alleynians III,Old Shirburnians,0,3,2.0,3
24222200,Old Epsomians,Old Carthusians II,5,4,5.0,9
24222318,Old Berkhamstedians II,Old Haberdashers,2,4,3.0,6
24222408,Old Salopians II,Old Westminsters II,0,8,0.0,8
24534443,Old Brentwoods,Old Carthusians,0,2,2.0,2
24509707,Old Etonians II,Old Tonbridgians II,4,1,2.0,5
24215400,KCS Old Boys,Old Cholmeleians,1,2,4.0,3
24215410,Old Alleynians,Old Bradfieldians,3,6,3.0,9
24215444,Old Carthusians,Old Tonbridgians,5,2,2.0,7
24239815,Old Johnians,Old Marlburians,2,3,4.0,5
24215499,Old Foresters,Old Salopians,4,0,1.0,4
24194596,Old Westminsters,Lancing Old Boys,3,2,4.0,5
24220964,Old Chigwellians II,Old Kimboltonians,4,4,6.0,8
24220968,Old Harrovians II,Old Radleians,0,1,3.0,1
24222180,Old Alleynians III,Old Carthusians II,0,8,0.0,8
24140980,Old Epsomians,Kings College Wimbledon II,2,2,5.0,4
24222181,Old Shirburnians,Old Albanians,2,0,2.0,2
24222324,Old Berkhamstedians II,Old King's Scholars,2,1,4.0,3
24222314,Old Wellingtonians,Old Haberdashers,1,10,0.0,11
24222348,Old Brentwoods IV,Old Salopians II,5,0,0.0,5
24540985,Old Ardinians,Old Cholmeleians II,0,3,2.0,3
24509994,Old Brentwoods III,Old Alleynians II,1,2,4.0,3
24535359,Old Harrovians III,Old Westminsters II,0,5,0.0,5
24421580,Old Brentwoods,Bealonians,1,2,4.0,3
24439515,Old Merchant Taylors II,Bealonians VII,5,4,5.0,9
24500307,Old Rugbeians,Kings Old Boys,1,0,3.0,1
24540260,Old Cholmeleians Vets,Old Reptonians Vets,3,1,3.0,4
24215469,Old Wykehamists,Old Etonians,1,3,3.0,4
24215398,KCS Old Boys,Old Carthusians,2,1,4.0,3
24215441,Old Alleynians,Old Brentwoods,2,2,5.0,4
24215450,Old Cholmeleians,Old Reptonians,1,2,4.0,3
24215542,Old Rugbeians,Old Foresters,1,3,3.0,4
24239813,Lancing Old Boys,Old Harrovians,3,2,4.0,5
24215547,Old Westminsters,Old Berkhamstedians,2,3,4.0,5
24220952,Old Radleians,Old Kimboltonians,6,2,2.0,8
24220965,Old Cholmeleians II,Old Sennockians,1,2,4.0,3
24239895,Old Etonians II,Old Aldenhamians,5,0,0.0,5
23786197,Old Harrovians II,Old Chigwellians II,1,3,3.0,4
24140981,Old Ardinians,Old Carthusians II,5,1,2.0,6
24222159,Old Merchant Taylors,Old Epsomians,4,1,2.0,5
24222160,Old Tonbridgians II,Old Albanians,1,3,3.0,4
24222321,Old King's Scholars,Old Stoics,3,1,3.0,4
24222358,Old Kingstonians,Old Brentwoods IV,2,1,4.0,3
24482921,Old Berkhamstedians II,Old Amplefordians,3,3,5.0,6
24472479,Old Brentwoods Vets,Old Foresters Vets,2,2,5.0,4
24215463,Old Reptonians,Old Wykehamists,3,1,3.0,4
24215399,KCS Old Boys,Old Tonbridgians,0,5,0.0,5
24215455,Old Etonians,Old Brentwoods,2,1,4.0,3
24221871,Old Marlburians,Old Westminsters,0,2,2.0,2
24215541,Old Rugbeians,Old Berkhamstedians,3,3,5.0,6
24215516,Old Harrovians,Old Foresters,0,8,0.0,8
24220959,Old Kimboltonians,Old Etonians II,2,4,3.0,6
24220960,Old Malvernians,Old Cholmeleians II,2,3,4.0,5
24220961,Old Radleians,Old Alleynians II,0,0,4.0,0
24222156,Old Alleynians III,Old Epsomians,1,1,4.0,2
24222131,Old Brentwoods II,Kings College Wimbledon II,2,2,5.0,4
24239908,Old Carthusians II,Old Merchant Taylors,3,1,3.0,4
24222149,Old Tonbridgians II,Old Shirburnians,2,1,4.0,3
24222294,Old Berkhamstedians II,Old Wellingtonians,2,2,5.0,4
24222290,Old Amplefordians,Old Haberdashers,0,5,0.0,5
24222372,Old Brentwoods IV,Old Westminsters II,0,4,1.0,4
24381740,Old Salopians,Old Carthusians,1,5,2.0,6
24427038,Lancing Old Boys II,Old Harrovians III,2,3,4.0,5
23954929,Old Haberdashers,Old Ardinians,2,10,0.0,12
24215416,Old Bradfieldians,Old Etonians,0,1,3.0,1
24222611,Old Alleynians,Old Tonbridgians,6,2,2.0,8
24215528,Old Marlburians,Lancing Old Boys,5,1,2.0,6
24215545,Old Salopians,Old Johnians,3,2,4.0,5
24215483,Old Chigwellians,Old Rugbeians,3,4,4.0,7
24220984,Old Aldenhamians,Old Chigwellians II,0,2,2.0,2
24222185,Old Alleynians III,Old Merchant Taylors,0,3,2.0,3
24222135,Kings College Wimbledon II,Old Albanians,1,2,4.0,3
24076663,Old King's Scholars,Old Wellingtonians,4,1,2.0,5
24222285,Old Harrovians III,Old Amplefordians,1,0,3.0,1
24222406,Lancing Old Boys II,Old Cheltonians,0,3,2.0,3
24222367,Old Brentwoods IV,Old Oundelians,7,2,0.0,9
24222401,Old Westminsters II,Old Kingstonians,2,0,2.0,2
24398093,KCS Old Boys,Old Reptonians,1,4,2.0,5
24397061,Old Brentwoods,Old Westminsters,8,1,0.0,9
24418415,Old Foresters,Old Radleians,4,1,2.0,5
24482923,Old Kimboltonians,Old Carthusians II,2,2,5.0,4
24441272,Old Brentwoods III,Old Sennockians,3,2,4.0,5
24460765,Old Berkhamstedians II,Old Alleynians II,0,0,4.0,0
24466500,Old Cholmeleians II,Old Brentwoods II,4,1,2.0,5
24483120,Old Harrovians II,Old Etonians II,2,4,3.0,6
24482983,Old Haberdashers,Old Stoics,4,1,2.0,5
24215413,Old Bradfieldians,Old Carthusians,2,2,5.0,4
24215434,Old Brentwoods,Old Reptonians,1,1,4.0,2
24215411,Old Alleynians,Old Cholmeleians,4,4,6.0,8
24215476,Lancing Old Boys,Old Westminsters,0,1,3.0,1
24215526,Old Marlburians,Old Berkhamstedians,3,2,4.0,5
24215492,Old Chigwellians,Old Foresters,2,3,4.0,5
24220957,Old Malvernians,Old Radleians,5,4,5.0,9
24220956,Old Cholmeleians II,Old Aldenhamians,3,0,2.0,3
24222138,Old Shirburnians,Old Brentwoods II,1,3,3.0,4
24222143,Old Merchant Taylors,Kings College Wimbledon II,2,6,2.0,8
24222136,Old Tonbridgians II,Old Epsomians,3,2,4.0,5
24222373,Old Eastbournians,Old Salopians II,1,1,4.0,2
24222362,Old Westminsters II,Old Cheltonians,1,0,3.0,1
24466488,Old Kimboltonians,Old Harrovians III,4,1,2.0,5
24221962,Old Brentwoods IV,Old Harrovians II,3,5,4.0,8
23954939,Old Haberdashers,Old Merchant Taylors II,1,0,3.0,1
23954950,Old Wellingtonians,Old Wykehamists II,2,0,2.0,2
24388887,Old Kingstonians,Old Amplefordians,1,2,4.0,3
24396969,Old Etonians II,Old Owens II,1,4,2.0,5
24222640,Old Carthusians,Old Alleynians,2,1,4.0,3
24215415,Old Bradfieldians,Old Alleynians,0,2,2.0,2
24215462,Old Reptonians,KCS Old Boys,1,0,3.0,1
24215432,Old Brentwoods,Old Wykehamists,4,3,4.0,7
24215454,Old Etonians,Old Cholmeleians,2,0,2.0,2
24215521,Old Johnians,Old Westminsters,0,1,3.0,1
24215484,Old Chigwellians,Old Salopians,4,0,1.0,4
24215497,Old Foresters,Lancing Old Boys,7,0,0.0,7
24220954,Old Alleynians II,Old Harrovians II,0,4,1.0,4
24222179,Old Epsomians,Old Ardinians,2,2,5.0,4
24222127,Old Albanians,Old Merchant Taylors,0,2,2.0,2
24222313,Old King's Scholars,Old Brentwoods III,1,6,0.0,7
24222361,Lancing Old Boys II,Old Brentwoods IV,4,3,4.0,7
24222366,Old Salopians II,Old Kingstonians,4,1,2.0,5
24372943,Old Wellingtonians,Old Berkhamstedians II,1,3,3.0,4
24397717,Old Cheltonians,Old Etonians II,0,2,2.0,2
23954926,Kings College Wimbledon II,Old Kimboltonians,2,5,2.0,7
24440051,Old Eastbournians,Old Cholmeleians II,1,3,3.0,4
24440036,Old Stoics,Old Brentwoods II,1,4,2.0,5
24441271,Old Carthusians II,Old Malvernians,5,0,0.0,5
24441281,Old Tonbridgians II,Old Radleians,4,3,4.0,7
24439476,Actonians Association VII,Old Haberdashers,4,3,4.0,7
24416362,Dorkinians,Old Carthusians,6,5,5.0,11
24215464,Old Reptonians,Old Tonbridgians,2,2,5.0,4
24215431,Old Brentwoods,Old Bradfieldians,4,0,1.0,4
24140964,Old Etonians,KCS Old Boys,0,3,2.0,3
24215478,Old Berkhamstedians,Old Salopians,3,1,3.0,4
24215539,Old Rugbeians,Old Chigwellians,1,0,3.0,1
24215504,Old Harrovians,Lancing Old Boys,6,2,2.0,8
24221881,Old Westminsters,Old Foresters,2,3,4.0,5
24220996,Old Alleynians II,Old Kimboltonians,4,1,2.0,5
24220950,Old Aldenhamians,Old Etonians II,1,6,0.0,7
24220948,Old Chigwellians II,Old Sennockians,1,2,4.0,3
24222126,Old Carthusians II,Old Ardinians,1,6,0.0,7
24222155,Old Albanians,Kings College Wimbledon II,5,2,2.0,7
24222125,Old Tonbridgians II,Old Alleynians III,1,3,3.0,4
24222281,Old Ardinians II,Old Amplefordians,1,1,4.0,2
24222282,Old Brentwoods III,Old Berkhamstedians II,3,1,3.0,4
24240049,Old Oundelians,Old Cheltonians,0,6,0.0,6
24222357,Old Salopians II,Lancing Old Boys II,0,4,1.0,4
23954910,Old Eastbournians,Old King's Scholars,2,2,5.0,4
23954934,Old Malvernians,Old Merchant Taylors,3,2,4.0,5
23954906,Old Stoics,Old Kingstonians,2,2,5.0,4
23954928,Old Epsomians,Old Radleians,2,11,1.0,13
24254220,Old Carthusians,Dorkinians,2,3,4.0,5
24380543,Old Hamptonians,Old Alleynians,3,1,3.0,4
24240055,Shene Old Grammarians,Old Cholmeleians,2,1,4.0,3
24422289,East Barnet Old Grammarians IV,Old Haberdashers,3,6,3.0,9
24223938,Bealonians VII,Old Brentwoods IV,2,1,4.0,3
24221462,Bealonians VIII,Old Merchant Taylors II,3,9,0.0,12
24215447,Old Cholmeleians,Old Tonbridgians,3,2,4.0,5
24215461,Old Reptonians,Old Alleynians,2,1,4.0,3
24107283,Old Wykehamists,Old Carthusians,2,4,3.0,6
24215396,KCS Old Boys,Old Etonians,3,5,4.0,8
24215518,Old Johnians,Old Salopians,1,3,3.0,4
24215525,Old Marlburians,Old Foresters,0,2,2.0,2
24215503,Old Harrovians,Old Berkhamstedians,6,4,4.0,10
24215562,Old Westminsters,Old Chigwellians,1,4,2.0,5
24222265,Old King's Scholars,Old Harrovians III,1,3,3.0,4
24222347,Old Cheltonians,Lancing Old Boys II,0,1,3.0,1
23954927,Old Alleynians II,Old Shirburnians,5,1,2.0,6
24372944,Old Tonbridgians II,Old Westminsters II,3,3,5.0,6
23954951,Old Berkhamstedians II,Old Brentwoods IV,3,1,3.0,4
24201397,Old Brentwoods,Old Wilsonians,2,1,4.0,3
24372780,Old Rugbeians,Old Aloysians,2,1,4.0,3
24402119,Old Tenisonians II,Kings College Wimbledon II,7,0,0.0,7
24222427,Old Oundelians,Old Wykehamists II,4,2,3.0,6
24238037,Old Bradfieldians Vets,Old Salopians Vets,1,1,4.0,2
24215459,Old Reptonians,Old Cholmeleians,1,2,4.0,3
24215452,Old Etonians,Old Carthusians,0,7,0.0,7
24215467,Old Tonbridgians,Old Wykehamists,7,2,0.0,9
24215538,Old Rugbeians,Old Salopians,5,2,2.0,7
24215517,Old Johnians,Old Foresters,3,5,4.0,8
24215502,Old Harrovians,Old Chigwellians,2,3,4.0,5
24220974,Old Kimboltonians,Old Harrovians II,4,1,2.0,5
24220951,Old Cholmeleians II,Old Alleynians II,4,1,2.0,5
24222117,Old Carthusians II,Old Brentwoods II,3,4,4.0,7
24222312,Old Berkhamstedians II,Old Ardinians II,4,3,4.0,7
24222323,Old Stoics,Old Amplefordians,1,1,4.0,2
24121590,Old Shirburnians,KCS Old Boys,2,4,3.0,6
24048105,Old Alleynians,Old Brentwoods,2,3,4.0,5
24374753,Old Westminsters,Old Merchant Taylors,3,2,4.0,5
23954932,Old Chigwellians II,Old Brentwoods III,1,2,4.0,3
23954933,Old Sennockians,Old Alleynians III,2,1,4.0,3
23954938,Old Oundelians,Lancing Old Boys II,3,3,5.0,6
23954952,Old Cheltonians,Old Westminsters II,1,1,4.0,2
24360680,Old Haberdashers,Old Meadonians VI,8,4,2.0,12
24215458,Old Reptonians,Old Brentwoods,2,2,5.0,4
24215443,Old Carthusians,Old Cholmeleians,7,0,0.0,7
24215537,Old Rugbeians,Lancing Old Boys,3,2,4.0,5
24220937,Old Cholmeleians II,Old Harrovians II,5,0,0.0,5
24220935,Old Chigwellians II,Old Etonians II,2,2,5.0,4
24220936,Old Sennockians,Old Kimboltonians,1,3,3.0,4
24222066,Old Brentwoods II,Old Ardinians,1,7,0.0,8
24222261,Old Ardinians II,Old King's Scholars,4,4,6.0,8
24222264,Old Amplefordians,Old Berkhamstedians II,0,3,2.0,3
24176719,Old Merchant Taylors,Old Westminsters,1,1,4.0,2
24121500,Old Aldenhamians,Old Foresters,1,8,0.0,9
24121632,Old Etonians,Old Salopians,0,2,2.0,2
23954907,Old Cheltonians,Old Merchant Taylors II,5,4,5.0,9
23954908,Lancing Old Boys II,Old Harrovians III,0,3,2.0,3
23954909,Old Oundelians,Old Westminsters II,1,3,3.0,4
23954911,Old Wellingtonians,Old Wykehamists II,2,2,5.0,4
24140966,Old Bradfieldians,Old Cholmeleians,3,2,4.0,5
24121591,Old Reptonians,Old Chigwellians,3,0,2.0,3
24140954,Old Bradfieldians,Old Tonbridgians,3,2,4.0,5
23786191,Old Berkhamstedians,Old Chigwellians,1,2,4.0,3
24141007,Lancing Old Boys,Old Foresters,1,5,2.0,6
23785497,Old Salopians,Old Harrovians,2,2,5.0,4
23786214,Old Alleynians II,Old Sennockians,7,2,0.0,9
24141008,Old Shirburnians,Old Ardinians,1,2,4.0,3
23786227,Old King's Scholars,Old Ardinians II,3,4,4.0,7
24096906,Old Amplefordians,Old Brentwoods III,2,3,4.0,5
24140965,Old Cheltonians,Old Salopians II,2,3,4.0,5
23774116,Old Oundelians,Lancing Old Boys II,2,2,5.0,4
24231517,Old Alleynians,Old Meadonians,3,2,4.0,5
24231516,Old Carthusians,Old Blues,4,0,1.0,4
24197374,Old Rugbeians,Old Sedcopians,3,1,3.0,4
23786251,Old Wykehamists II,Old Kingstonians,0,1,3.0,1
23949449,Old Bradfieldians Vets,Old Carthusians Vets,1,0,3.0,1
24116862,Old Foresters Vets,Old Chigwellians Vets Blues,4,3,4.0,7
23786053,KCS Old Boys,Old Bradfieldians,6,2,2.0,8
23786062,Old Wykehamists,Old Brentwoods,2,1,4.0,3
23786054,Old Tonbridgians,Old Etonians,2,3,4.0,5
23786081,Lancing Old Boys,Old Johnians,1,2,4.0,3
23786082,Old Salopians,Old Chigwellians,0,9,0.0,9
23786074,Old Foresters,Old Marlburians,3,1,3.0,4
23786073,Old Westminsters,Old Harrovians,5,2,2.0,7
23786196,Old Radleians,Old Cholmeleians II,3,4,4.0,7
24048167,Old Aldenhamians,Old Alleynians II,0,2,2.0,2
23773845,Old Etonians II,Old Chigwellians II,1,2,4.0,3
23786195,Old Sennockians,Old Harrovians II,4,1,2.0,5
24141002,Old Alleynians III,Old Ardinians,0,5,0.0,5
23786215,Old Brentwoods II,Old Epsomians,1,4,2.0,5
23786218,Old Shirburnians,Old Merchant Taylors,4,1,2.0,5
24141003,Old Albanians,Old Carthusians II,3,2,4.0,5
23786223,Old Wellingtonians,Old Amplefordians,5,1,2.0,6
23786222,Old Stoics,Old Brentwoods III,0,4,1.0,4
23786221,Old Harrovians III,Old Berkhamstedians II,0,2,2.0,2
23786231,Old Oundelians,Old Eastbournians,1,2,4.0,3
24193555,Hale End Athletic,Old Cholmeleians,0,3,2.0,3
24231593,Old Chigwellians Vets Blues,Polytechnic Vets,3,0,2.0,3
24197375,Old Salvatorians,Old Carthusians,0,5,0.0,5
24188875,Old Reptonians,Old Wokingians,0,4,1.0,4
23949457,Old Brentwoods Vets,Old Wykehamists Vets,2,0,2.0,2
24140989,Old Alleynians,Old Wykehamists,7,2,0.0,9
24076670,Old Reptonians,Old Etonians,1,1,4.0,2
24076667,Old Brentwoods,KCS Old Boys,1,2,4.0,3
24076669,Old Tonbridgians,Old Bradfieldians,0,1,3.0,1
23785513,Lancing Old Boys,Old Salopians,1,3,3.0,4
24048165,Old Foresters,Old Berkhamstedians,5,2,2.0,7
23785519,Old Johnians,Old Harrovians,4,5,5.0,9
23785511,Old Marlburians,Old Rugbeians,2,0,2.0,2
23785522,Old Chigwellians,Old Westminsters,3,2,4.0,5
23785628,Old Kimboltonians,Old Chigwellians II,2,2,5.0,4
23785626,Old Aldenhamians,Old Sennockians,4,1,2.0,5
23785624,Old Etonians II,Old Cholmeleians II,3,1,3.0,4
23785625,Old Harrovians II,Old Malvernians,5,3,4.0,8
23925612,Kings College Wimbledon II,Old Ardinians,2,6,2.0,8
23785651,Old Brentwoods II,Old Albanians,0,4,1.0,4
23785652,Old Merchant Taylors,Old Alleynians III,1,2,4.0,3
23785877,Old Ardinians II,Old Berkhamstedians II,1,9,0.0,10
23785853,Old Brentwoods III,Old Haberdashers,1,4,2.0,5
23785866,Old Harrovians III,Old Wellingtonians,8,4,2.0,12
23785865,Old Amplefordians,Old King's Scholars,3,3,5.0,6
23786030,Old Kingstonians,Old Westminsters II,4,2,3.0,6
23786027,Old Cheltonians,Old Oundelians,8,0,0.0,8
23774120,Old Salopians II,Old Eastbournians,3,0,2.0,3
24152936,Old Carthusians,Bromleians,7,0,0.0,7
24231602,Old Chigwellians Vets Blues,Halstead Town Vets,3,2,4.0,5
24152946,Old Chigwellians Vets Blues,Canning Town Vets,3,5,4.0,8
23837661,Old Brentwoods IV,Old Parmiterians VII,7,2,0.0,9
24197379,Old Epsomians,Economicals III,1,2,4.0,3
23786029,Old Wykehamists II,Lancing Old Boys II,2,5,2.0,7
23949452,Old Malvernians Vets,Lancing Old Boys Vets,2,4,3.0,6
24107282,Old Bradfieldians,Old Reptonians,0,8,0.0,8
23785487,Old Alleynians,KCS Old Boys,4,4,6.0,8
24096852,Old Berkhamstedians,Old Johnians,2,3,4.0,5
24048164,Old Salopians,Old Marlburians,1,2,4.0,3
24048159,Old Chigwellians,Lancing Old Boys,1,0,3.0,1
24048160,Old Harrovians,Old Westminsters,0,2,2.0,2
23785619,Old Radleians,Old Harrovians II,5,0,0.0,5
23785617,Old Sennockians,Old Alleynians II,2,1,4.0,3
23785648,Old Shirburnians,Old Epsomians,0,5,0.0,5
23785647,Old Albanians,Old Ardinians,0,3,2.0,3
24115347,Old Ardinians II,Old Harrovians III,3,2,4.0,5
24096903,Old Wellingtonians,Old Berkhamstedians II,1,9,0.0,10
23786025,Lancing Old Boys II,Old Kingstonians,3,3,5.0,6
23786014,Old Cheltonians,Old Brentwoods IV,8,2,0.0,10
23786018,Old Oundelians,Old Salopians II,2,3,4.0,5
23786017,Old Westminsters II,Old Eastbournians,2,0,2.0,2
24092599,Old Carthusians,Old Cholmeleians,4,1,2.0,5
24111773,Old Meadonians IV,Old King's Scholars,1,0,3.0,1
24178512,Old Brentwoods,Old Blues,1,0,3.0,1
24070035,Old Strand Academicals,Old Rugbeians,1,4,2.0,5
23968292,Kings College Wimbledon II,Old Thorntonians IV,5,1,2.0,6
23949454,Old Reptonians Vets,Old Tonbridgians Vets,3,1,3.0,4
24076650,Old Etonians,Old Tonbridgians,1,3,3.0,4
23785500,Lancing Old Boys,Old Marlburians,1,3,3.0,4
23785498,Old Johnians,Old Rugbeians,3,1,3.0,4
23786192,Old Salopians,Old Foresters,3,5,4.0,8
23971044,Old Kimboltonians,Old Sennockians,4,2,3.0,6
23891543,Old Alleynians II,Old Aldenhamians,3,1,3.0,4
23785605,Old Etonians II,Old Malvernians,5,2,2.0,7
23785603,Old Chigwellians II,Old Radleians,2,1,4.0,3
23785641,Old Carthusians II,Old Shirburnians,2,4,3.0,6
23785645,Old Albanians,Old Alleynians III,5,3,4.0,8
23912201,Old Merchant Taylors,Old Brentwoods II,3,1,3.0,4
23912196,Old Tonbridgians II,Old Ardinians,0,2,2.0,2
24096893,Old Wellingtonians,Old Ardinians II,5,0,0.0,5
24115344,Old Berkhamstedians II,Old Stoics,3,1,3.0,4
23785669,Old Harrovians III,Old Brentwoods III,3,6,3.0,9
23786012,Old Kingstonians,Old Salopians II,2,1,4.0,3
23786011,Old Eastbournians,Lancing Old Boys II,2,1,4.0,3
24144172,Old Westminsters,Old Berkhamstedians,5,2,2.0,7
24026293,Leyton County Old Boys,Old Cholmeleians,1,2,4.0,3
24026294,Old Chigwellians,Richmond & Kew SSEC,3,5,4.0,8
24026297,Fulham Compton Old Boys II,Old Cholmeleians II,4,1,2.0,5
24096609,Old Brentwoods IV,St. James' Old Boys IV,8,0,0.0,8
24026298,Old Haberdashers,Actonians Association VIII,11,1,0.0,12
24026312,Croxley Green Vets,Old Chigwellians Vets Blues,0,3,2.0,3
24152944,Old Chigwellians Vets Blues,Atletico Trotters Vets,5,2,2.0,7
24042761,Old Brentwoods,Enfield Old Grammarians,4,2,3.0,6
24070006,Old Carthusians,Old Minchendenians,4,2,3.0,6
24070005,Old Alleynians,Old Suttonians,3,4,4.0,7
24048157,Old Wykehamists II,Old Oundelians,1,3,3.0,4
23785468,Old Wykehamists,Old Bradfieldians,2,2,5.0,4
23785465,Old Etonians,Old Alleynians,3,2,4.0,5
23785467,Old Tonbridgians,Old Reptonians,3,4,4.0,7
23785496,Old Berkhamstedians,Old Rugbeians,2,4,3.0,6
24014047,Old Johnians,Old Chigwellians,5,1,2.0,6
23785493,Old Marlburians,Old Harrovians,2,4,3.0,6
23785599,Old Radleians,Old Sennockians,6,2,2.0,8
23785598,Old Malvernians,Old Kimboltonians,2,2,5.0,4
23785590,Old Chigwellians II,Old Cholmeleians II,3,0,2.0,3
23925606,Old Brentwoods II,Old Carthusians II,6,0,0.0,6
23785637,Old Albanians,Old Shirburnians,4,3,4.0,7
23785658,Old Ardinians II,Old Brentwoods III,0,9,0.0,9
23875023,Old Berkhamstedians II,Old Amplefordians,3,3,5.0,6
24076661,Old Stoics,Old King's Scholars,1,2,4.0,3
23785659,Old Harrovians III,Old Haberdashers,0,2,2.0,2
23911886,Old Brentwoods IV,Old Eastbournians,3,1,3.0,4
23786005,Old Oundelians,Old Kingstonians,2,3,4.0,5
23925613,Old Westminsters II,Lancing Old Boys II,4,3,4.0,7
23968303,Old Ardinians,Icarus,0,2,2.0,2
23968305,Old Foresters,Old Meadonians,2,3,4.0,5
23837648,Old Etonians II,Old Minchendenians II,3,1,3.0,4
23837649,Old Merchant Taylors,Old Woodhouseians II,1,3,3.0,4
23904799,Old Cholmeleians,Old Wykehamists,3,3,5.0,6
24067055,Old Tonbridgians,Old Brentwoods,1,2,4.0,3
24002446,Old Berkhamstedians,Lancing Old Boys,4,0,1.0,4
23773766,Old Marlburians,Old Johnians,1,2,4.0,3
23785505,Old Salopians,Old Westminsters,0,1,3.0,1
23523098,Old Aldenhamians,Old Radleians,2,4,3.0,6
24002453,Old Cholmeleians II,Old Etonians II,1,7,0.0,8
24002454,Old Chigwellians II,Old Malvernians,2,3,4.0,5
23773844,Old Harrovians II,Old Alleynians II,0,2,2.0,2
23773917,Old Alleynians III,Old Tonbridgians II,5,2,2.0,7
24002456,Kings College Wimbledon II,Old Shirburnians,2,1,4.0,3
23773910,Old Merchant Taylors,Old Albanians,4,8,2.0,12
23773989,Old Haberdashers,Old Wellingtonians,3,3,5.0,6
23773988,Old King's Scholars,Old Amplefordians,5,3,4.0,8
23785743,Old Stoics,Old Berkhamstedians II,2,1,4.0,3
23773987,Old Harrovians III,Old Ardinians II,3,1,3.0,4
23774126,Old Westminsters II,Old Oundelians,4,0,1.0,4
23562218,KCS Old Boys,Old Bradfieldians,5,1,2.0,6
23562213,Old Rugbeians,Old Reptonians,1,2,4.0,3
23562220,Old Eastbournians,Old Chigwellians,0,13,1.0,13
24107081,Old Ardinians,Old Foresters,2,4,3.0,6
23562210,Old Etonians,Old Kimboltonians,3,1,3.0,4
24026280,Fulham Compton Old Boys,Old Alleynians,2,3,4.0,5
24026281,Richmond & Kew SAL,Old Carthusians,0,4,1.0,4
23837655,Old Brentwoods II,Southgate County III,1,4,2.0,5
23837656,Old Parkonians IV,Old Brentwoods III,4,1,2.0,5
23837657,Old Suttonians IV,Old Epsomians,3,0,2.0,3
23774134,Old Wykehamists II,Old Salopians II,0,1,3.0,1
23522924,Old Wykehamists,Old Tonbridgians,2,1,4.0,3
24006547,Old Alleynians,Old Reptonians,3,1,3.0,4
24006549,Old Carthusians,Old Etonians,6,2,2.0,8
23773758,Old Rugbeians,Old Marlburians,2,3,4.0,5
24006597,Old Johnians,Lancing Old Boys,2,0,2.0,2
24008696,Old Kimboltonians,Old Aldenhamians,3,5,4.0,8
23773827,Old Alleynians II,Old Radleians,4,4,6.0,8
24006587,Old Etonians II,Old Sennockians,0,0,4.0,0
23773829,Old Chigwellians II,Old Harrovians II,2,2,5.0,4
23773897,Kings College Wimbledon II,Old Alleynians III,2,5,2.0,7
24044589,Old Epsomians,Old Albanians,2,1,4.0,3
23773908,Old Tonbridgians II,Old Merchant Taylors,3,1,3.0,4
23773980,Old Haberdashers,Old Stoics,3,2,4.0,5
23773978,Old Wellingtonians,Old Harrovians III,2,3,4.0,5
23774108,Old Cheltonians,Old Kingstonians,3,1,3.0,4
23786244,Lancing Old Boys II,Old Oundelians,2,6,2.0,8
23774122,Old Westminsters II,Old Brentwoods IV,3,3,5.0,6
23562209,Old Berkhamstedians,Old Westminsters,2,2,5.0,4
23562215,Old Shirburnians,Old Harrovians,5,1,2.0,6
23568919,Old Malvernians,Old Cholmeleians,1,2,4.0,3
23562211,Old Salopians,Old Amplefordians,2,1,4.0,3
23968313,Old Thorntonians III,Old Carthusians II,2,1,4.0,3
24026275,Old King's Scholars,Old Blues II,2,0,2.0,2
23970904,Old Etonians,Old Bradfieldians,1,1,4.0,2
23987840,Old Tonbridgians,Old Cholmeleians,2,4,3.0,6
23785514,Old Berkhamstedians,Old Foresters,2,2,5.0,4
23773740,Old Chigwellians,Old Marlburians,5,2,2.0,7
24006537,Old Harrovians,Old Salopians,2,1,4.0,3
23773805,Old Radleians,Old Malvernians,2,2,5.0,4
23988411,Old Etonians II,Old Alleynians II,2,3,4.0,5
23773811,Old Harrovians II,Old Cholmeleians II,3,1,3.0,4
23773887,Old Brentwoods II,Old Merchant Taylors,1,0,3.0,1
23773895,Old Shirburnians,Old Tonbridgians II,7,1,0.0,8
23773889,Old Epsomians,Old Alleynians III,2,1,4.0,3
23773888,Old Carthusians II,Kings College Wimbledon II,2,2,5.0,4
23773971,Old Ardinians II,Old Haberdashers,3,6,3.0,9
23786224,Old Brentwoods III,Old Wellingtonians,2,4,3.0,6
23786226,Old Stoics,Old Harrovians III,1,7,0.0,8
23774104,Old Eastbournians,Old Westminsters II,1,2,4.0,3
23774103,Old Salopians II,Old Cheltonians,1,3,3.0,4
24006546,Old Oundelians,Old Brentwoods IV,2,4,3.0,6
23562219,Old Kingstonians,Old Aldenhamians,1,5,2.0,6
23562208,Old Brentwoods,Lancing Old Boys,8,2,0.0,10
23562217,Old Sennockians,Old Wykehamists,2,1,4.0,3
23968288,Glyn Old Boys,KCS Old Boys,4,2,3.0,6
23969942,Reigatians,Old Alleynians,1,5,2.0,6
23968287,UCL Academicals,Old Reptonians,2,7,0.0,9
23968289,Old Carthusians,Rob Roy Rovers,3,0,2.0,3
23968291,Old Rugbeians,Old Pauline,3,2,4.0,5
23970906,Shene Old Grammarians,Old Johnians,2,1,4.0,3
23773713,Old Reptonians,Old Bradfieldians,4,2,3.0,6
23969950,Old Brentwoods,Old Carthusians,2,5,2.0,7
23773712,Old Wykehamists,KCS Old Boys,1,8,0.0,9
23773710,Old Cholmeleians,Old Etonians,0,3,2.0,3
23773736,Old Salopians,Old Berkhamstedians,3,2,4.0,5
23773737,Old Chigwellians,Old Harrovians,4,2,3.0,6
23785609,Old Alleynians II,Old Cholmeleians II,2,2,5.0,4
23909473,Old Malvernians,Old Harrovians II,2,2,5.0,4
23810068,Old Etonians II,Old Kimboltonians,3,2,4.0,5
23773880,Old Alleynians III,Old Brentwoods II,6,2,2.0,8
23773879,Old Carthusians II,Old Tonbridgians II,5,2,2.0,7
23773881,Old Albanians,Old Epsomians,3,3,5.0,6
23773873,Old Merchant Taylors,Old Shirburnians,1,0,3.0,1
23773952,Old Berkhamstedians II,Old Harrovians III,3,3,5.0,6
23773950,Old Stoics,Old Ardinians II,1,5,2.0,6
23992270,Old Amplefordians,Old Wellingtonians,4,2,3.0,6
23774090,Lancing Old Boys II,Old Salopians II,2,3,4.0,5
23562216,Old Tonbridgians,Old Alleynians,0,6,0.0,6
23968307,Rob Roy Rovers,Old Westminsters,4,1,2.0,5
23968309,City of London,Kings College Wimbledon II,6,3,3.0,9
23968310,Old Chigwellians II,Old Parmiterians II,2,3,4.0,5
23968311,Reigatians II,Old Aldenhamians,3,2,4.0,5
23968315,Old Brentwoods IV,Old Parkonians VI,5,4,5.0,9
23968316,Old Haberdashers,Albanian V,4,0,1.0,4
23968318,Earls Colne,Old Foresters,5,3,4.0,8
23774091,Old Wykehamists II,Old Westminsters II,0,4,1.0,4
23841919,Old Bradfieldians,Old Wykehamists,3,1,3.0,4
23773705,KCS Old Boys,Old Brentwoods,3,1,3.0,4
23773733,Old Johnians,Old Berkhamstedians,3,0,2.0,3
23773734,Old Salopians,Old Rugbeians,0,1,3.0,1
23841921,Old Harrovians,Old Marlburians,1,3,3.0,4
23810146,Old Kimboltonians,Old Alleynians II,7,2,0.0,9
23773780,Old Radleians,Old Chigwellians II,8,0,0.0,8
23925599,Old Cholmeleians II,Old Malvernians,3,4,4.0,7
23785596,Old Harrovians II,Old Etonians II,2,2,5.0,4
23773863,Old Alleynians III,Old Albanians,7,2,0.0,9
23773871,Old Brentwoods II,Old Shirburnians,0,3,2.0,3
23773870,Old Epsomians,Old Merchant Taylors,1,2,4.0,3
23773864,Old Tonbridgians II,Kings College Wimbledon II,1,1,4.0,2
23773944,Old Wellingtonians,Old Stoics,1,5,2.0,6
23925604,Old Brentwoods III,Old Harrovians III,2,0,2.0,2
23773942,Old Amplefordians,Old Ardinians II,1,3,3.0,4
23904797,Old Salopians II,Old Brentwoods IV,7,0,0.0,7
23774077,Old Kingstonians,Old Cheltonians,0,0,4.0,0
23774075,Old Oundelians,Old Westminsters II,2,2,5.0,4
23968306,Old Chigwellians,Spaniards,4,0,1.0,4
23837610,Alleyn Old Boys,Old Etonians,4,0,1.0,4
23837577,Old Foresters,Old Owens,1,3,3.0,4
23543987,Old Brentwoods,Old Tonbridgians,5,1,2.0,6
23522940,Old Carthusians,Old Bradfieldians,1,1,4.0,2
23522939,Old Wykehamists,Old Reptonians,0,6,0.0,6
23522941,Old Alleynians,Old Etonians,3,1,3.0,4
23535286,Old Cholmeleians,KCS Old Boys,0,2,2.0,2
23522972,Old Berkhamstedians,Old Harrovians,4,4,6.0,8
23522980,Old Rugbeians,Old Westminsters,1,4,2.0,5
23522971,Lancing Old Boys,Old Chigwellians,0,2,2.0,2
23538728,Old Marlburians,Old Salopians,1,5,2.0,6
23522979,Old Foresters,Old Johnians,5,2,2.0,7
23538686,Old Malvernians,Old Alleynians II,3,1,3.0,4
23523383,Old Etonians II,Old Radleians,1,3,3.0,4
23523382,Old Harrovians II,Old Kimboltonians,1,3,3.0,4
23535287,Old Sennockians,Old Aldenhamians,3,3,5.0,6
23523512,Old Ardinians,Old Alleynians III,6,1,0.0,7
23523514,Old Shirburnians,Old Carthusians II,0,8,0.0,8
23523505,Kings College Wimbledon II,Old Merchant Taylors,0,2,2.0,2
23523513,Old Albanians,Old Brentwoods II,4,2,3.0,6
23523569,Old Ardinians II,Old Wellingtonians,5,9,3.0,14
23523570,Old Haberdashers,Old King's Scholars,1,2,4.0,3
23523542,Old Amplefordians,Old Harrovians III,1,1,4.0,2
23523949,Old Cheltonians,Old Westminsters II,3,5,4.0,8
23523868,Old Brentwoods IV,Lancing Old Boys II,2,3,4.0,5
23968317,Earlsfield United,Old Epsomians,9,2,0.0,11
23523953,Old Salopians II,Old Wykehamists II,4,3,4.0,7
23522932,Old Bradfieldians,Old Brentwoods,1,6,0.0,7
23538723,KCS Old Boys,Old Reptonians,2,0,2.0,2
23522931,Old Cholmeleians,Old Alleynians,0,6,0.0,6
23522934,Old Etonians,Old Wykehamists,1,1,4.0,2
23522933,Old Tonbridgians,Old Carthusians,6,5,5.0,11
23522962,Old Berkhamstedians,Old Marlburians,4,3,4.0,7
23522967,Old Foresters,Old Westminsters,2,0,2.0,2
23522954,Old Salopians,Lancing Old Boys,3,2,4.0,5
23522955,Old Chigwellians,Old Johnians,2,0,2.0,2
23522963,Old Harrovians,Old Rugbeians,4,5,5.0,9
23523361,Old Kimboltonians,Old Malvernians,2,2,5.0,4
23523114,Old Aldenhamians,Old Harrovians II,1,0,3.0,1
23523106,Old Chigwellians II,Old Alleynians II,0,6,0.0,6
23523110,Old Sennockians,Old Cholmeleians II,1,2,4.0,3
23902771,Old Ardinians,Old Tonbridgians II,8,1,0.0,9
23543993,Old Shirburnians,Old Alleynians III,1,3,3.0,4
23523475,Old Carthusians II,Old Albanians,2,4,3.0,6
23523538,Old Haberdashers,Old Amplefordians,2,2,5.0,4
23523540,Old King's Scholars,Old Berkhamstedians II,5,3,4.0,8
23523541,Old Harrovians III,Old Stoics,1,5,2.0,6
23523853,Old Kingstonians,Old Oundelians,4,1,2.0,5
23523850,Lancing Old Boys II,Old Eastbournians,1,1,4.0,2
23523861,Old Westminsters II,Old Salopians II,4,3,4.0,7
23523862,Old Brentwoods IV,Old Wykehamists II,4,2,3.0,6
23522872,Old Carthusians,Old Brentwoods,1,1,4.0,2
23522871,Old Tonbridgians,KCS Old Boys,0,3,2.0,3
23522948,Old Chigwellians,Old Berkhamstedians,5,0,0.0,5
23523011,Old Kimboltonians,Old Radleians,1,2,4.0,3
23523007,Old Aldenhamians,Old Malvernians,0,1,3.0,1
23523006,Old Sennockians,Old Chigwellians II,0,1,3.0,1
23523403,Old Ardinians,Old Shirburnians,1,0,3.0,1
23523414,Old Merchant Taylors,Old Tonbridgians II,3,2,4.0,5
23523530,Old Berkhamstedians II,Old Brentwoods III,1,1,4.0,2
23523531,Old Stoics,Old Haberdashers,0,2,2.0,2
23523534,Old Harrovians III,Old King's Scholars,2,3,4.0,5
23523745,Old Eastbournians,Old Kingstonians,2,4,3.0,6
23523749,Old Salopians II,Old Oundelians,4,0,1.0,4
26111257,Old Carthusians,Old Reptonians,0,0,4.0,0
26202289,Old Haberdashers,Old Brentwoods II,2,6,2.0,8
26329400,Old Brentwoods Vets,KCS Old Boys Vets,1,0,3.0,1
26091155,Old Cholmeleians,Old Alleynians,1,0,3.0,1
26110630,Old Carthusians,KCS Old Boys,5,2,2.0,7
26237552,Old Chigwellians,Old Brentwoods,0,3,2.0,3
26091159,Old Radleians,Old Johnians,0,8,0.0,8
26244280,Old Cholmeleians II,Old Ardinians,1,1,4.0,2
26237554,Old Aldenhamians,Old Alleynians II,1,5,2.0,6
26237556,Old Haberdashers,KCS Old Boys II,5,2,2.0,7
26108851,Old Brentwoods II,Old Alleynians III,3,1,3.0,4
26170413,Old Merchant Taylors,Old Carthusians II,2,1,4.0,3
26170419,Old Brentwoods III,Old Berkhamstedians II,1,3,3.0,4
26199272,Old Tonbridgians II,Old King's Scholars,5,3,4.0,8
26265230,Old Chigwellians,Old Foresters,4,3,4.0,7
26234198,Old Brentwoods Vets,Old Salopians Vets,2,0,2.0,2
26110620,Old Bradfieldians,Old Chigwellians,5,1,2.0,6
26110625,KCS Old Boys,Old Etonians,2,0,2.0,2
26205894,Old Brentwoods,Old Foresters,0,0,4.0,0
26180231,Old Alleynians II,Lancing Old Boys,10,2,0.0,12
26199222,Old Chigwellians II,Old Cholmeleians II,2,7,0.0,9
26237555,KCS Old Boys II,Old Shirburnians,3,3,5.0,6
26170421,Old Brentwoods II,Old Epsomians,6,0,0.0,6
26307484,Old Reptonians,Old Tonbridgians,1,0,3.0,1
26307177,Old Kimboltonians,Old Aldenhamians,3,3,5.0,6
26307064,Old Harrovians III,Old Berkhamstedians II,0,1,3.0,1
26091156,Old Brentwoods,Old Chigwellians,1,2,4.0,3
26277505,Old Carthusians Vets,Old Foresters Vets,0,3,2.0,3
26110635,Old Reptonians,Old Chigwellians,5,3,4.0,8
26110633,Old Cholmeleians,KCS Old Boys,2,1,4.0,3
26205884,Old Foresters,Old Alleynians,2,1,4.0,3
26199140,Old Rugbeians,Old Malvernians,8,0,0.0,8
26170428,Old Ardinians,Old Berkhamstedians,6,5,5.0,11
26170440,KCS Old Boys II,Old Brentwoods II,0,6,0.0,6
26111265,Old Alleynians III,Old Merchant Taylors,3,6,3.0,9
26170445,Old Brentwoods III,Old Tonbridgians II,4,3,4.0,7
26170406,Old Brentwoods,Old Bradfieldians,4,0,1.0,4
26110621,Old Foresters,Old Reptonians,2,1,4.0,3
26170422,KCS Old Boys,Old Chigwellians,3,2,4.0,5
26237553,Old Etonians,Old Alleynians,3,2,4.0,5
26216833,Old Rugbeians,Old Radleians,4,4,6.0,8
26170408,Old Kimboltonians,Lancing Old Boys,5,1,2.0,6
26170401,Old Berkhamstedians,Old Chigwellians II,7,0,0.0,7
26112020,Old Etonians II,Old Ardinians,0,3,2.0,3
26170414,Old Alleynians III,Old Epsomians,0,2,2.0,2
26202285,Old Brentwoods II,Old Haberdashers,3,2,4.0,5
26110758,Old Carthusians II,Old Sennockians,2,1,4.0,3
26200800,Old Tonbridgians,Old Carthusians,3,2,4.0,5
26284074,Old Tonbridgians II,Old Aldenhamians,1,4,2.0,5
26302872,Old Brentwoods III,Old Harrovians III,2,3,4.0,5
26256569,Old Brentwoods IV,Old Berkhamstedians II,2,3,4.0,5
26110636,Old Foresters,Old Brentwoods,0,1,3.0,1
26170423,Old Bradfieldians,Old Foresters,7,3,2.0,10
26110631,Old Etonians,Old Chigwellians,5,2,2.0,7
26064419,Old Malvernians,Old Rugbeians,1,4,2.0,5
26110724,Old Wykehamists,Old Johnians,3,3,5.0,6
26110755,Lancing Old Boys,Old Cholmeleians II,0,5,0.0,5
26110728,Old Etonians II,Old Albanians,5,4,5.0,9
26170403,Old Alleynians III,Old Sennockians,2,0,2.0,2
26152695,Old Haberdashers,Old Merchant Taylors,2,3,4.0,5
26254919,Old Brentwoods II,Old Shirburnians,2,0,2.0,2
26237558,Old Tonbridgians II,Old Brentwoods III,4,1,2.0,5
26205178,Old Westminsters II,Old Kingstonians,2,1,4.0,3
26170415,Old Stoics,Old Cheltonians,1,2,4.0,3
26200799,Old Reptonians,Old Alleynians,3,2,4.0,5
26170122,Old Alleynians II,Old Aldenhamians,2,2,5.0,4
26253786,Old Ardinians,Old Kimboltonians,4,4,6.0,8
26224538,KCS Old Boys Vets,Old Etonians Vets,3,1,3.0,4
26274693,Old Harrovians Vets,Old Wykehamists Vets,2,3,4.0,5
26268021,KCS Old Boys,Old Cholmeleians,1,2,4.0,3
26110634,Old Etonians,Old Carthusians,2,1,4.0,3
26110723,Old Tonbridgians,Old Radleians,3,2,4.0,5
26110722,Old Westminsters,Old Rugbeians,1,4,2.0,5
26110753,Old Aldenhamians,Old Albanians,5,2,2.0,7
26170410,Old Cholmeleians II,Old Berkhamstedians,0,2,2.0,2
26170417,Old Etonians II,Old Chigwellians II,2,2,5.0,4
26110764,Old Haberdashers,Old Epsomians,0,1,3.0,1
25918113,Old Brentwoods II,Old Carthusians II,4,3,4.0,7
26110771,Old Kingstonians,Old Brentwoods III,4,3,4.0,7
26110772,Old Salopians II,Old Oundelians,7,2,0.0,9
26195986,Old Foresters,Old Meadonians,2,3,4.0,5
26253906,Old Alleynians II,Old Woodhouseians II,0,1,3.0,1
26140677,Old Alleynians III,Old Parmiterians IV,0,0,4.0,0
26117294,Old Merchant Taylors II,Old Parmiterians VIII,2,3,4.0,5
26110624,Old Reptonians,Old Cholmeleians,14,0,1.0,14
26170398,Old Brentwoods,Old Etonians,1,1,4.0,2
26241650,Old Carthusians,Old Foresters,7,1,0.0,8
26110721,Old Wykehamists,Old Radleians,3,3,5.0,6
26241059,Old Malvernians,Old Tonbridgians,1,5,2.0,6
26110747,Old Etonians II,Old Aldenhamians,2,1,4.0,3
26216821,Old Shirburnians,Old Haberdashers,1,2,4.0,3
25562130,Old Sennockians,KCS Old Boys II,0,1,3.0,1
26239167,Old Brentwoods II,Old Ardinians,1,2,4.0,3
26170287,Old Tonbridgians II,Old Cholmeleians II,2,0,2.0,2
26140308,Old Chigwellians II,Old Kimboltonians,2,3,4.0,5
26170123,Old Canfordians,Old Harrovians III,1,2,4.0,3
26241051,Old Tenisonians II,Old Alleynians II,1,2,4.0,3
26110619,KCS Old Boys,Old Alleynians,3,7,2.0,10
26205896,Old Carthusians,Old Cholmeleians,7,1,0.0,8
26110718,Old Johnians,Old Tonbridgians,3,2,4.0,5
26170400,Old Salopians,Old Wykehamists,4,1,2.0,5
26180159,Old Berkhamstedians,Old Kimboltonians,3,3,5.0,6
26110757,Old Epsomians,Old Merchant Taylors,0,8,0.0,8
26091165,Old Haberdashers,Old Carthusians II,4,3,4.0,7
26110769,Old Wellingtonians,Old Westminsters II,3,5,4.0,8
26111241,Old Stoics,Old Brentwoods IV,0,3,2.0,3
26140430,KCS Old Boys II,Old Brentwoods II,1,2,4.0,3
26068088,Old Cheltonians,Old Canfordians,0,3,2.0,3
25876642,KCS Old Boys Vets,Old Malvernians Vets,2,1,4.0,3
25863321,Old Chigwellians Vets,Old Salopians Vets,1,2,4.0,3
25863689,Old Cholmeleians Vets,Old Etonians Vets,1,2,4.0,3
25935452,Old Foresters Vets,Old Bradfieldians Vets,2,0,2.0,2
25935453,Old Harrovians Vets,Old Reptonians Vets,4,4,6.0,8
26170346,Old Bradfieldians,KCS Old Boys,1,6,0.0,7
26170420,Old Foresters,Old Etonians,3,5,4.0,8
26091161,Old Wykehamists,Old Westminsters,1,0,3.0,1
26091163,Old Etonians II,Lancing Old Boys,2,0,2.0,2
26170409,Old Chigwellians II,Old Alleynians II,4,6,4.0,10
26111261,Old Epsomians,Old Shirburnians,1,2,4.0,3
26111260,Old Sennockians,Old Merchant Taylors,1,1,4.0,2
26091169,Old Berkhamstedians II,Old Amplefordians,1,1,4.0,2
26091167,Old Harrovians III,Old King's Scholars,1,5,2.0,6
26091166,Old Westminsters II,Old Tonbridgians II,2,4,3.0,6
26091170,Old Johnians II,Old Oundelians,4,0,1.0,4
26091171,Old Salopians II,Old Stoics,5,2,2.0,7
26110622,Old Alleynians,Old Brentwoods,5,1,2.0,6
26091137,Old Chigwellians,Old Cholmeleians,1,1,4.0,2
26091144,Old Rugbeians,Old Tonbridgians,0,2,2.0,2
26068072,Old Marlburians,Old Harrovians,2,3,4.0,5
26068071,Old Westminsters,Old Malvernians,3,3,5.0,6
26110752,Old Kimboltonians,Old Chigwellians II,8,1,0.0,9
26110741,Lancing Old Boys,Old Albanians,5,0,0.0,5
26068074,Old Ardinians,Old Etonians II,3,2,4.0,5
26068079,Old Cholmeleians II,Old Aldenhamians,1,1,4.0,2
26110760,Old Shirburnians,KCS Old Boys II,4,4,6.0,8
26111266,Old Alleynians III,Old Harrovians II,2,1,4.0,3
26068087,Old Harrovians III,Old Kingstonians,2,1,4.0,3
26068090,Old Stoics,Old Johnians II,1,2,4.0,3
25928093,Old Reptonians,KCS Old Boys,4,0,1.0,4
26116200,Old Carthusians,Old Johnians,4,0,1.0,4
25923789,Old Berkhamstedians II,Old Amplefordians,5,1,2.0,6
26093052,Old Merchant Taylors II,Old Westminsters II,2,1,4.0,3
26106998,Bealonians,Old Foresters,0,1,3.0,1
26140724,Old Alleynians II,St. James' Old Boys,4,1,2.0,5
26116528,Old Woodhouseians II,Old Brentwoods II,6,4,4.0,10
26075882,Old Foresters,Old Cholmeleians,4,1,2.0,5
26068060,Old Johnians,Old Rugbeians,3,1,3.0,4
26068059,Old Harrovians,Old Salopians,0,4,1.0,4
26068058,Old Westminsters,Old Marlburians,2,2,5.0,4
26091129,Old Berkhamstedians,Old Etonians II,3,3,5.0,6
26068056,Old Ardinians,Old Kimboltonians,1,2,4.0,3
26068057,Old Chigwellians II,Old Aldenhamians,2,4,3.0,6
26068055,Old Merchant Taylors,Old Harrovians II,3,5,4.0,8
25928091,Old Bradfieldians,Old Alleynians,2,3,4.0,5
25928092,Old Chigwellians,Old Tonbridgians,2,4,3.0,6
26067125,Old Cholmeleians II,Old Alleynians III,3,2,4.0,5
26093088,Old Alleynians II,Old Epsomians,5,2,2.0,7
26098199,Old Salopians II,Old Brentwoods IV,1,4,2.0,5
25923808,Old Canfordians,Old Kingstonians,4,2,3.0,6
25923788,Old King's Scholars,Old Tonbridgians II,5,4,5.0,9
26092731,Old Etonians,Old Meadonians,2,3,4.0,5
26286571,Old Westminster Citizens Vets,Old Brentwoods Vets,4,3,4.0,7
26073409,Old Reptonians,Old Alleynians,1,0,3.0,1
26064413,KCS Old Boys,Old Foresters,2,4,3.0,6
26075884,Old Brentwoods,Old Carthusians,0,1,3.0,1
26064414,Old Etonians,Old Cholmeleians,4,3,4.0,7
26064418,Old Johnians,Old Marlburians,6,2,2.0,8
26064420,Old Salopians,Old Westminsters,6,2,2.0,8
26064421,Old Tonbridgians,Old Wykehamists,2,0,2.0,2
26102054,Lancing Old Boys,Old Etonians II,2,4,3.0,6
26068005,Old Albanians,Old Cholmeleians II,3,5,4.0,8
26068011,Old Haberdashers,Old Shirburnians,2,3,4.0,5
26068022,Old Harrovians II,Old Brentwoods II,4,4,6.0,8
26068031,Old King's Scholars,Old Berkhamstedians II,1,3,3.0,4
26066737,Old Berkhamstedians,Old Tonbridgians II,2,3,4.0,5
26067007,Old Kimboltonians,Old Merchant Taylors,5,0,0.0,5
26092936,Old Kingstonians,Old Ardinians,0,4,1.0,4
26066392,Lancing Old Boys II,KCS Old Boys II,2,4,3.0,6
26066418,Old Aldenhamians,Old Sennockians,4,2,3.0,6
26073901,Old Chigwellians II,Old Brentwoods III,6,0,0.0,6
25923787,Old Wellingtonians,Old Johnians II,2,1,4.0,3
25923786,Old Harrovians III,Old Cheltonians,3,2,4.0,5
26057389,Old Alleynians III,Old Wilsonians IV,2,1,4.0,3
25918128,KCS Old Boys,Old Brentwoods,1,1,4.0,2
26064417,Old Alleynians,Old Chigwellians,3,2,4.0,5
25918130,Old Cholmeleians,Old Bradfieldians,1,3,3.0,4
25918129,Old Etonians,Old Reptonians,1,5,2.0,6
25918135,Old Malvernians,Old Salopians,2,4,3.0,6
25918134,Old Marlburians,Old Rugbeians,3,0,2.0,3
25918132,Old Harrovians,Old Wykehamists,1,2,4.0,3
25918133,Old Westminsters,Old Johnians,3,0,2.0,3
25918137,Old Berkhamstedians,Old Alleynians II,1,4,2.0,5
25918138,Old Ardinians,Old Albanians,4,1,2.0,5
25918141,Old Aldenhamians,Old Kimboltonians,3,4,4.0,7
25918140,Old Cholmeleians II,Lancing Old Boys,7,2,0.0,9
25918145,Old Alleynians III,Old Shirburnians,5,2,2.0,7
26067998,Old Haberdashers,Old Harrovians II,1,3,3.0,4
25918146,Old Carthusians II,KCS Old Boys II,6,2,2.0,8
25918148,Old Kingstonians,Old Amplefordians,3,3,5.0,6
25918149,Old Wellingtonians,Old Berkhamstedians II,2,6,2.0,8
25918150,Old Brentwoods III,Old Harrovians III,7,2,0.0,9
25918266,Old Oundelians,Old Brentwoods IV,0,4,1.0,4
25918265,Old Stoics,Old Canfordians,4,1,2.0,5
25748989,Old Merchant Taylors,Old Carthusians,1,2,4.0,3
26057394,Old Parkonians IV,Old Merchant Taylors II,1,7,0.0,8
25935450,Old Wellingtonians Vets,Old Aldenhamians Vets,5,4,5.0,9
26286574,Old Wilsonians Vets,Old Chigwellians Vets,4,0,1.0,4
25918107,Old Wykehamists,Old Rugbeians,3,1,3.0,4
26064568,Old Malvernians,Old Westminsters,2,5,2.0,7
25918108,Old Radleians,Old Harrovians,2,0,2.0,2
25918106,Old Tonbridgians,Old Salopians,4,2,3.0,6
25918112,Old Kimboltonians,Old Cholmeleians II,2,4,3.0,6
25918111,Old Albanians,Old Aldenhamians,2,1,4.0,3
25918114,KCS Old Boys II,Old Merchant Taylors,0,1,3.0,1
25918115,Old Epsomians,Old Sennockians,1,1,4.0,2
25918117,Old Carthusians II,Old Harrovians II,1,0,3.0,1
25918120,Old Berkhamstedians II,Old Brentwoods III,5,2,2.0,7
25918121,Old King's Scholars,Old Kingstonians,4,4,6.0,8
25918119,Old Harrovians III,Old Tonbridgians II,2,2,5.0,4
25485553,Old Alleynians II,Lancing Old Boys,7,0,0.0,7
25485551,Old Ardinians,Old Etonians II,3,1,3.0,4
25923783,Old Oundelians,Old Stoics,4,3,4.0,7
25923784,Old Merchant Taylors II,Lancing Old Boys II,7,0,0.0,7
26076144,Old Johnians,Old Johnians II,4,4,6.0,8
25836866,Old Foresters Vets,Old Etonians Vets,3,4,4.0,7
25918095,Old Bradfieldians,Old Reptonians,3,4,4.0,7
25918097,Old Radleians,Old Tonbridgians,4,4,6.0,8
25918096,Old Salopians,Old Marlburians,1,0,3.0,1
25918098,Old Harrovians,Old Johnians,0,4,1.0,4
25918099,Old Etonians II,Old Alleynians II,1,4,2.0,5
25918100,Old Amplefordians,Old Wellingtonians,6,2,2.0,8
25485544,Old Kimboltonians,Old Haberdashers,2,1,4.0,3
25485545,Old Kingstonians,Old Carthusians II,2,0,2.0,2
25485550,Old Brentwoods III,Old Harrovians II,4,2,3.0,6
25884189,Old Brentwoods IV,Old Epsomians,1,1,4.0,2
25485548,Old Shirburnians,Old Cholmeleians II,0,3,2.0,3
25485543,Old Aldenhamians,Old Albanians,4,1,2.0,5
25876416,Old Canfordians,Old Berkhamstedians,2,5,2.0,7
25485547,Old King's Scholars,Old Brentwoods II,1,2,4.0,3
25485542,Old Merchant Taylors,Old Oundelians,6,3,3.0,9
25485535,Old Stoics,Lancing Old Boys II,1,2,4.0,3
25485546,Old Tonbridgians II,Old Cheltonians,2,0,2.0,2
25485541,Old Chigwellians II,Old Berkhamstedians II,1,0,3.0,1
25485549,Old Sennockians,Old Harrovians III,5,0,0.0,5
25485552,Old Westminsters II,Old Alleynians III,3,3,5.0,6
25877347,KCS Old Boys,Old Foresters,2,3,4.0,5
25918074,Old Bradfieldians,Old Etonians,7,3,2.0,10
25918080,Old Brentwoods,Old Reptonians,1,1,4.0,2
25999405,Old Carthusians,Old Chigwellians,5,1,2.0,6
25918083,Old Rugbeians,Old Marlburians,1,7,0.0,8
25918082,Old Tonbridgians,Old Harrovians,2,3,4.0,5
25918087,Lancing Old Boys,Old Chigwellians II,7,0,0.0,7
25918084,Old Aldenhamians,Old Etonians II,2,3,4.0,5
25918088,Old Brentwoods II,Old Merchant Taylors,2,1,4.0,3
25918090,Old Shirburnians,Old Carthusians II,5,0,0.0,5
25918089,Old Sennockians,Old Haberdashers,3,2,4.0,5
25918091,Old Amplefordians,Old Harrovians III,0,3,2.0,3
25918092,Old Kingstonians,Old Wellingtonians,2,3,4.0,5
25918093,Old Brentwoods IV,Old Canfordians,7,3,2.0,10
25918094,Old Salopians II,Old Cheltonians,2,1,4.0,3
25846816,Old Rugbeians,Old Salopians,3,2,4.0,5
25846823,Old Malvernians,Old Radleians,3,3,5.0,6
25846821,Old Westminsters,Old Harrovians,1,2,4.0,3
25846826,Old Alleynians II,Old Etonians II,1,1,4.0,2
25846825,Old Albanians,Old Berkhamstedians,2,2,5.0,4
25846831,KCS Old Boys II,Old Harrovians II,2,0,2.0,2
25846833,Old Carthusians II,Old Alleynians III,0,5,0.0,5
25846834,Old Sennockians,Old Brentwoods II,0,2,2.0,2
25846843,Old Amplefordians,Old Westminsters II,3,4,4.0,7
25846841,Old Tonbridgians II,Old Kingstonians,2,1,4.0,3
25777002,Old Johnians,Old Aldenhamians,1,0,3.0,1
25749129,Old Reptonians,Old Brentwoods,3,1,3.0,4
25783946,KCS Old Boys,Old Kimboltonians,8,2,0.0,10
25749185,Old Chigwellians,Old Wykehamists,4,2,3.0,6
25810773,Old Ardinians,Old Tonbridgians,2,3,4.0,5
25749211,Old Etonians,Old Alleynians,0,1,3.0,1
25749336,Old Foresters,Old Bradfieldians,4,5,5.0,9
25846352,Old Alleynians,Old Bradfieldians,5,2,2.0,7
25846365,Old Rugbeians,Old Wykehamists,3,2,4.0,5
25846356,Old Johnians,Old Malvernians,10,4,1.0,14
25846360,Old Radleians,Old Marlburians,4,4,6.0,8
25846361,Old Salopians,Old Harrovians,7,1,0.0,8
25846363,Old Tonbridgians,Old Westminsters,4,3,4.0,7
25846752,Old Ardinians,Lancing Old Boys,8,0,0.0,8
25846381,Old Chigwellians II,Old Etonians II,2,2,5.0,4
25846407,Old Harrovians II,Old Haberdashers,0,2,2.0,2
25846417,Old Berkhamstedians II,Old Harrovians III,6,0,0.0,6
25846415,Old Amplefordians,Old Tonbridgians II,2,3,4.0,5
25846413,Old Wellingtonians,Old King's Scholars,3,4,4.0,7
25788414,Old Merchant Taylors,Southgate County II,2,5,2.0,7
25851401,Old Alleynians III,Old Minchendenians IV,3,0,2.0,3
25581800,Old Bradfieldians,Old Carthusians,5,1,2.0,6
25661191,Old Chigwellians,Old Etonians,2,2,5.0,4
25581794,Old Cholmeleians,Old Brentwoods,2,0,2.0,2
25581806,Old Marlburians,Old Westminsters,2,1,4.0,3
25581808,Old Salopians,Old Tonbridgians,1,4,2.0,5
25581803,Old Harrovians,Old Radleians,3,0,2.0,3
25581812,Old Alleynians II,Old Berkhamstedians,1,1,4.0,2
25581815,Old Chigwellians II,Old Ardinians,1,3,3.0,4
25661192,Old Albanians,Old Kimboltonians,2,6,2.0,8
25597235,Old Alleynians III,Old Haberdashers,1,2,4.0,3
25581819,Old Epsomians,KCS Old Boys II,2,1,4.0,3
25562168,Old Shirburnians,Old Sennockians,1,5,2.0,6
25581820,Old Carthusians II,Old Brentwoods II,5,1,2.0,6
25581818,Old Harrovians II,Old Merchant Taylors,1,1,4.0,2
25597244,Old Berkhamstedians II,Old Kingstonians,4,0,1.0,4
25846142,Old Brentwoods III,Old Amplefordians,6,1,0.0,7
25597247,Old Wellingtonians,Old Harrovians III,0,1,3.0,1
25597248,Old Westminsters II,Old King's Scholars,6,2,2.0,8
25578207,Old Brentwoods IV,Old Felstedians,4,2,3.0,6
25485534,Old Canfordians,Old Merchant Taylors II,9,1,0.0,10
25581855,Old Johnians II,Old Cheltonians,2,4,3.0,6
25838416,Old Ignatian,Old Foresters,0,2,2.0,2
25876242,Old Wilsonians V,Lancing Old Boys II,1,0,3.0,1
25408686,Old Wykehamists Vets,Old Etonians Vets,0,4,1.0,4
25408688,Old Foresters Vets,Old Cholmeleians Vets,2,2,5.0,4
25408685,Old Salopians Vets,Old Reptonians Vets,6,2,2.0,8
25408689,Old Harrovians Vets,KCS Old Boys Vets,1,8,0.0,9
25782681,Enfield Old Grammarians Vets,Old Brentwoods Vets,0,1,3.0,1
25782682,Globe Rangers Vets 2nd,Old Chigwellians Vets,3,7,2.0,10
25562149,Old Reptonians,Old Brentwoods,4,0,1.0,4
25562148,KCS Old Boys,Old Bradfieldians,2,3,4.0,5
25555659,Old Alleynians,Old Etonians,2,2,5.0,4
25562153,Old Cholmeleians,Old Chigwellians,5,2,2.0,7
25581795,Old Foresters,Old Carthusians,0,2,2.0,2
25562161,Old Rugbeians,Old Westminsters,3,1,3.0,4
25562158,Old Wykehamists,Old Malvernians,2,4,3.0,6
25562160,Old Marlburians,Old Johnians,1,1,4.0,2
25581780,Old Alleynians II,Old Cholmeleians II,4,1,2.0,5
25562162,Old Berkhamstedians,Old Albanians,3,1,3.0,4
25562163,Old Aldenhamians,Lancing Old Boys,4,3,4.0,7
25581781,Old Etonians II,Old Kimboltonians,0,2,2.0,2
25581816,Old Haberdashers,Old Sennockians,4,2,3.0,6
25562167,Old Epsomians,Old Alleynians III,3,1,3.0,4
25597234,Old Shirburnians,Old Brentwoods II,2,1,4.0,3
25597223,Old Harrovians II,Old Carthusians II,4,2,3.0,6
25562171,Old Kingstonians,Old Harrovians III,2,6,2.0,8
25562170,Old King's Scholars,Old Tonbridgians II,2,1,4.0,3
25562169,Old Westminsters II,Old Amplefordians,5,1,2.0,6
25555657,Old Brentwoods IV,Old Cheltonians,0,1,3.0,1
25402512,Old Canfordians,Old Oundelians,2,1,4.0,3
25402514,Old Johnians II,Old Salopians II,4,2,3.0,6
25445156,Old Parmiterians IX,Old Merchant Taylors II,1,3,3.0,4
25408687,Old Malvernians Vets,Old Carthusians Vets,5,2,2.0,7
25562099,Old Carthusians,Old Alleynians,3,6,3.0,9
25562101,Old Malvernians,Old Harrovians,3,3,5.0,6
25562100,Old Johnians,Old Westminsters,4,1,2.0,5
25568711,Old Marlburians,Old Tonbridgians,1,2,4.0,3
25562103,Old Salopians,Old Radleians,2,1,4.0,3
25581779,Old Albanians,Lancing Old Boys,6,1,0.0,7
25568720,Old Alleynians II,Old Kimboltonians,4,2,3.0,6
25568721,Old Berkhamstedians,Old Aldenhamians,10,2,0.0,12
25562123,Old Ardinians,Old Cholmeleians II,4,0,1.0,4
25562131,Old Epsomians,Old Brentwoods II,6,4,4.0,10
25562137,Old Carthusians II,Old Haberdashers,2,4,3.0,6
25562138,Old Merchant Taylors,Old Alleynians III,2,0,2.0,2
25562136,Old Harrovians II,Old Shirburnians,2,3,4.0,5
25562142,Old Tonbridgians II,Old Amplefordians,1,5,2.0,6
25562141,Old Wellingtonians,Old Kingstonians,2,1,4.0,3
25562139,Old Westminsters II,Old Harrovians III,3,2,4.0,5
25555642,Old Cheltonians,Old Salopians II,7,4,3.0,11
25703542,KCS Old Boys,Glyn Old Boys,4,4,6.0,8
25754416,Old Pauline,Old Rugbeians,5,1,2.0,6
25776145,Old Foresters Vets,Old Chigwellians Vets,2,1,4.0,3
25688153,Old Reptonians,Old Carthusians,1,0,3.0,1
25561350,Old Brentwoods,KCS Old Boys,1,2,4.0,3
25555658,Old Alleynians,Old Cholmeleians,5,0,0.0,5
25561351,Old Chigwellians,Old Bradfieldians,2,2,5.0,4
25561363,Old Wykehamists,Old Marlburians,1,1,4.0,2
25561359,Old Radleians,Old Malvernians,5,4,5.0,9
25561360,Old Salopians,Old Johnians,1,6,0.0,7
25639179,Old Harrovians,Old Rugbeians,4,3,4.0,7
25568592,Old Alleynians II,Old Chigwellians II,3,0,2.0,3
25568593,Old Kimboltonians,Old Aldenhamians,8,1,0.0,9
25562121,Lancing Old Boys,Old Berkhamstedians,3,2,4.0,5
25568594,Old Cholmeleians II,Old Albanians,5,0,0.0,5
25581774,KCS Old Boys II,Old Alleynians III,2,4,3.0,6
25568624,Old Shirburnians,Old Merchant Taylors,4,4,6.0,8
25561745,Old Sennockians,Old Harrovians II,1,4,2.0,5
25562090,Old Kingstonians,Old Tonbridgians II,2,3,4.0,5
25562086,Old Amplefordians,Old King's Scholars,3,2,4.0,5
25562085,Old Harrovians III,Old Berkhamstedians II,2,2,5.0,4
25562091,Old Westminsters II,Old Brentwoods III,3,5,4.0,8
25562092,Old Oundelians,Old Stoics,2,4,3.0,6
25562093,Old Brentwoods IV,Old Johnians II,4,3,4.0,7
25754169,Old Tonbridgians,Old Westminsters,3,2,4.0,5
25703543,Old Etonians,Alleyn Old Boys,4,2,3.0,6
25754412,Old Brentwoods II,Bealonians II,4,2,3.0,6
25776146,Old Etonians Vets,Old Finchleians Vets,3,1,3.0,4
25561309,Old Alleynians,Old Reptonians,4,5,5.0,9
25561310,Old Cholmeleians,Old Etonians,2,2,5.0,4
25688152,Old Foresters,Old Bradfieldians,8,0,0.0,8
25561311,Old Johnians,Old Harrovians,2,2,5.0,4
25568551,Old Marlburians,Old Salopians,3,2,4.0,5
25561314,Old Westminsters,Old Wykehamists,4,3,4.0,7
25661184,Old Kimboltonians,Old Albanians,5,3,4.0,8
25561317,Old Aldenhamians,Old Ardinians,2,6,2.0,8
25568559,Old Chigwellians II,Old Berkhamstedians,4,1,2.0,5
25671863,Old Sennockians,Old Shirburnians,4,1,2.0,5
25597224,Old Epsomians,Old Carthusians II,4,3,4.0,7
25597225,Old Harrovians II,KCS Old Boys II,1,2,4.0,3
25561325,Old Berkhamstedians II,Old Wellingtonians,7,3,2.0,10
25561326,Old King's Scholars,Old Westminsters II,2,3,4.0,5
25402400,Old Harrovians III,Old Amplefordians,2,4,3.0,6
25561345,Old Cheltonians,Old Johnians II,2,3,4.0,5
25561344,Old Salopians II,Old Brentwoods IV,1,3,3.0,4
25408253,KCS Old Boys,Old Rugbeians,2,1,4.0,3
25654947,Old Suttonians II,Old Alleynians II,1,2,4.0,3
25788398,Old Tenisonians IV,Old Alleynians III,1,9,0.0,10
25561361,Old Harrovians,Old Marlburians,0,5,0.0,5
25402518,Old Etonians II,Old Cholmeleians II,1,0,3.0,1
25402517,Old Albanians,Old Chigwellians II,8,1,0.0,9
25402519,Old Epsomians,Old Harrovians II,2,4,3.0,6
25402521,Old King's Scholars,Old Brentwoods III,4,2,3.0,6
25402523,Old Westminsters II,Old Berkhamstedians II,4,3,4.0,7
25402524,Old Brentwoods IV,Old Oundelians,5,0,0.0,5
25402526,Old Canfordians,Old Johnians II,2,3,4.0,5
25402525,Old Stoics,Old Salopians II,2,2,5.0,4
25408263,Old Ardinians,Old Salopians,4,2,3.0,6
25408256,Old Malvernians,Old Foresters,0,6,0.0,6
25408254,Lancing Old Boys,Old Brentwoods,1,4,2.0,5
25408258,Old Wykehamists,Old Radleians,3,1,3.0,4
25408252,Old Berkhamstedians,Old Alleynians,2,5,2.0,7
25408264,Old Johnians,Old Sennockians,3,1,3.0,4
25408260,Old Westminsters,Old Tonbridgians,2,2,5.0,4
25408255,Old Etonians,Old Haberdashers,8,0,0.0,8
25408265,Old Merchant Taylors,Old Amplefordians,3,0,2.0,3
25408261,Old Shirburnians,Old Bradfieldians,1,3,3.0,4
25560805,East Barnet Old Grammarians,Old Brentwoods II,1,5,2.0,6
25560855,Alleyn Old Boys III,KCS Old Boys II,3,2,4.0,5
25639149,Clissold Park Rangers,Old Rugbeians,1,2,4.0,3
25405352,Old Reptonians,Old Bradfieldians,1,0,3.0,1
25405332,Old Alleynians,Old Foresters,5,0,0.0,5
25405347,Old Cholmeleians,Old Carthusians,2,2,5.0,4
25402498,Old Wykehamists,Old Salopians,2,3,4.0,5
25560814,Old Tonbridgians,Old Marlburians,6,3,3.0,9
25402502,Old Berkhamstedians,Old Cholmeleians II,3,0,2.0,3
25402504,Lancing Old Boys,Old Aldenhamians,1,2,4.0,3
25402503,Old Chigwellians II,Old Kimboltonians,3,3,5.0,6
25402501,Old Alleynians II,Old Ardinians,2,1,4.0,3
25662615,Old Alleynians III,Old Carthusians II,4,2,3.0,6
25402506,Old Shirburnians,Old Epsomians,1,1,4.0,2
25402505,Old Merchant Taylors,Old Sennockians,2,0,2.0,2
25555611,Old Tonbridgians II,Old Westminsters II,3,2,4.0,5
25402511,Old Amplefordians,Old Berkhamstedians II,2,1,4.0,3
25402508,Old King's Scholars,Old Wellingtonians,3,2,4.0,5
25402510,Old Harrovians III,Old Brentwoods III,2,8,0.0,10
25555633,Old Oundelians,Old Canfordians,3,2,4.0,5
25555621,Old Salopians II,Old Johnians II,0,4,1.0,4
25408259,Old Harrovians,Old Chigwellians,2,3,4.0,5
25445015,Old Parmiterians,Old Etonians,0,5,0.0,5
25405335,Old Bradfieldians,Old Cholmeleians,3,2,4.0,5
25404728,KCS Old Boys,Old Reptonians,1,5,2.0,6
25405340,Old Carthusians,Old Brentwoods,6,3,3.0,9
25404732,Old Etonians,Old Foresters,1,3,3.0,4
25563021,Old Chigwellians,Old Alleynians,2,3,4.0,5
25529682,Old Johnians,Old Wykehamists,3,2,4.0,5
25402477,Old Marlburians,Old Malvernians,3,1,3.0,4
25402475,Old Harrovians,Old Tonbridgians,0,3,2.0,3
25402474,Old Westminsters,Old Radleians,2,2,5.0,4
25402481,Old Berkhamstedians,Old Ardinians,4,4,6.0,8
25402482,Old Kimboltonians,Old Etonians II,1,2,4.0,3
25402479,Lancing Old Boys,Old Alleynians II,1,2,4.0,3
25402480,Old Cholmeleians II,Old Chigwellians II,2,0,2.0,2
25560797,Old Alleynians III,Old Brentwoods II,4,3,4.0,7
25402486,Old Carthusians II,Old Shirburnians,4,2,3.0,6
25402483,Old Merchant Taylors,KCS Old Boys II,2,1,4.0,3
25402484,Old Sennockians,Old Epsomians,5,0,0.0,5
25402490,Old Amplefordians,Old Kingstonians,2,1,4.0,3
25402489,Old Tonbridgians II,Old Berkhamstedians II,1,3,3.0,4
25402488,Old Wellingtonians,Old Brentwoods III,1,4,2.0,5
25402491,Old Harrovians III,Old Westminsters II,1,2,4.0,3
25402493,Old Oundelians,Old Cheltonians,1,5,2.0,6
25402492,Old Brentwoods IV,Old Stoics,1,1,4.0,2
25405331,Old Alleynians,Old Carthusians,5,0,0.0,5
25560778,Old Etonians,Old Bradfieldians,1,3,3.0,4
25405343,Old Chigwellians,Old Reptonians,2,2,5.0,4
25405349,Old Foresters,KCS Old Boys,1,1,4.0,2
25402454,Old Wykehamists,Old Harrovians,4,1,2.0,5
25402452,Old Malvernians,Old Johnians,2,3,4.0,5
25402451,Old Radleians,Old Rugbeians,1,0,3.0,1
25402453,Old Westminsters,Old Tonbridgians,1,5,2.0,6
25402457,Old Kimboltonians,Old Berkhamstedians,3,2,4.0,5
25402455,Old Ardinians,Old Aldenhamians,4,2,3.0,6
25402458,Old Cholmeleians II,Old Alleynians II,4,1,2.0,5
25402460,KCS Old Boys II,Old Epsomians,0,3,2.0,3
25547921,Old Harrovians II,Old Alleynians III,1,1,4.0,2
25402465,Old Berkhamstedians II,Old King's Scholars,2,0,2.0,2
25402464,Old Kingstonians,Old Westminsters II,2,6,2.0,8
25402462,Old Tonbridgians II,Old Harrovians III,0,2,2.0,2
25402463,Old Wellingtonians,Old Amplefordians,4,1,2.0,5
25402466,Old Cheltonians,Old Brentwoods IV,2,6,2.0,8
25402467,Old Salopians II,Old Canfordians,6,0,0.0,6
25402468,Old Johnians II,Old Stoics,2,2,5.0,4
25405365,Old Brentwoods,Bealonians,0,3,2.0,3
25445150,Old Ignatian II,Old Merchant Taylors,1,2,4.0,3
25491855,Old Suttonians II,Old Etonians II,2,0,2.0,2
25405334,Old Bradfieldians,Old Brentwoods,4,0,1.0,4
25405346,Old Cholmeleians,Old Reptonians,1,6,0.0,7
25404730,Old Etonians,KCS Old Boys,4,3,4.0,7
25547918,Old Johnians,Old Radleians,4,1,2.0,5
25402432,Old Marlburians,Old Wykehamists,4,1,2.0,5
25402431,Old Salopians,Old Malvernians,2,0,2.0,2
25402430,Old Harrovians,Old Westminsters,2,0,2.0,2
25402436,Old Ardinians,Old Alleynians II,1,2,4.0,3
25402433,Old Aldenhamians,Old Chigwellians II,1,3,3.0,4
25402434,Old Cholmeleians II,Old Kimboltonians,1,1,4.0,2
25402435,Old Albanians,Old Etonians II,2,3,4.0,5
25402438,Old Alleynians III,KCS Old Boys II,2,2,5.0,4
25402440,Old Merchant Taylors,Old Brentwoods II,3,1,3.0,4
25402439,Old Harrovians II,Old Sennockians,1,0,3.0,1
25402441,Old Brentwoods III,Old Kingstonians,2,1,4.0,3
25402443,Old King's Scholars,Old Harrovians III,2,0,2.0,2
25402442,Old Westminsters II,Old Wellingtonians,3,2,4.0,5
25402444,Old Brentwoods IV,Old Salopians II,6,1,0.0,7
25402445,Old Johnians II,Old Canfordians,1,0,3.0,1
25402446,Old Stoics,Old Oundelians,1,1,4.0,2
25445013,Old Foresters,Old Parkonians,4,1,2.0,5
25483305,Shene Old Grammarians,Old Rugbeians,4,4,6.0,8
25405339,Old Carthusians,Old Bradfieldians,3,1,3.0,4
25405351,Old Reptonians,Old Etonians,7,2,0.0,9
25405337,Old Brentwoods,Old Cholmeleians,1,2,4.0,3
25405330,Old Alleynians,KCS Old Boys,5,1,2.0,6
25402410,Old Rugbeians,Old Harrovians,4,3,4.0,7
25402411,Old Malvernians,Old Marlburians,3,1,3.0,4
25402409,Old Radleians,Old Wykehamists,2,2,5.0,4
25402412,Old Westminsters,Old Salopians,4,2,3.0,6
25402413,Old Kimboltonians,Old Alleynians II,0,3,2.0,3
25402414,Lancing Old Boys,Old Ardinians,2,2,5.0,4
25402416,Old Haberdashers,Old Alleynians III,1,3,3.0,4
25402415,KCS Old Boys II,Old Carthusians II,2,3,4.0,5
25402419,Old Brentwoods II,Old Sennockians,5,3,4.0,8
25402418,Old Merchant Taylors,Old Shirburnians,7,1,0.0,8
25402417,Old Harrovians II,Old Epsomians,2,6,2.0,8
25402423,Old Berkhamstedians II,Old Westminsters II,3,2,4.0,5
25402421,Old Kingstonians,Old King's Scholars,2,1,4.0,3
25402420,Old Amplefordians,Old Brentwoods III,3,10,1.0,13
25402422,Old Harrovians III,Old Wellingtonians,6,3,3.0,9
25402424,Old Canfordians,Old Cheltonians,2,2,5.0,4
25402425,Old Johnians II,Old Brentwoods IV,4,4,6.0,8
25405333,Old Bradfieldians,Old Alleynians,3,2,4.0,5
25404727,KCS Old Boys,Old Carthusians,4,3,4.0,7
25404729,Old Etonians,Old Brentwoods,1,4,2.0,5
25405348,Old Foresters,Old Chigwellians,4,4,6.0,8
25402388,Old Marlburians,Old Radleians,1,2,4.0,3
25402385,Old Salopians,Old Rugbeians,1,1,4.0,2
25402387,Old Tonbridgians,Old Johnians,0,1,3.0,1
25402386,Old Harrovians,Old Malvernians,4,2,3.0,6
25402392,Old Alleynians II,Old Aldenhamians,5,1,2.0,6
25402389,Old Berkhamstedians,Lancing Old Boys,5,6,5.0,11
25402393,Old Kimboltonians,Old Ardinians,1,2,4.0,3
25402391,Old Cholmeleians II,Old Etonians II,1,0,3.0,1
25402390,Old Chigwellians II,Old Albanians,4,5,5.0,9
25402396,Old Brentwoods II,KCS Old Boys II,2,4,3.0,6
25402394,Old Epsomians,Old Haberdashers,4,8,2.0,12
25402397,Old Shirburnians,Old Harrovians II,2,6,2.0,8
25402398,Old Carthusians II,Old Merchant Taylors,1,2,4.0,3
25402395,Old Sennockians,Old Alleynians III,3,2,4.0,5
25402401,Old Kingstonians,Old Berkhamstedians II,0,6,0.0,6
25402399,Old Brentwoods III,Old Westminsters II,5,0,0.0,5
25402402,Old Wellingtonians,Old Tonbridgians II,3,2,4.0,5
25402403,Old Oundelians,Old Johnians II,1,3,3.0,4
25402404,Old Canfordians,Old Salopians II,3,0,2.0,3
25405350,Old Reptonians,KCS Old Boys,3,0,2.0,3
25405345,Old Cholmeleians,Old Foresters,0,2,2.0,2
25405342,Old Chigwellians,Old Carthusians,5,2,2.0,7
25402364,Old Johnians,Old Salopians,4,1,2.0,5
25402367,Old Malvernians,Old Wykehamists,2,2,5.0,4
25402365,Old Radleians,Old Westminsters,5,0,0.0,5
25402366,Old Tonbridgians,Old Rugbeians,6,2,2.0,8
25402370,Old Ardinians,Old Chigwellians II,7,2,0.0,9
25402372,Lancing Old Boys,Old Kimboltonians,0,5,0.0,5
25402369,Old Aldenhamians,Old Cholmeleians II,5,3,4.0,8
25402371,Old Etonians II,Old Berkhamstedians,2,1,4.0,3
25402368,Old Albanians,Old Alleynians II,1,3,3.0,4
25402373,KCS Old Boys II,Old Sennockians,1,3,3.0,4
25402375,Old Carthusians II,Old Epsomians,4,1,2.0,5
25402374,Old Merchant Taylors,Old Haberdashers,0,0,4.0,0
25402377,Old Berkhamstedians II,Old Tonbridgians II,1,1,4.0,2
25402376,Old King's Scholars,Old Amplefordians,3,1,3.0,4
25402378,Old Oundelians,Old Salopians II,2,6,2.0,8
25402380,Old Canfordians,Old Stoics,1,3,3.0,4
25402379,Old Johnians II,Old Cheltonians,0,2,2.0,2
25405336,Old Brentwoods,Old Alleynians,0,7,0.0,7
25405338,Old Carthusians,Old Etonians,2,1,4.0,3
25405341,Old Chigwellians,KCS Old Boys,2,2,5.0,4
25402348,Old Rugbeians,Old Johnians,1,3,3.0,4
25402349,Old Wykehamists,Old Tonbridgians,2,3,4.0,5
25402347,Old Radleians,Old Salopians,5,0,0.0,5
25402350,Old Albanians,Old Ardinians,2,2,5.0,4
25402351,Old Aldenhamians,Old Berkhamstedians,6,1,0.0,7
25402352,Old Chigwellians II,Lancing Old Boys,2,6,2.0,8
25402353,KCS Old Boys II,Old Haberdashers,2,1,4.0,3
25402354,Old Brentwoods II,Old Harrovians II,6,1,0.0,7
25402355,Old Shirburnians,Old Alleynians III,2,3,4.0,5
25402356,Old Merchant Taylors,Old Epsomians,2,0,2.0,2
25402357,Old Sennockians,Old Carthusians II,2,1,4.0,3
25402359,Old Cheltonians,Old Oundelians,2,2,5.0,4
25402360,Old Canfordians,Old Brentwoods IV,1,1,4.0,2
27099158,Old Chigwellians Veterans,Old Foresters Vets,0,2,2.0,2
27435363,Old Bradfieldians,Old Reptonians,0,2,2.0,2
27435362,KCS Old Boys,Old Alleynians,0,3,2.0,3
27435364,Old Cholmeleians,Old Tonbridgians,3,1,3.0,4
27435365,Old Etonians,Old Foresters,3,2,4.0,5
27435378,Old Rugbeians,Old Marlburians,2,2,5.0,4
27435366,Old Ardinians,Old Wykehamists,3,0,2.0,3
27435377,Old Brentwoods,Old Kimboltonians,4,1,2.0,5
27435376,Old Chigwellians,Old Salopians,2,0,2.0,2
27435375,Old Harrovians,Old Radleians,1,0,3.0,1
27435383,Old Berkhamstedians,Old Westminsters,1,1,4.0,2
27435381,Old Aldenhamians,Old Alleynians II,5,6,5.0,11
27435379,Old Brentwoods II,Old Cholmeleians II,2,3,4.0,5
27435380,Old Merchant Taylors,Lancing Old Boys,3,0,2.0,3
27435387,Old Carthusians II,Old Epsomians,2,1,4.0,3
27435386,Old Brentwoods III,Old Berkhamstedians II,0,1,3.0,1
27435385,Old Sennockians,Old Alleynians III,1,3,3.0,4
27435384,Old Harrovians II,Old Chigwellians II,4,2,3.0,6
27477638,Old King's Scholars,Old Shirburnians,2,3,4.0,5
27477639,Old Westminsters II,KCS Old Boys II,4,2,3.0,6
27411807,Old Canfordians,Old Amplefordians,3,0,2.0,3
27411808,Old Kingstonians,Old Felstedians,9,0,0.0,9
27411809,Old Salopians II,Old Stoics,1,2,4.0,3
27411806,Old Merchant Taylors II,Old Oundelians,2,5,2.0,7
27411813,Old Tonbridgians II,Old Malvernians,4,5,5.0,9
27411810,Old Johnians II,Old Wellingtonians,3,2,4.0,5
27555896,Arthurian League Representative Team,SAL Representative Team,4,0,1.0,4
27381991,Old Reptonians,KCS Old Boys,3,2,4.0,5
27381994,Old Carthusians,Old Alleynians,0,6,0.0,6
27381945,Old Cholmeleians,Old Bradfieldians,0,6,0.0,6
27381946,Old Foresters,Old Johnians,0,4,1.0,4
27382008,Old Kimboltonians,Old Salopians,2,3,4.0,5
27381995,Old Ardinians,Old Radleians,4,5,5.0,9
27382004,Old Brentwoods,Old Marlburians,5,2,2.0,7
27382006,Old Harrovians,Old Chigwellians,0,3,2.0,3
27382009,Lancing Old Boys,Old Berkhamstedians,1,1,4.0,2
27382011,Old Brentwoods II,Old Westminsters,1,0,3.0,1
27382012,Old Merchant Taylors,Old Aldenhamians,3,6,3.0,9
27382015,Old Berkhamstedians II,Old Sennockians,4,3,4.0,7
27524382,Old Alleynians III,Old Epsomians,8,0,0.0,8
27382019,Old Westminsters II,Old Harrovians III,4,3,4.0,7
27382022,Old Johnians II,Old Tonbridgians II,0,1,3.0,1
27382034,Old Canfordians,Old Stoics,4,3,4.0,7
27382030,Old Salopians II,Old Kingstonians,1,4,2.0,5
27382032,Old Cranleighans,Old Cheltonians,3,1,3.0,4
27403450,Old Bradfieldians,Old Johnians,3,2,4.0,5
27381921,Old Etonians,Old Reptonians,0,2,2.0,2
27381920,Old Tonbridgians,KCS Old Boys,2,6,2.0,8
27381919,Old Foresters,Old Alleynians,3,4,4.0,7
27381922,Old Ardinians,Old Brentwoods,1,2,4.0,3
27381926,Old Rugbeians,Old Wykehamists,0,1,3.0,1
27381928,Old Kimboltonians,Old Marlburians,3,1,3.0,4
27381924,Old Radleians,Old Chigwellians,3,5,4.0,8
27381923,Old Harrovians,Old Salopians,3,2,4.0,5
27381929,Old Brentwoods II,Old Berkhamstedians,3,3,5.0,6
27381930,Old Cholmeleians II,Lancing Old Boys,4,0,1.0,4
27381931,Old Westminsters,Old Etonians II,3,2,4.0,5
27381933,Old Berkhamstedians II,Old Harrovians II,1,2,4.0,3
27403821,Old Carthusians II,Old Alleynians III,2,2,5.0,4
27381932,Old Brentwoods III,Old Haberdashers,4,8,2.0,12
27381934,Old Chigwellians II,Old Epsomians,1,0,3.0,1
27381936,Old Albanians,Old Sennockians,0,4,1.0,4
27381938,Old Shirburnians,Old Tonbridgians II,0,2,2.0,2
27381937,KCS Old Boys II,Old Johnians II,7,1,0.0,8
27381939,Old Brentwoods IV,Old Amplefordians,4,0,1.0,4
27381942,Old Salopians II,Old Wykehamists II,0,3,2.0,3
27381941,Old Cranleighans,Old Kingstonians,1,1,4.0,2
27381944,Old Wellingtonians,Old Canfordians,0,2,2.0,2
27403521,Old Stoics,Old Oundelians,3,0,2.0,3
27403567,Old Merchant Taylors,Enfield Old Grammarians III,0,5,0.0,5
27099205,Old Harrovians Vets,Old Westminsters Vets,2,1,4.0,3
27099225,KCS Old Boys Vets,Old Wykehamists Vets,4,1,2.0,5
27099230,Lancing Old Boys Vets,Old Salopians Vets,0,6,0.0,6
27099195,Old Etonians Vets,Old Bradfieldians Vets,1,0,3.0,1
27099156,Old Foresters Vets,Old Cholmeleians Vets,8,1,0.0,9
27381828,Old Alleynians,Old Bradfieldians,4,2,3.0,6
27354433,Old Johnians,Old Tonbridgians,1,1,4.0,2
27354429,KCS Old Boys,Old Cholmeleians,2,2,5.0,4
27354426,Old Etonians,Old Carthusians,1,2,4.0,3
27381847,Old Kimboltonians,Old Rugbeians,4,4,6.0,8
27354436,Old Marlburians,Old Ardinians,2,0,2.0,2
27354437,Old Wykehamists,Old Harrovians,5,1,2.0,6
27354440,Old Berkhamstedians,Old Etonians II,0,3,2.0,3
27354439,Old Brentwoods II,Lancing Old Boys,2,0,2.0,2
27354442,Old Cholmeleians II,Old Alleynians II,1,1,4.0,2
27354438,Old Westminsters,Old Aldenhamians,2,0,2.0,2
27354444,Old Haberdashers,Old Berkhamstedians II,2,3,4.0,5
27402940,Old Carthusians II,Old Albanians,3,5,4.0,8
27354446,Old Sennockians,Old Brentwoods III,7,1,0.0,8
27354448,Old Harrovians II,Old Epsomians,1,1,4.0,2
27354460,Old Amplefordians,Old Westminsters II,0,2,2.0,2
27354465,Old Brentwoods IV,Old King's Scholars,2,1,4.0,3
27354464,Old Harrovians III,Old Shirburnians,5,3,4.0,8
27354467,Old Canfordians,Old Wykehamists II,1,2,4.0,3
27354470,Old Kingstonians,Old Oundelians,2,1,4.0,3
27354468,Old Salopians II,Old Cheltonians,4,6,4.0,10
27477764,Old Chigwellians,East Barnet Old Grammarians,8,0,0.0,8
27358493,Old Foresters,Bealonians,1,2,4.0,3
27347766,Old Parmiterians,Old Brentwoods,1,2,4.0,3
27349278,East Barnet Old Grammarians III,Old Chigwellians II,1,4,2.0,5
27325389,Old Tenisonians II,KCS Old Boys II,0,2,2.0,2
27205821,Old Merchant Taylors II,Old Parkonians III,2,5,2.0,7
27205826,Old Etonians Vets,Old Ignatian Vets,3,0,2.0,3
27205827,Old Foresters Vets,Albanian Vets,6,2,2.0,8
27354398,Old Reptonians,Old Cholmeleians,4,0,1.0,4
27354399,Old Alleynians,Old Tonbridgians,3,1,3.0,4
27354400,Old Carthusians,Old Johnians,4,0,1.0,4
27354401,Old Radleians,Old Wykehamists,3,7,2.0,10
27354404,Old Salopians,Old Ardinians,1,4,2.0,5
27354405,Old Brentwoods,Old Chigwellians,4,2,3.0,6
27354403,Old Harrovians,Old Marlburians,1,0,3.0,1
27354407,Old Berkhamstedians,Old Aldenhamians,3,2,4.0,5
27354406,Lancing Old Boys,Old Westminsters,0,9,0.0,9
27353604,Old Merchant Taylors,Old Brentwoods II,1,0,3.0,1
27354413,Old Haberdashers,Old Harrovians II,6,3,3.0,9
27354409,Old Brentwoods III,Old Carthusians II,3,1,3.0,4
27354410,Old Chigwellians II,Old Berkhamstedians II,1,1,4.0,2
27354414,Old Sennockians,Old Epsomians,5,1,2.0,6
27354408,Old Alleynians III,Old Albanians,4,0,1.0,4
27354415,Old Shirburnians,Old Brentwoods IV,5,3,4.0,8
27354418,Old Tonbridgians II,KCS Old Boys II,1,4,2.0,5
27354417,Old Harrovians III,Old Johnians II,5,1,2.0,6
27354416,Old Westminsters II,Old King's Scholars,7,1,0.0,8
27354425,Old Cheltonians,Old Canfordians,1,2,4.0,3
27354419,Old Oundelians,Old Salopians II,1,9,0.0,10
27354421,Old Stoics,Old Kingstonians,1,11,0.0,12
27354420,Old Wellingtonians,Old Cranleighans,3,1,3.0,4
27099238,Old Amplefordians,Old Kimboltonians,2,7,0.0,9
27386156,Old Suttonians,Old Bradfieldians,3,9,0.0,12
27386155,Old Etonians,KCS Old Boys,2,3,4.0,5
27109044,Forest School 1st XI,Old Foresters,1,4,2.0,5
27256006,Old Alleynians,Old Johnians,7,0,0.0,7
27256004,Old Reptonians,Old Foresters,6,4,4.0,10
27256005,Old Carthusians,Old Tonbridgians,3,0,2.0,3
27256008,Old Marlburians,Old Brentwoods,2,3,4.0,5
27256010,Old Wykehamists,Old Salopians,1,0,3.0,1
27358510,Old Berkhamstedians II,Old Carthusians II,2,2,5.0,4
27358506,Old Haberdashers,Old Chigwellians II,1,7,0.0,8
27256012,Old Albanians,Old Harrovians II,3,2,4.0,5
27256018,Old King's Scholars,Old Johnians II,3,0,2.0,3
27256016,KCS Old Boys II,Old Shirburnians,3,1,3.0,4
27256017,Old Brentwoods IV,Old Tonbridgians II,0,2,2.0,2
27256020,Old Canfordians,Old Salopians II,7,5,4.0,12
27256021,Old Kingstonians,Old Cheltonians,6,1,0.0,7
27256019,Old Wellingtonians,Old Oundelians,7,3,2.0,10
27099232,Old Radleians,Old Malvernians,3,4,4.0,7
27099239,Old Westminsters,Old Bradfieldians,2,3,4.0,5
27099243,Old Aldenhamians,Old Chigwellians,1,0,3.0,1
27099237,Old Etonians,KCS Old Boys,3,0,2.0,3
27099240,Old Cholmeleians,Old Merchant Taylors,3,2,4.0,5
27099236,Old Harrovians,Old Ardinians,3,1,3.0,4
27205814,Old Brentwoods II,Old Finchleians II,3,1,3.0,4
27205813,Southgate County II,Old Etonians II,6,8,4.0,14
27477369,Old Alleynians II,Old Berkhamstedians,1,2,4.0,3
27478209,Old Alleynians III,Old Brentwoods III,1,5,2.0,6
27255983,Old Alleynians,Old Etonians,5,1,2.0,6
27255984,Old Reptonians,Old Bradfieldians,2,2,5.0,4
27255985,Old Johnians,KCS Old Boys,2,2,5.0,4
27255987,Old Kimboltonians,Old Harrovians,7,0,0.0,7
27255986,Old Radleians,Old Marlburians,2,5,2.0,7
27255988,Old Chigwellians,Old Ardinians,1,3,3.0,4
27255990,Old Alleynians II,Lancing Old Boys,2,4,3.0,6
27255991,Old Aldenhamians,Old Etonians II,0,1,3.0,1
27255992,Old Cholmeleians II,Old Westminsters,3,6,3.0,9
27255995,Old Albanians,Old Epsomians,5,1,2.0,6
27255993,Old Alleynians III,Old Carthusians II,3,0,2.0,3
27255999,Old King's Scholars,Old Amplefordians,4,6,4.0,10
27255996,KCS Old Boys II,Old Harrovians III,3,2,4.0,5
27255998,Old Tonbridgians II,Old Johnians II,4,0,1.0,4
27256001,Old Kingstonians,Old Canfordians,5,3,4.0,8
27256003,Old Wykehamists II,Old Salopians II,2,2,5.0,4
27256000,Old Cranleighans,Old Oundelians,1,1,4.0,2
27099242,Old Wykehamists,Old Berkhamstedians,0,3,2.0,3
27099241,Old Rugbeians,Old Foresters,2,4,3.0,6
27099233,Old Sennockians,Old Salopians,1,4,2.0,5
27232428,Old Cholmeleians,Old Alleynians,0,7,0.0,7
27232431,Old Tonbridgians,Old Reptonians,1,2,4.0,3
27232429,Old Carthusians,Old Foresters,4,1,2.0,5
27232436,Old Kimboltonians,Old Radleians,5,2,2.0,7
27232442,Old Marlburians,Old Salopians,1,4,2.0,5
27232435,Old Chigwellians,Old Wykehamists,5,0,0.0,5
27232451,Old Aldenhamians,Old Cholmeleians II,2,4,3.0,6
27232449,Old Brentwoods II,Old Merchant Taylors,3,0,2.0,3
27232450,Old Etonians II,Old Alleynians II,1,2,4.0,3
27232452,Old Westminsters,Old Berkhamstedians,0,2,2.0,2
27232460,Old Albanians,Old Carthusians II,3,1,3.0,4
27232517,Old Berkhamstedians II,Old Alleynians III,3,0,2.0,3
27232461,Old Brentwoods III,Old Harrovians II,5,5,6.0,10
27232462,Old Sennockians,Old Chigwellians II,1,0,3.0,1
27232467,Old Amplefordians,KCS Old Boys II,1,4,2.0,5
27232468,Old King's Scholars,Old Brentwoods IV,3,2,4.0,5
27232469,Old Harrovians III,Old Westminsters II,2,2,5.0,4
27232470,Old Johnians II,Old Shirburnians,1,2,4.0,3
27230789,Old Kingstonians,Old Cranleighans,1,1,4.0,2
27232475,Old Wykehamists II,Old Canfordians,3,2,4.0,5
27230791,Old Wellingtonians,Old Cheltonians,3,1,3.0,4
27099235,Old Johnians,Lancing Old Boys,1,2,4.0,3
27205811,KCS Old Boys,Economicals,5,0,0.0,5
27205803,Old Bradfieldians,Old Epsomians,10,0,0.0,10
27205810,Old Parkonians,Old Brentwoods,4,6,4.0,10
27205812,Old Etonians,Old Wilsonians,3,0,2.0,3
27108170,Old Alleynians,KCS Old Boys,1,3,3.0,4
27108168,Old Johnians,Old Reptonians,0,2,2.0,2
27108169,Old Cholmeleians,Old Etonians,2,1,4.0,3
27110005,Old Wykehamists,Old Kimboltonians,3,2,4.0,5
27110004,Old Salopians,Old Radleians,1,1,4.0,2
27110003,Old Harrovians,Old Rugbeians,3,2,4.0,5
27110006,Old Ardinians,Old Marlburians,3,4,4.0,7
27110096,Old Berkhamstedians,Old Merchant Taylors,2,4,3.0,6
27224774,Old Alleynians II,Old Brentwoods II,7,1,0.0,8
27110095,Old Aldenhamians,Lancing Old Boys,1,4,2.0,5
27110094,Old Etonians II,Old Westminsters,0,0,4.0,0
27110120,Old Haberdashers,Old Sennockians,2,1,4.0,3
27110119,Old Brentwoods III,Old Albanians,2,3,4.0,5
27110117,Old Harrovians II,Old Berkhamstedians II,0,0,4.0,0
27110153,Old Amplefordians,Old Harrovians III,2,0,2.0,2
27110151,Old Brentwoods IV,KCS Old Boys II,5,4,5.0,9
27110152,Old Tonbridgians II,Old King's Scholars,1,0,3.0,1
27110150,Old Westminsters II,Old Johnians II,4,1,2.0,5
27110172,Old Cheltonians,Old Salopians II,1,3,3.0,4
27110170,Old Oundelians,Old Wykehamists II,0,7,0.0,7
27110171,Old Stoics,Old Wellingtonians,2,2,5.0,4
27110169,Old Cranleighans,Old Canfordians,2,5,2.0,7
27109048,Charterhouse School 1st XI,Old Carthusians,1,5,2.0,6
27109910,Charterhouse School 2nd XI,Old Carthusians II,2,2,5.0,4
27108167,Old Cholmeleians,Old Johnians,2,1,4.0,3
27108127,Old Foresters,KCS Old Boys,2,6,2.0,8
27108165,Old Tonbridgians,Old Etonians,3,3,5.0,6
27109945,Old Chigwellians,Old Kimboltonians,4,4,6.0,8
27109946,Old Rugbeians,Old Salopians,2,3,4.0,5
27109944,Old Marlburians,Old Wykehamists,1,4,2.0,5
27109943,Old Ardinians,Old Harrovians,7,3,2.0,10
27109942,Old Brentwoods,Old Radleians,3,1,3.0,4
27110091,Old Brentwoods II,Old Aldenhamians,2,2,5.0,4
27110093,Old Cholmeleians II,Old Berkhamstedians,1,2,4.0,3
27110092,Old Merchant Taylors,Old Etonians II,1,1,4.0,2
27110090,Old Westminsters,Old Alleynians II,0,4,1.0,4
27110114,Old Epsomians,Old Haberdashers,8,0,0.0,8
27257381,Old Brentwoods III,Old Alleynians III,4,2,3.0,6
27110111,Old Chigwellians II,Old Albanians,1,2,4.0,3
27110112,Old Sennockians,Old Harrovians II,3,5,4.0,8
27110148,Old Shirburnians,Old King's Scholars,1,0,3.0,1
27110146,Old Tonbridgians II,Old Westminsters II,1,1,4.0,2
27110144,Old Harrovians III,Old Brentwoods IV,1,5,2.0,6
27110145,Old Johnians II,Old Amplefordians,3,4,4.0,7
27110166,Old Canfordians,Old Cheltonians,2,2,5.0,4
27110165,Old Wykehamists II,Old Stoics,3,2,4.0,5
27110164,Old Salopians II,Old Cranleighans,1,1,4.0,2
27110163,Old Wellingtonians,Old Kingstonians,3,6,3.0,9
27109905,Lancing College 1st XI,Lancing Old Boys,0,0,4.0,0
27109906,Lancing College 2nd XI,Lancing Old Boys II,0,5,0.0,5
27099175,Old Bradfieldians Vets,Old Wellingtonians Vets,7,1,0.0,8
27099200,Old Malvernians Vets,Old Harrovians Vets,3,0,2.0,3
27099208,Old Reptonians Vets,KCS Old Boys Vets,2,2,5.0,4
27123945,Old Foresters Vets,Old Wykehamists Vets,0,1,3.0,1
27108124,Old Johnians,Old Foresters,7,1,0.0,8
27108126,Old Cholmeleians,Old Carthusians,0,3,2.0,3
27108125,Old Etonians,Old Bradfieldians,0,3,2.0,3
27108123,Old Tonbridgians,Old Alleynians,1,4,2.0,5
27109941,Old Ardinians,Old Rugbeians,6,2,2.0,8
27109938,Old Radleians,Old Harrovians,3,1,3.0,4
27109939,Old Wykehamists,Old Brentwoods,7,0,0.0,7
27109929,Old Salopians,Old Kimboltonians,4,1,2.0,5
27110089,Old Berkhamstedians,Old Alleynians II,1,5,2.0,6
27110088,Lancing Old Boys,Old Brentwoods II,0,3,2.0,3
27110087,Old Aldenhamians,Old Merchant Taylors,0,3,2.0,3
27110086,Old Etonians II,Old Cholmeleians II,8,5,3.0,13
27110109,Old Carthusians II,Old Chigwellians II,3,1,3.0,4
27110110,Old Epsomians,Old Sennockians,0,4,1.0,4
27110108,Old Harrovians II,Old Alleynians III,2,2,5.0,4
27110107,Old Albanians,Old Berkhamstedians II,0,0,4.0,0
27110141,KCS Old Boys II,Old King's Scholars,2,3,4.0,5
27110140,Old Brentwoods IV,Old Shirburnians,3,2,4.0,5
27110139,Old Harrovians III,Old Tonbridgians II,0,2,2.0,2
27110138,Old Westminsters II,Old Amplefordians,1,3,3.0,4
27110162,Old Canfordians,Old Wellingtonians,3,1,3.0,4
27110161,Old Kingstonians,Old Salopians II,7,2,0.0,9
27110160,Old Cranleighans,Old Stoics,1,0,3.0,1
27108092,Old Alleynians,Old Reptonians,1,2,4.0,3
27108089,KCS Old Boys,Old Carthusians,0,3,2.0,3
27108090,Old Etonians,Old Johnians,2,3,4.0,5
27108091,Old Foresters,Old Tonbridgians,1,4,2.0,5
27109928,Old Brentwoods,Old Rugbeians,6,3,3.0,9
27109927,Old Chigwellians,Old Marlburians,3,2,4.0,5
27109926,Old Harrovians,Old Wykehamists,1,2,4.0,3
27110012,Old Alleynians II,Old Aldenhamians,1,3,3.0,4
27110013,Old Berkhamstedians,Lancing Old Boys,5,0,0.0,5
27110010,Old Brentwoods II,Old Etonians II,1,1,4.0,2
27110011,Old Merchant Taylors,Old Cholmeleians II,1,1,4.0,2
27110106,Old Epsomians,Old Brentwoods III,2,5,2.0,7
27110103,Old Chigwellians II,Old Haberdashers,2,2,5.0,4
27110105,Old Sennockians,Old Berkhamstedians II,2,3,4.0,5
27110101,Old Harrovians II,Old Carthusians II,3,1,3.0,4
27110100,Old Albanians,Old Alleynians III,2,0,2.0,2
27110136,Old Amplefordians,Old Brentwoods IV,4,1,2.0,5
27110137,Old King's Scholars,Old Westminsters II,0,4,1.0,4
27110134,Old Tonbridgians II,Old Shirburnians,5,0,0.0,5
27110133,Old Johnians II,Old Harrovians III,2,1,4.0,3
27110159,Old Cheltonians,Old Cranleighans,2,2,5.0,4
27110158,Old Wykehamists II,Old Wellingtonians,3,0,2.0,3
27110157,Old Oundelians,Old Kingstonians,0,3,2.0,3
27108081,Old Bradfieldians,Old Foresters,2,1,4.0,3
27108079,KCS Old Boys,Old Reptonians,3,5,4.0,8
27108080,Old Tonbridgians,Old Carthusians,0,2,2.0,2
27109924,Old Kimboltonians,Old Ardinians,1,4,2.0,5
27109925,Old Rugbeians,Old Chigwellians,6,5,5.0,11
27110009,Lancing Old Boys,Old Etonians II,3,5,4.0,8
27110008,Old Aldenhamians,Old Berkhamstedians,2,2,5.0,4
27110007,Old Merchant Taylors,Old Alleynians II,2,2,5.0,4
27110099,Old Berkhamstedians II,Old Haberdashers,2,1,4.0,3
27110098,Old Alleynians III,Old Chigwellians II,1,2,4.0,3
27110097,Old Carthusians II,Old Sennockians,4,4,6.0,8
27110130,Old Amplefordians,Old Tonbridgians II,0,2,2.0,2
27110131,Old Shirburnians,KCS Old Boys II,1,9,0.0,10
27110156,Old Cheltonians,Old Oundelians,6,0,0.0,6
27110154,Old Stoics,Old Canfordians,1,3,3.0,4
27109891,Brentwood School 1st XI,Old Brentwoods,0,0,4.0,0
27109892,Brentwood School 2nd XI,Old Brentwoods II,1,9,0.0,10
27109893,Brentwood School 3rd XI,Old Brentwoods III,0,0,4.0,0
27109894,Brentwood School 4th XI,Old Brentwoods IV,0,0,4.0,0
27109897,Epsom College 1st XI,Old Epsomians,1,3,3.0,4
27109898,Harrow School 1st XI,Old Harrovians,0,0,4.0,0
27109899,Harrow School 2nd XI,Old Harrovians II,0,0,4.0,0
27109900,Harrow School 3rd XI,Old Harrovians III,0,0,4.0,0
27109895,Highgate School 1st XI,Old Cholmeleians,0,0,4.0,0
27109896,Highgate School 2nd XI,Old Cholmeleians II,0,0,4.0,0
27109901,Kingston Grammar School 1st XI,Old Kingstonians,1,2,4.0,3
27109903,Westminster School 1st XI,Old Westminsters,0,2,2.0,2
27109904,Westminster School 2nd XI,Old Westminsters II,0,5,0.0,5
12649002,Old Foresters IV,Old Brentwoods IV,4,8,2.0,12
12649001,Old Brentwoods III,Old Brentwoods IV,3,5,4.0,8
12637620,KCS Old Boys,Lancing Old Boys,1,1,4.0,2
12639446,Old Chigwellians,Old Etonians,0,4,1.0,4
12639447,Old Haileyburians,Old Malvernians,3,1,3.0,4
12631497,Lancing Old Boys II,Old Cholmeleians II,1,4,2.0,5
12639448,Old Marlburians,Old Wykehamists II,6,1,0.0,7
12643281,Old Foresters III,Old Brentwoods IV,0,2,2.0,2
12632423,Old Citizens,Old Foresters IV,6,1,0.0,7
12641287,Old Carthusians,Old Brentwoods,6,2,2.0,8
12614177,Old Etonians,KCS Old Boys,5,1,2.0,6
12631463,Old Brentwoods,Old Carthusians,3,5,4.0,8
12636819,Old Haileyburians,Old Westminsters,0,0,4.0,0
12636926,Old King's Scholars,Old Wykehamists,1,7,0.0,8
12631499,Old Carthusians II,Old Carthusians III,0,0,4.0,0
12631496,Old Chigwellians II,Old Cholmeleians II,1,4,2.0,5
12631503,Kings College Wimbledon II,Old Marlburians,7,1,0.0,8
12632422,Old Citizens,Old Brentwoods IV,6,3,3.0,9
12633239,Old Brentwoods III,Old Foresters III,1,2,4.0,3
12631493,Old Carthusians III,Old Cholmeleians II,1,1,4.0,2
12636584,Old Harrovians,Old Etonians,1,1,4.0,2
12636588,Old Salopians,Lancing Old Boys,1,3,3.0,4
12631466,Old Cholmeleians,Lancing Old Boys,0,2,2.0,2
12621535,Lancing Old Boys,Old Cholmeleians,2,0,2.0,2
12621536,Old Foresters,Old Etonians,4,1,2.0,5
12621537,KCS Old Boys,Old Harrovians,2,3,4.0,5
12636925,Old Bradfieldians,Old Malvernians,1,3,3.0,4
12617658,Old Haberdashers,Old Wellingtonians,2,1,4.0,3
12629953,Old Chigwellians II,Lancing Old Boys II,1,0,3.0,1
12631507,Old Harrovians II,Old Marlburians,1,3,3.0,4
12631514,Old Epsomians,Old Amplefordians,3,2,4.0,5
12631515,Old Berkhamstedians,Old Cholmeleians III,1,0,3.0,1
12632421,Old Citizens,Old Brentwoods III,6,0,0.0,6
12626282,Old Brentwoods IV,Old Cholmeleians IV,1,3,3.0,4
12632424,Old Foresters III,Old Foresters IV,2,2,5.0,4
12634427,Old Sennockians,Old Millhillians,1,4,2.0,5
12614180,Old Foresters,KCS Old Boys,4,4,6.0,8
12614179,Old Harrovians,Old Chigwellians,1,0,3.0,1
12631451,Old Brentwoods,Old Cholmeleians,4,2,3.0,6
12617649,Old King's Scholars,Old Malvernians,1,4,2.0,5
12617650,Old Bradfieldians,Old Salopians,2,2,5.0,4
12617657,Old Chigwellians II,Old Wellingtonians,3,2,4.0,5
12623384,Kings College Wimbledon II,Old Harrovians II,0,1,3.0,1
12631111,Old Etonians II,Old Wykehamists II,6,0,0.0,6
12626278,Old Chigwellians III,Old Eastbournians,2,0,2.0,2
12631513,Old Cholmeleians III,Old Amplefordians,3,0,2.0,3
12626281,Old Brentwoods III,Old Cholmeleians IV,3,2,4.0,5
12624797,Old Wykehamists,Old Carthusians,0,4,1.0,4
12624787,Old Carthusians III,Lancing Old Boys II,1,0,3.0,1
12629939,Old Westminsters II,Old Citizens,2,1,4.0,3
12634426,Old Stoics,Old Millhillians,1,1,4.0,2
12614178,Old Carthusians,Lancing Old Boys,1,0,3.0,1
12614174,Old Tonbridgians,Old Brentwoods,1,4,2.0,5
12614175,Old Harrovians,Old Cholmeleians,4,6,4.0,10
12614176,Old Chigwellians,Old Foresters,2,0,2.0,2
12617646,Old Bradfieldians,Old Aldenhamians,5,2,2.0,7
12617647,Old Westminsters,Old King's Scholars,2,3,4.0,5
12617648,Old Wykehamists,Old Malvernians,4,1,2.0,5
12617654,Old Reptonians,Old Cholmeleians II,3,1,3.0,4
12617656,Old Haberdashers,Old Salopians II,1,4,2.0,5
12623381,Kings College Wimbledon II,Old Brentwoods II,2,4,3.0,6
12623383,Old Harrovians II,Old Wykehamists II,1,3,3.0,4
12623382,Old Aldenhamians II,Old Marlburians,1,2,4.0,3
12626270,Old Berkhamstedians,Old Amplefordians,7,3,2.0,10
12626271,Old Westminsters II,Old Epsomians,3,1,3.0,4
12626279,Old Chigwellians IV,Old Brentwoods III,1,5,2.0,6
12624883,Old Citizens,Old Cholmeleians III,3,2,4.0,5
12624884,Old Westminsters II,Old Epsomians,3,1,3.0,4
12621777,Old Carthusians III,Old Wellingtonians,2,3,4.0,5
12614172,Old Chigwellians,KCS Old Boys,1,0,3.0,1
12614169,Old Etonians,Old Brentwoods,1,0,3.0,1
12614170,Old Carthusians,Old Cholmeleians,2,1,4.0,3
12614171,Lancing Old Boys,Old Foresters,0,0,4.0,0
12614173,Old Harrovians,Old Tonbridgians,1,3,3.0,4
12617643,Old Aldenhamians,Old King's Scholars,3,0,2.0,3
12617644,Old Radleians,Old Malvernians,2,3,4.0,5
12617645,Old Bradfieldians,Old Wykehamists,4,1,2.0,5
12617652,Old Reptonians,Old Chigwellians II,6,1,0.0,7
12617653,Old Salopians II,Old Cholmeleians II,1,4,2.0,5
12623380,Old Brentwoods II,Old Wykehamists II,2,1,4.0,3
12626998,Old Epsomians,Old Eastbournians,4,1,2.0,5
12626943,Old Chigwellians IV,Old Malvernians II,1,3,3.0,4
12622332,Old Carthusians III,Old Etonians II,5,0,0.0,5
12622331,Lancing Old Boys II,Old Marlburians,1,1,4.0,2
12622193,Old Stoics,Old Sennockians,4,2,3.0,6
12612289,Old Harrovians,Old Etonians,4,1,2.0,5
12612290,Old Tonbridgians,Old Foresters,2,4,3.0,6
12622606,Old Reptonians,Old Salopians II,3,4,4.0,7
12612291,KCS Old Boys,Old Brentwoods,0,4,1.0,4
12612292,Old Harrovians,Old Carthusians,0,7,0.0,7
12612293,Old Foresters,Old Tonbridgians,3,1,3.0,4
12622546,Old Wykehamists,Old Aldenhamians,1,3,3.0,4
12622547,Old Salopians,Old Malvernians,6,0,0.0,6
12622607,Old Carthusians II,Old Reptonians,0,5,0.0,5
12622665,Old Etonians II,Old Brentwoods II,4,2,3.0,6
12612294,Old Cholmeleians,Old Brentwoods,1,1,4.0,2
12612295,KCS Old Boys,Old Carthusians,0,3,2.0,3
12612296,Old Tonbridgians,Old Chigwellians,1,2,4.0,3
12612297,Lancing Old Boys,Old Etonians,2,0,2.0,2
12622548,Old Aldenhamians,Old Malvernians,2,4,3.0,6
12622549,Old King's Scholars,Old Radleians,1,3,3.0,4
12622666,Old Brentwoods II,Old Aldenhamians II,2,3,4.0,5
12622746,Old Cholmeleians IV,Old Citizens,1,7,0.0,8
12612298,Old Brentwoods,Old Chigwellians,0,3,2.0,3
12612299,KCS Old Boys,Old Cholmeleians,3,2,4.0,5
12622550,Old King's Scholars,Old Aldenhamians,0,5,0.0,5
12622551,Old Westminsters,Old Haileyburians,4,1,2.0,5
12622552,Old Bradfieldians,Old Radleians,3,2,4.0,5
12622553,Old Salopians,Old Wykehamists,2,1,4.0,3
12622610,Old Carthusians II,Lancing Old Boys II,0,1,3.0,1
12622608,Old Salopians II,Old Chigwellians II,0,2,2.0,2
12622609,Old Cholmeleians II,Old Haberdashers,0,1,3.0,1
12622611,Old Reptonians,Old Wellingtonians,1,1,4.0,2
12622667,Old Harrovians II,Old Foresters II,0,4,1.0,4
12622712,Old Amplefordians,Old Westminsters II,1,4,2.0,5
12622747,Old Foresters IV,Old Brentwoods III,0,2,2.0,2
12622748,Old Brentwoods IV,Old Foresters III,4,2,3.0,6
12612304,Old Tonbridgians,KCS Old Boys,2,2,5.0,4
12612300,Lancing Old Boys,Old Brentwoods,2,0,2.0,2
12612301,Old Foresters,Old Cholmeleians,0,3,2.0,3
12612302,Old Carthusians,Old Etonians,3,1,3.0,4
12612303,Old Chigwellians,Old Harrovians,4,5,5.0,9
12622554,Old Salopians,Old Bradfieldians,1,1,4.0,2
12622555,Old Haileyburians,Old Radleians,2,7,0.0,9
12622556,Old Malvernians,Old Wykehamists,2,1,4.0,3
12622668,Kings College Wimbledon II,Old Foresters II,1,3,3.0,4
12622713,Old Cholmeleians III,Old Epsomians,2,3,4.0,5
12622714,Old Berkhamstedians,Old Westminsters II,3,1,3.0,4
12622749,Old Chigwellians IV,Old Foresters IV,1,3,3.0,4
12612306,Old Brentwoods,KCS Old Boys,2,6,2.0,8
12612307,Old Chigwellians,Lancing Old Boys,0,1,3.0,1
12612305,Old Foresters,Old Carthusians,0,3,2.0,3
12612308,Old Cholmeleians,Old Tonbridgians,4,0,1.0,4
12622557,Old Radleians,Old Aldenhamians,1,4,2.0,5
12622558,Old Bradfieldians,Old King's Scholars,4,0,1.0,4
12622559,Old Westminsters,Old Malvernians,1,3,3.0,4
12622560,Old Haileyburians,Old Wykehamists,2,2,5.0,4
12622612,Old Carthusians III,Old Chigwellians II,5,4,5.0,9
12622613,Old Reptonians,Old Haberdashers,5,2,2.0,7
12622614,Old Carthusians II,Old Salopians II,2,0,2.0,2
12622615,Old Cholmeleians II,Old Wellingtonians,2,3,4.0,5
12622669,Old Etonians II,Old Foresters II,1,1,4.0,2
12622670,Old Aldenhamians II,Old Harrovians II,3,0,2.0,3
12622671,Kings College Wimbledon II,Old Wykehamists II,2,2,5.0,4
12622715,Old Westminsters II,Old Eastbournians,1,1,4.0,2
12622716,Old Berkhamstedians,Old Epsomians,2,1,4.0,3
12622750,Old Cholmeleians IV,Old Foresters IV,1,3,3.0,4
12622751,Old Citizens,Old Malvernians II,1,2,4.0,3
12612309,KCS Old Boys,Old Chigwellians,0,4,1.0,4
12612310,Old Tonbridgians,Old Etonians,3,3,5.0,6
12612311,Lancing Old Boys,Old Harrovians,5,2,2.0,7
12622561,Old Westminsters,Old Bradfieldians,3,3,5.0,6
12622562,Old Malvernians,Old Haileyburians,3,2,4.0,5
12622563,Old Radleians,Old Wykehamists,0,1,3.0,1
12622617,Old Reptonians,Lancing Old Boys II,1,1,4.0,2
12622616,Old Haberdashers,Old Carthusians II,5,2,2.0,7
12622618,Old Salopians II,Old Wellingtonians,1,1,4.0,2
12622672,Kings College Wimbledon II,Old Aldenhamians II,0,5,0.0,5
12622717,Old Chigwellians III,Old Amplefordians,3,1,3.0,4
12622718,Old Eastbournians,Old Cholmeleians III,1,0,3.0,1
12622752,Old Chigwellians IV,Old Cholmeleians IV,0,1,3.0,1
12612314,Old Brentwoods,Lancing Old Boys,1,5,2.0,6
12612312,Old Chigwellians,Old Carthusians,1,2,4.0,3
12612313,Old Etonians,Old Cholmeleians,2,3,4.0,5
12622564,Old Westminsters,Old Aldenhamians,0,1,3.0,1
12622565,Old Radleians,Old King's Scholars,4,1,2.0,5
12622619,Old Salopians II,Lancing Old Boys II,1,1,4.0,2
12622566,Old Haileyburians,Old Salopians,1,4,2.0,5
12622567,Old King's Scholars,Old Westminsters,0,3,2.0,3
12622673,Old Wykehamists II,Old Marlburians,0,3,2.0,3
12622719,Old Chigwellians III,Old Westminsters II,3,1,3.0,4
12622753,Old Foresters III,Old Malvernians II,2,6,2.0,8
12612316,Old Tonbridgians,Lancing Old Boys,2,5,2.0,7
12612315,Old Carthusians,Old Harrovians,4,3,4.0,7
12622568,Old Haileyburians,Old Bradfieldians,2,3,4.0,5
12622569,Old Westminsters,Old Radleians,3,1,3.0,4
12622622,Old Cholmeleians II,Lancing Old Boys II,0,1,3.0,1
12622620,Old Chigwellians II,Old Carthusians III,0,1,3.0,1
12622621,Old Salopians II,Old Haberdashers,4,2,3.0,6
12622623,Old Carthusians II,Old Wellingtonians,3,1,3.0,4
12622674,Old Marlburians,Old Etonians II,4,2,3.0,6
12622675,Old Aldenhamians II,Old Foresters II,0,0,4.0,0
12622720,Old Epsomians,Old Berkhamstedians,3,2,4.0,5
12622721,Old Cholmeleians III,Old Chigwellians III,1,0,3.0,1
12622754,Old Chigwellians IV,Old Foresters III,0,5,0.0,5
12612317,Old Carthusians,Old Chigwellians,1,0,3.0,1
12612318,Old Brentwoods,Old Harrovians,0,3,2.0,3
12612319,Old Etonians,Old Tonbridgians,2,1,4.0,3
12622570,Old Salopians,Old King's Scholars,4,1,2.0,5
12622571,Old Aldenhamians,Old Radleians,1,2,4.0,3
12622572,Old Bradfieldians,Old Westminsters,4,0,1.0,4
12622624,Old Salopians II,Old Carthusians II,1,3,3.0,4
12622625,Old Haberdashers,Old Reptonians,4,4,6.0,8
12622626,Lancing Old Boys II,Old Wellingtonians,0,1,3.0,1
12622678,Old Harrovians II,Kings College Wimbledon II,1,2,4.0,3
12622676,Old Brentwoods II,Old Etonians II,1,2,4.0,3
12622677,Old Marlburians,Old Foresters II,3,1,3.0,4
12622679,Old Aldenhamians II,Old Wykehamists II,4,3,4.0,7
12622722,Old Epsomians,Old Chigwellians III,1,3,3.0,4
12622723,Old Eastbournians,Old Westminsters II,2,5,2.0,7
12622755,Old Malvernians II,Old Brentwoods IV,3,0,2.0,3
12622756,Old Citizens,Old Chigwellians IV,5,1,2.0,6
12612320,Old Chigwellians,Old Cholmeleians,2,1,4.0,3
12612321,Old Foresters,Old Chigwellians,3,2,4.0,5
12622573,Old Radleians,Old Salopians,2,3,4.0,5
12622627,Old Haberdashers,Old Carthusians III,1,3,3.0,4
12622628,Old Chigwellians II,Old Salopians II,2,5,2.0,7
12622680,Old Harrovians II,Old Aldenhamians II,0,7,0.0,7
12612322,Lancing Old Boys,Old Chigwellians,0,0,4.0,0
12612323,Old Cholmeleians,Old Etonians,3,2,4.0,5
12622574,Old Salopians,Old Westminsters,4,0,1.0,4
12622630,Old Haberdashers,Lancing Old Boys II,2,1,4.0,3
12622629,Old Chigwellians II,Old Carthusians II,2,2,5.0,4
12622631,Old Wellingtonians,Old Salopians II,1,6,0.0,7
12622724,Old Westminsters II,Old Cholmeleians III,2,5,2.0,7
12612324,Old Harrovians,Old Foresters,3,4,4.0,7
12622575,Old Malvernians,Old Radleians,1,2,4.0,3
12622576,Old Aldenhamians,Old Salopians,0,5,0.0,5
12622577,Old Wykehamists,Old Westminsters,1,1,4.0,2
12622632,Old Carthusians III,Old Carthusians II,1,1,4.0,2
12622633,Old Chigwellians II,Old Haberdashers,2,2,5.0,4
12622634,Lancing Old Boys II,Old Reptonians,0,3,2.0,3
12622635,Old Cholmeleians II,Old Salopians II,1,2,4.0,3
12622681,Old Foresters II,Old Brentwoods II,1,4,2.0,5
12622682,Old Wykehamists II,Old Etonians II,1,1,4.0,2
12622725,Old Eastbournians,Old Amplefordians,3,3,5.0,6
12622726,Old Chigwellians III,Old Berkhamstedians,1,1,4.0,2
12622757,Old Brentwoods III,Old Foresters IV,4,4,6.0,8
12612325,Lancing Old Boys,Old Carthusians,3,3,5.0,6
12612326,Old Cholmeleians,Old Harrovians,3,1,3.0,4
12612327,KCS Old Boys,Old Tonbridgians,1,4,2.0,5
12622578,Old Haileyburians,Old Aldenhamians,1,2,4.0,3
12622579,Old King's Scholars,Old Salopians,0,3,2.0,3
12622683,Old Etonians II,Old Aldenhamians II,2,3,4.0,5
12622684,Old Foresters II,Old Harrovians II,2,3,4.0,5
12612329,Old Harrovians,KCS Old Boys,3,0,2.0,3
12612330,Old Foresters,Lancing Old Boys,0,1,3.0,1
12612328,Old Tonbridgians,Old Carthusians,1,4,2.0,5
12622580,Old King's Scholars,Old Bradfieldians,1,4,2.0,5
12622581,Old Westminsters,Old Salopians,0,6,0.0,6
12622636,Old Cholmeleians II,Old Chigwellians II,0,0,4.0,0
12622637,Old Wellingtonians,Old Haberdashers,3,9,0.0,12
12622638,Lancing Old Boys II,Old Salopians II,1,2,4.0,3
12622685,Old Harrovians II,Old Brentwoods II,1,2,4.0,3
12622727,Old Eastbournians,Old Berkhamstedians,4,1,2.0,5
12622758,Old Foresters IV,Old Chigwellians IV,0,0,4.0,0
12622759,Old Brentwoods III,Old Malvernians II,1,0,3.0,1
12612331,KCS Old Boys,Old Etonians,3,0,2.0,3
12622582,Old Haileyburians,Old King's Scholars,3,3,5.0,6
12622583,Old Salopians,Old Radleians,3,2,4.0,5
12622639,Old Cholmeleians II,Old Carthusians III,1,3,3.0,4
12622640,Lancing Old Boys II,Old Chigwellians II,2,1,4.0,3
12622689,Old Etonians II,Kings College Wimbledon II,2,1,4.0,3
12622686,Old Marlburians,Old Aldenhamians II,1,2,4.0,3
12622687,Old Wykehamists II,Old Foresters II,1,2,4.0,3
12622688,Old Brentwoods II,Old Harrovians II,1,6,0.0,7
12622728,Old Amplefordians,Old Chigwellians III,2,1,4.0,3
12622729,Old Cholmeleians III,Old Eastbournians,3,0,2.0,3
12622760,Old Malvernians II,Old Brentwoods III,6,0,0.0,6
12622761,Old Chigwellians IV,Old Brentwoods IV,0,2,2.0,2
12622762,Old Foresters III,Old Cholmeleians IV,1,9,0.0,10
12622763,Old Foresters IV,Old Citizens,1,5,2.0,6
12612332,Old Brentwoods,Old Foresters,5,2,2.0,7
12612333,Old Etonians,Old Harrovians,4,0,1.0,4
12612334,Old Chigwellians,Old Tonbridgians,4,1,2.0,5
12622584,Old Radleians,Old Haileyburians,1,1,4.0,2
12622585,Old Westminsters,Old Wykehamists,1,3,3.0,4
12622643,Old Wellingtonians,Lancing Old Boys II,1,2,4.0,3
12622641,Old Cholmeleians II,Old Carthusians II,1,3,3.0,4
12622642,Old Haberdashers,Old Chigwellians II,2,4,3.0,6
12622644,Old Carthusians III,Old Salopians II,3,0,2.0,3
12622690,Old Aldenhamians II,Old Brentwoods II,2,1,4.0,3
12622691,Kings College Wimbledon II,Old Etonians II,5,0,0.0,5
12622692,Old Marlburians,Old Harrovians II,3,1,3.0,4
12622693,Old Foresters II,Old Wykehamists II,1,0,3.0,1
12622730,Old Eastbournians,Old Chigwellians III,1,1,4.0,2
12622764,Old Malvernians II,Old Cholmeleians IV,12,1,1.0,13
12622765,Old Foresters III,Old Citizens,0,9,0.0,9
12612335,KCS Old Boys,Old Foresters,1,1,4.0,2
12612336,Lancing Old Boys,Old Tonbridgians,4,1,2.0,5
12622586,Old Malvernians,Old Aldenhamians,2,3,4.0,5
12622646,Old Carthusians III,Lancing Old Boys II,4,2,3.0,6
12622645,Old Haberdashers,Old Cholmeleians II,1,3,3.0,4
12622647,Old Wellingtonians,Old Reptonians,3,2,4.0,5
12622696,Old Brentwoods II,Kings College Wimbledon II,3,0,2.0,3
12622694,Old Wykehamists II,Old Aldenhamians II,1,4,2.0,5
12622695,Old Foresters II,Old Etonians II,0,9,0.0,9
12622766,Old Foresters III,Old Brentwoods III,2,2,5.0,4
12622767,Old Cholmeleians IV,Old Brentwoods IV,0,1,3.0,1
12622768,Old Malvernians II,Old Chigwellians IV,7,0,0.0,7
12612338,Old Etonians,Lancing Old Boys,2,1,4.0,3
12612337,Old Foresters,Old Harrovians,0,3,2.0,3
12612339,Old Brentwoods,Old Tonbridgians,4,3,4.0,7
12622587,Old Aldenhamians,Old Haileyburians,2,0,2.0,2
12622588,Old Radleians,Old Westminsters,0,2,2.0,2
12622648,Lancing Old Boys II,Old Carthusians II,0,1,3.0,1
12622649,Old Salopians II,Old Reptonians,2,2,5.0,4
12622697,Old Etonians II,Old Harrovians II,2,2,5.0,4
12622731,Old Chigwellians III,Old Cholmeleians III,2,3,4.0,5
12622732,Old Epsomians,Old Westminsters II,2,2,5.0,4
12622769,Old Foresters III,Old Chigwellians IV,2,3,4.0,5
12622770,Old Citizens,Old Cholmeleians IV,6,1,0.0,7
12622771,Old Brentwoods IV,Old Malvernians II,2,4,3.0,6
12612343,Old Harrovians,Lancing Old Boys,0,3,2.0,3
12612340,Old Cholmeleians,Old Chigwellians,0,0,4.0,0
12612341,Old Brentwoods,Old Etonians,4,3,4.0,7
12612342,Old Carthusians,Old Foresters,3,3,5.0,6
12622589,Old Malvernians,Old Bradfieldians,5,0,0.0,5
12622590,Old Salopians,Old Haileyburians,7,0,0.0,7
12622591,Old Wykehamists,Old King's Scholars,0,1,3.0,1
12622650,Old Wellingtonians,Old Carthusians III,0,8,0.0,8
12622651,Old Carthusians II,Old Cholmeleians II,2,1,4.0,3
12622652,Lancing Old Boys II,Old Haberdashers,6,0,0.0,6
12622653,Old Chigwellians II,Old Reptonians,1,1,4.0,2
12622700,Old Foresters II,Kings College Wimbledon II,3,6,3.0,9
12622698,Old Aldenhamians II,Old Etonians II,1,2,4.0,3
12622699,Old Wykehamists II,Old Harrovians II,2,5,2.0,7
12622701,Old Brentwoods II,Old Marlburians,1,3,3.0,4
12622733,Old Berkhamstedians,Old Chigwellians III,4,2,3.0,6
12622772,Old Brentwoods III,Old Chigwellians IV,2,3,4.0,5
12622773,Old Malvernians II,Old Citizens,3,3,5.0,6
12622774,Old Brentwoods IV,Old Foresters IV,1,0,3.0,1
12612346,Old Cholmeleians,KCS Old Boys,2,2,5.0,4
12612344,Old Etonians,Old Carthusians,1,4,2.0,5
12612345,Old Tonbridgians,Old Harrovians,0,8,0.0,8
12622592,Old Wykehamists,Old Haileyburians,3,0,2.0,3
12622593,Old Malvernians,Old Salopians,3,2,4.0,5
12622654,Lancing Old Boys II,Old Carthusians III,1,4,2.0,5
12622655,Old Carthusians II,Old Haberdashers,5,2,2.0,7
12622702,Old Harrovians II,Old Etonians II,2,1,4.0,3
12622703,Old Foresters II,Old Marlburians,1,3,3.0,4
12622734,Old Amplefordians,Old Berkhamstedians,0,1,3.0,1
12622735,Old Epsomians,Old Cholmeleians III,0,1,3.0,1
12622775,Old Cholmeleians IV,Old Brentwoods III,3,7,2.0,10
12622776,Old Brentwoods IV,Old Citizens,3,4,4.0,7
12622777,Old Malvernians II,Old Foresters III,5,1,2.0,6
12612348,Lancing Old Boys,KCS Old Boys,2,0,2.0,2
12612347,Old Harrovians,Old Brentwoods,3,1,3.0,4
12612349,Old Carthusians,Old Tonbridgians,8,1,0.0,9
12622594,Old Radleians,Old Bradfieldians,6,3,3.0,9
12622595,Old Malvernians,Old King's Scholars,2,1,4.0,3
12622596,Old Aldenhamians,Old Wykehamists,2,1,4.0,3
12622656,Old Wellingtonians,Old Carthusians II,0,2,2.0,2
12622657,Old Carthusians III,Old Reptonians,2,2,5.0,4
12622705,Old Marlburians,Kings College Wimbledon II,5,1,2.0,6
12622704,Old Brentwoods II,Old Foresters II,2,6,2.0,8
12622736,Old Eastbournians,Old Epsomians,1,2,4.0,3
12622737,Old Cholmeleians III,Old Westminsters II,2,5,2.0,7
12622778,Old Brentwoods IV,Old Chigwellians IV,1,3,3.0,4
12622779,Old Foresters IV,Old Cholmeleians IV,3,2,4.0,5
12622780,Old Citizens,Old Foresters III,5,1,2.0,6
12612353,Old Carthusians,KCS Old Boys,1,0,3.0,1
12612350,Old Foresters,Old Brentwoods,1,5,2.0,6
12612351,Old Etonians,Old Chigwellians,0,0,4.0,0
12612352,Old Tonbridgians,Old Cholmeleians,1,2,4.0,3
12622597,Old Aldenhamians,Old Bradfieldians,2,4,3.0,6
12622598,Old King's Scholars,Old Haileyburians,3,2,4.0,5
12622599,Old Wykehamists,Old Radleians,3,2,4.0,5
12622600,Old Malvernians,Old Westminsters,2,3,4.0,5
12622658,Old Reptonians,Old Carthusians II,1,1,4.0,2
12622659,Old Wellingtonians,Old Cholmeleians II,1,1,4.0,2
12622660,Old Carthusians III,Old Haberdashers,6,3,3.0,9
12622706,Old Foresters II,Old Aldenhamians II,2,4,3.0,6
12622707,Old Marlburians,Old Brentwoods II,6,2,2.0,8
12622738,Old Westminsters II,Old Berkhamstedians,1,2,4.0,3
12622739,Old Amplefordians,Old Epsomians,3,4,4.0,7
12622781,Old Cholmeleians IV,Old Chigwellians IV,3,2,4.0,5
12622782,Old Brentwoods III,Old Citizens,0,9,0.0,9
12622783,Old Malvernians II,Old Foresters IV,9,0,0.0,9
12612354,Old Cholmeleians,Old Carthusians,2,2,5.0,4
12612355,Old Etonians,Old Foresters,2,3,4.0,5
12622601,Old Bradfieldians,Old Haileyburians,0,2,2.0,2
12622602,Old Wykehamists,Old Salopians,1,2,4.0,3
12622603,Old Aldenhamians,Old Westminsters,0,5,0.0,5
12622661,Old Reptonians,Old Carthusians III,2,3,4.0,5
12622662,Old Carthusians II,Old Chigwellians II,4,1,2.0,5
12622708,Old Wykehamists II,Kings College Wimbledon II,1,3,3.0,4
12622709,Old Etonians II,Old Marlburians,2,5,2.0,7
12622740,Old Westminsters II,Old Chigwellians III,1,4,2.0,5
12622741,Old Amplefordians,Old Cholmeleians III,1,5,2.0,6
12622742,Old Berkhamstedians,Old Eastbournians,1,1,4.0,2
12622784,Old Cholmeleians IV,Old Foresters III,0,3,2.0,3
12612356,Old Chigwellians,Old Brentwoods,3,2,4.0,5
12612357,Old Cholmeleians,Old Foresters,3,2,4.0,5
12622604,Old Salopians,Old Aldenhamians,4,2,3.0,6
12622605,Old Wykehamists,Old Bradfieldians,4,4,6.0,8
12622663,Old Wellingtonians,Old Chigwellians II,0,3,2.0,3
12622664,Old Cholmeleians II,Old Reptonians,1,7,0.0,8
12622711,Old Aldenhamians II,Kings College Wimbledon II,4,3,4.0,7
12622710,Old Wykehamists II,Old Brentwoods II,1,2,4.0,3
12622743,Old Cholmeleians III,Old Berkhamstedians,1,0,3.0,1
12622744,Old Amplefordians,Old Eastbournians,2,5,2.0,7
12622745,Old Chigwellians III,Old Epsomians,2,5,2.0,7
12622785,Old Brentwoods IV,Old Brentwoods III,4,0,1.0,4
12622786,Old Foresters IV,Old Foresters III,2,1,4.0,3
13711962,Old Amplefordians,Ampleforth College 1st XI,4,2,3.0,6
13868764,Old Cholmeleians II,Old Merchant Taylors,0,4,1.0,4
13646388,Old Cholmeleians II,Old Millfieldians,3,4,4.0,7
13098821,Lancing Old Boys,Old Foresters,3,0,2.0,3
13098923,Old Haileyburians,Old Wykehamists,0,3,2.0,3
13097280,Old Sennockians,Old Harrovians III,1,6,0.0,7
13098752,Lancing Old Boys,Old Brentwoods,4,1,2.0,5
13098754,Old Carthusians,Old Cholmeleians,6,3,3.0,9
13098866,Old Aldenhamians,Old Westminsters,2,2,5.0,4
13469677,Old Carthusians III,Old Marlburians,1,4,2.0,5
13186732,Old Aldenhamians II,Old Wellingtonians,5,2,2.0,7
13186693,Old Chigwellians II,Old Cholmeleians II,8,0,0.0,8
13097201,Old Brentwoods II,Old Wykehamists II,0,3,2.0,3
13340143,Old Amplefordians,Old Brentwoods IV,2,7,0.0,9
13186723,Old Carthusians II,Old Wellingtonians,4,1,2.0,5
13617599,Old Harrovians Vets,Old Etonians Vets,2,3,4.0,5
13617591,Old Brentwoods Vets,Old Salopians Vets,4,2,3.0,6
13098809,Lancing Old Boys,Old Salopians,0,1,3.0,1
13469475,Old Etonians,Old Foresters,0,1,3.0,1
13098806,Old Harrovians,Old Cholmeleians,1,4,2.0,5
13300466,Old Radleians,Old Tonbridgians,0,4,1.0,4
13098860,Old Westminsters,Old King's Scholars,7,5,4.0,12
13186657,Old Marlburians,Lancing Old Boys II,2,1,4.0,3
13186703,Old Haberdashers,Old Carthusians III,1,6,0.0,7
13186716,Old Chigwellians II,Old Salopians II,0,2,2.0,2
13366107,Old Carthusians III,Old Haberdashers,4,1,2.0,5
13097217,Old Berkhamstedians,Old Brentwoods II,2,1,4.0,3
13097207,Old Foresters II,Old Cholmeleians III,1,1,4.0,2
13097339,Old Stoics,Old Eastbournians,3,5,4.0,8
13325406,Old Westminsters II,Old Citizens,2,3,4.0,5
13470117,Old Brentwoods IV,Old Sennockians,2,3,4.0,5
13418291,Old Foresters III,Old Cholmeleians IV,1,2,4.0,3
13578360,Queen Mary College Old Boys,Old Aldenhamians,5,2,2.0,7
13097266,Old Millhillians,Old Sennockians,1,2,4.0,3
13574448,Old Cholmeleians Vets,Old Etonians Vets,1,3,3.0,4
13597533,Old Kimboltonians Vets,Old Brentwoods Vets,0,1,3.0,1
13098835,Old Brentwoods,Old Cholmeleians,2,5,2.0,7
13469473,Lancing Old Boys,Old Malvernians,4,2,3.0,6
13098831,Old Harrovians,Old Salopians,2,2,5.0,4
13098852,KCS Old Boys,Old Haileyburians,3,0,2.0,3
13098868,Old Tonbridgians,Old Radleians,2,2,5.0,4
13098909,Old Reptonians,Old Westminsters,1,1,4.0,2
13098846,Old Bradfieldians,Old Wykehamists,5,2,2.0,7
13098915,Old Aldenhamians,Old King's Scholars,1,0,3.0,1
13186682,Old Salopians II,Old Aldenhamians II,1,2,4.0,3
13186695,Old Haberdashers,Old Wellingtonians,0,4,1.0,4
13186706,Old Cholmeleians II,Old Chigwellians II,1,0,3.0,1
13471390,Old Harrovians II,Old Cholmeleians III,1,5,2.0,6
13097198,Kings College Wimbledon II,Old Etonians II,0,2,2.0,2
13471385,Old Epsomians,Old Wykehamists II,4,2,3.0,6
13097204,Old Berkhamstedians,Old Foresters II,0,3,2.0,3
13097323,Old Citizens,Old Bancroftians AFC,3,1,3.0,4
13097333,Old Eastbournians,Old Brentwoods III,3,4,4.0,7
13097335,Old Westminsters II,Old Malvernians II,0,1,3.0,1
13097279,Old Brentwoods IV,Old Amplefordians,2,3,4.0,5
13097281,Old Sennockians,Old Cholmeleians IV,5,3,4.0,8
13602722,Old Foresters,Old Carthusians,0,3,2.0,3
13606994,Old Carthusians II,Old Marlburians,1,2,4.0,3
13612305,Old Oundelians,Old Stoics,1,0,3.0,1
13098782,Old Brentwoods,Old Etonians,0,3,2.0,3
13328099,Old Cholmeleians,Old Foresters,3,2,4.0,5
13098824,Old Carthusians,Lancing Old Boys,1,0,3.0,1
13098893,KCS Old Boys,Old Radleians,4,2,3.0,6
13098883,Old Haileyburians,Old Reptonians,2,3,4.0,5
13098891,Old Bradfieldians,Old Aldenhamians,1,3,3.0,4
13098884,Old Tonbridgians,Old Westminsters,3,0,2.0,3
13334851,Old King's Scholars,Old Wykehamists,2,1,4.0,3
13186674,Old Carthusians II,Old Salopians II,2,2,5.0,4
13419686,Old Carthusians III,Old Cholmeleians II,1,3,3.0,4
13186722,Old Chigwellians II,Old Haberdashers,1,2,4.0,3
13186652,Old Aldenhamians II,Old Marlburians,1,9,0.0,10
13186711,Lancing Old Boys II,Old Wellingtonians,2,1,4.0,3
13186662,Old Cholmeleians II,Old Carthusians III,3,1,3.0,4
13097215,Old Brentwoods II,Old Etonians II,0,1,3.0,1
13471386,Old Etonians II,Old Brentwoods II,2,0,2.0,2
13097212,Old Epsomians,Old Foresters II,1,2,4.0,3
13097293,Old Bancroftians AFC,Old Westminsters II,1,1,4.0,2
13097303,Old Brentwoods III,Old Malvernians II,0,4,1.0,4
13097294,Old Chigwellians III,Old Citizens,1,4,2.0,5
13399245,Old Brentwoods IV,Old Cholmeleians IV,1,0,3.0,1
13097268,Old Millhillians,Old Foresters III,6,1,0.0,7
13605355,Old Sennockians,Old Oundelians,1,3,3.0,4
13596451,Old Amplefordians,Old Stoics,1,5,2.0,6
13469472,Old Salopians,Old Brentwoods,1,1,4.0,2
13098787,Old Harrovians,Old Carthusians,1,3,3.0,4
13098785,Old Chigwellians,Old Malvernians,2,1,4.0,3
13098826,Old Malvernians,Old Chigwellians,1,1,4.0,2
13098827,Old Foresters,Old Etonians,1,2,4.0,3
13098874,Old Westminsters,KCS Old Boys,0,2,2.0,2
13098892,Old Wykehamists,Old Haileyburians,6,3,3.0,9
13098896,Old Reptonians,Old Radleians,4,6,4.0,10
13098897,Old King's Scholars,Old Tonbridgians,0,4,1.0,4
13186702,Old Aldenhamians II,Lancing Old Boys II,2,1,4.0,3
13186696,Old Wellingtonians,Old Chigwellians II,0,1,3.0,1
13186718,Old Salopians II,Old Haberdashers,1,5,2.0,6
13186727,Old Chigwellians II,Old Wellingtonians,2,3,4.0,5
13471388,Old Foresters II,Kings College Wimbledon II,4,1,2.0,5
13471389,Old Berkhamstedians,Old Etonians II,4,0,1.0,4
13097182,Old Cholmeleians III,Old Brentwoods II,0,2,2.0,2
13097195,Old Brentwoods II,Old Cholmeleians III,1,0,3.0,1
13097309,Old Chigwellians III,Old Brentwoods III,2,4,3.0,6
13097250,Old Millhillians,Old Brentwoods IV,0,1,3.0,1
13470114,Old Harrovians III,Old Cholmeleians IV,1,4,2.0,5
13597223,Old Carthusians III,Old Carthusians II,3,3,5.0,6
13585163,Old Millfieldians,Old Marlburians,3,4,4.0,7
13596475,Old Westminsters II,Old Sennockians,2,4,3.0,6
13591405,Old Oundelians,Old Citizens,2,2,5.0,4
13429247,Old Stoics,Stowe School,3,3,5.0,6
13098794,Old Foresters,Lancing Old Boys,2,0,2.0,2
13573198,Old Foresters,Lancing Old Boys,2,0,2.0,2
13507808,Old Harrovians Vets,Old Foresters Vets,2,1,4.0,3
13409652,Old Kimboltonians Vets,Old Westminsters Vets,2,1,4.0,3
13559025,Old Salopians Vets,Old Wykehamists Vets,3,1,3.0,4
13469471,Old Cholmeleians,Lancing Old Boys,3,3,5.0,6
13098825,Old Harrovians,Old Brentwoods,2,0,2.0,2
13300421,Old Malvernians,Old Foresters,0,10,0.0,10
13469469,Old Salopians,Old Carthusians,0,5,0.0,5
13098807,Old Chigwellians,Old Etonians,0,2,2.0,2
13098876,Old Bradfieldians,Old Tonbridgians,2,4,3.0,6
13098920,Old Wykehamists,Old Westminsters,3,3,5.0,6
13098857,Old Reptonians,Old Aldenhamians,2,1,4.0,3
13366108,Old Marlburians,Old Cholmeleians II,2,2,5.0,4
13186675,Old Wellingtonians,Old Carthusians III,1,1,4.0,2
13186701,Old Carthusians III,Old Wellingtonians,1,0,3.0,1
13471387,Kings College Wimbledon II,Old Harrovians II,2,5,2.0,7
13471391,Old Wykehamists II,Old Foresters II,1,5,2.0,6
13097172,Old Epsomians,Old Cholmeleians III,2,2,5.0,4
13097338,Old Bancroftians AFC,Old Chigwellians III,1,0,3.0,1
13470116,Old Amplefordians,Old Millhillians,5,3,4.0,8
13470115,Old Cholmeleians IV,Old Brentwoods IV,1,2,4.0,3
13574102,Old Carthusians II,Old Citizens,6,5,5.0,11
13585107,Old Stoics,Old Brentwoods III,1,0,3.0,1
13585110,Old Westminsters II,Old Eastbournians,3,2,4.0,5
13577982,Old Radleians,Radley College 1st XI,2,1,4.0,3
13372324,Arthurian League Representative Team,SAL Representative Team,1,0,3.0,1
13098802,Old Foresters,Old Brentwoods,4,1,2.0,5
13098798,Old Chigwellians,Old Carthusians,2,3,4.0,5
13098784,Lancing Old Boys,Old Harrovians,1,2,4.0,3
13098762,Old Etonians,Old Salopians,1,3,3.0,4
13098875,Old Aldenhamians,Old Haileyburians,8,2,0.0,10
13289947,Old Bradfieldians,Old Radleians,1,1,4.0,2
13098913,Old King's Scholars,Old Westminsters,0,3,2.0,3
13098903,Old Reptonians,KCS Old Boys,1,6,0.0,7
13098890,Old Wykehamists,Old Tonbridgians,3,2,4.0,5
13186679,Old Carthusians III,Old Aldenhamians II,2,0,2.0,2
13186710,Old Marlburians,Old Carthusians II,1,2,4.0,3
13186691,Old Salopians II,Old Wellingtonians,1,3,3.0,4
13186728,Old Chigwellians II,Lancing Old Boys II,0,3,2.0,3
13186670,Old Aldenhamians II,Old Carthusians III,0,1,3.0,1
13186659,Old Haberdashers,Old Cholmeleians II,3,4,4.0,7
13097177,Old Cholmeleians III,Old Berkhamstedians,2,4,3.0,6
13097210,Old Wykehamists II,Old Brentwoods II,1,1,4.0,2
13280587,Old Etonians II,Old Epsomians,1,1,4.0,2
13561370,Old Millfieldians,Old Harrovians II,5,1,2.0,6
13570987,Old Chigwellians III,Old Amplefordians,2,7,0.0,9
13570986,Old Brentwoods III,Old Bancroftians AFC,1,0,3.0,1
13570988,Old Stoics,Old Brentwoods IV,3,2,4.0,5
13570983,Old Oundelians,Old Cholmeleians IV,4,1,2.0,5
13570982,Old Ardinians,Old Westminsters II,0,3,2.0,3
13570990,Old Foresters III,Old Sennockians,1,3,3.0,4
13570989,Old Alleynians AFC,Old Citizens,0,3,2.0,3
13098783,Old Salopians,Old Foresters,1,1,4.0,2
13098810,Old Etonians,Lancing Old Boys,4,3,4.0,7
13413406,Old Cholmeleians Vets,Old Reptonians Vets,4,3,4.0,7
13098819,Old Salopians,Old Etonians,1,2,4.0,3
13098786,Old Chigwellians,Lancing Old Boys,1,4,2.0,5
13296802,Old Westminsters,Old Reptonians,1,1,4.0,2
13098881,Old Aldenhamians,KCS Old Boys,1,4,2.0,5
13098888,Old Radleians,Old Haileyburians,2,1,4.0,3
13186725,Old Salopians II,Old Cholmeleians II,1,5,2.0,6
13296886,Old Carthusians III,Lancing Old Boys II,1,0,3.0,1
13097181,Old Epsomians,Kings College Wimbledon II,6,2,2.0,8
13097185,Old Harrovians II,Old Berkhamstedians,2,2,5.0,4
13097168,Old Wykehamists II,Old Cholmeleians III,1,1,4.0,2
13097337,Old Malvernians II,Old Brentwoods III,2,3,4.0,5
13097329,Old Westminsters II,Old Stoics,3,1,3.0,4
13399798,Old Cholmeleians IV,Old Amplefordians,1,2,4.0,3
13097258,Old Sennockians,Old Foresters III,3,1,3.0,4
13550222,Old Brentwoods,Old Foresters,0,1,3.0,1
13535666,Old Carthusians,Old Tonbridgians,2,1,4.0,3
13549513,Old Brentwoods II,Old Carthusians II,0,2,2.0,2
13561449,Old Chigwellians II,Old Marlburians,1,6,0.0,7
13400464,Old Haberdashers,Haberdashers Aske School 1st XI,2,6,2.0,8
13423957,Forest School 1st XI,Old Foresters II,4,4,6.0,8
13401038,Old Chigwellians Vets,Old Etonians Vets,1,2,4.0,3
13098812,Old Foresters,Old Chigwellians,3,1,3.0,4
13098805,Old Carthusians,Old Brentwoods,2,0,2.0,2
13300422,Old Salopians,Old Malvernians,5,2,2.0,7
13098834,Old Harrovians,Old Etonians,1,2,4.0,3
13098904,Old King's Scholars,Old Bradfieldians,1,3,3.0,4
13339960,Old Aldenhamians,Old Radleians,3,0,2.0,3
13469538,Old Tonbridgians,KCS Old Boys,0,6,0.0,6
13186686,Old Carthusians II,Old Carthusians III,3,4,4.0,7
13399715,Old Aldenhamians II,Old Haberdashers,1,2,4.0,3
13186648,Lancing Old Boys II,Old Salopians II,1,1,4.0,2
13186707,Old Marlburians,Old Wellingtonians,0,1,3.0,1
13097222,Kings College Wimbledon II,Old Cholmeleians III,1,3,3.0,4
13097226,Old Foresters II,Old Epsomians,0,1,3.0,1
13097227,Old Harrovians II,Old Etonians II,2,2,5.0,4
13097336,Old Bancroftians AFC,Old Stoics,2,1,4.0,3
13438688,Old Reptonians,Lancing Old Boys,2,4,3.0,6
13550240,Old Chigwellians II,Old Kimboltonians,2,1,4.0,3
13549381,Old Brentwoods III,Old Millfieldians,4,6,4.0,10
13098830,Old Carthusians,Old Malvernians,6,2,2.0,8
13310577,Old Salopians,Old Chigwellians,1,1,4.0,2
13300469,Old Wykehamists,Old Aldenhamians,1,3,3.0,4
13098872,Old Reptonians,Old Tonbridgians,0,1,3.0,1
13098898,Old Haileyburians,Old Westminsters,3,1,3.0,4
13186665,Old Cholmeleians II,Old Carthusians II,0,1,3.0,1
13186714,Old Carthusians II,Old Cholmeleians II,1,1,4.0,2
13186646,Old Haberdashers,Lancing Old Boys II,0,3,2.0,3
13186708,Old Chigwellians II,Old Carthusians III,0,3,2.0,3
13186673,Old Carthusians III,Old Chigwellians II,4,1,2.0,5
13097200,Old Berkhamstedians,Old Harrovians II,4,0,1.0,4
13321421,Kings College Wimbledon II,Old Wykehamists II,7,3,2.0,10
13097175,Old Etonians II,Old Cholmeleians III,2,0,2.0,2
13097211,Old Cholmeleians III,Old Etonians II,2,3,4.0,5
13097330,Old Brentwoods III,Old Bancroftians AFC,1,1,4.0,2
13097325,Old Malvernians II,Old Stoics,0,1,3.0,1
13097326,Old Eastbournians,Old Westminsters II,1,1,4.0,2
13097271,Old Harrovians III,Old Foresters III,4,3,4.0,7
13438686,Old Foresters,Old Brentwoods,4,4,6.0,8
13515995,Old Kimboltonians,Old Alleynians AFC,3,3,5.0,6
13536696,Old Brentwoods II,Old Sennockians,3,0,2.0,3
13524757,Old Chigwellians III,Old Cholmeleians IV,6,1,0.0,7
13524785,Old Millfieldians,Old Amplefordians,5,0,0.0,5
13529650,Old Epsomians,Old Citizens,0,4,1.0,4
13098818,Old Cholmeleians,Old Chigwellians,2,0,2.0,2
13098887,Old King's Scholars,KCS Old Boys,0,10,0.0,10
13301407,Old Chigwellians II,Old Carthusians II,1,4,2.0,5
13097206,Old Brentwoods II,Kings College Wimbledon II,2,5,2.0,7
13097321,Old Citizens,Old Malvernians II,2,3,4.0,5
13426947,Old Harrovians III,Old Millhillians,3,2,4.0,5
13438687,Old Salopians,Old Tonbridgians,0,3,2.0,3
13478706,Old Carthusians,Old Westminsters,5,0,0.0,5
13529653,Old Cholmeleians II,Old Carthusians III,1,9,0.0,10
13529651,Old Stoics,Old Harrovians II,2,3,4.0,5
13420230,Old Ardinians,Old Sennockians,1,5,2.0,6
13506253,Old Oundelians,Old Carthusians III,2,6,2.0,8
13479987,Old Bradfieldians Vets,Old Salopians Vets,0,5,0.0,5
13414900,Old Millfieldians,Old Alleynians AFC,0,1,3.0,1
13469470,Old Malvernians,Old Cholmeleians,0,6,0.0,6
13098815,Old Carthusians,Old Harrovians,4,1,2.0,5
13300467,Old Westminsters,Old Tonbridgians,2,1,4.0,3
13296801,Old Haileyburians,Old Aldenhamians,2,0,2.0,2
13300472,Old Wykehamists,Old Bradfieldians,2,3,4.0,5
13186692,Old Haberdashers,Old Aldenhamians II,5,3,4.0,8
13186688,Old Salopians II,Old Marlburians,1,3,3.0,4
13186685,Old Cholmeleians II,Old Wellingtonians,2,2,5.0,4
13469676,Old Wellingtonians,Old Cholmeleians II,2,2,5.0,4
13455285,Old Cholmeleians III,Old Citizens,0,1,3.0,1
13455280,Old Chigwellians II,Old Wykehamists II,7,2,0.0,9
13420229,Old Westminsters II,Old Amplefordians,1,6,0.0,7
13518551,Old Carthusians II,Glynn Old Boys II,1,4,2.0,5
13406393,Old Carthusians III,Old Suttonians,2,5,2.0,7
13328065,Old Cholmeleians,Old Etonians,1,0,3.0,1
13098822,Old Chigwellians,Old Harrovians,0,4,1.0,4
13098914,Old Bradfieldians,Old Haileyburians,0,3,2.0,3
13339951,Old Wykehamists,KCS Old Boys,3,6,3.0,9
13098910,Old Tonbridgians,Old King's Scholars,8,1,0.0,9
13186672,Old Cholmeleians II,Lancing Old Boys II,3,0,2.0,3
13186715,Old Haberdashers,Old Marlburians,0,8,0.0,8
13097328,Old Chigwellians III,Old Malvernians II,2,3,4.0,5
13420232,Old Brentwoods IV,Old Alleynians AFC,1,4,2.0,5
13455288,Old Carthusians II,Old Etonians II,9,1,0.0,10
13430115,Old St Marys,Old Aldenhamians,0,2,2.0,2
13415965,Old Foresters Vets,Lancing Old Boys Vets,2,2,5.0,4
13401037,Old Harrovians Vets,Old Carthusians Vets,4,3,4.0,7
13469474,Old Malvernians,Old Brentwoods,1,5,2.0,6
13098820,Old Etonians,Old Carthusians,1,1,4.0,2
13098799,Old Foresters,Old Harrovians,3,2,4.0,5
13098779,Old Salopians,Old Cholmeleians,1,2,4.0,3
13098902,Old Aldenhamians,Old Wykehamists,2,3,4.0,5
13186700,Lancing Old Boys II,Old Marlburians,1,4,2.0,5
13471384,Kings College Wimbledon II,Old Berkhamstedians,1,2,4.0,3
13097331,Old Chigwellians III,Old Eastbournians,3,2,4.0,5
13420227,Old Millfieldians,Old Bancroftians AFC,3,1,3.0,4
13455281,Old Haberdashers,Old Epsomians,1,4,2.0,5
13420228,Old Oundelians,Old Harrovians III,7,3,2.0,10
13433406,Old Carthusians III,Nottsborough FC,0,3,2.0,3
13380243,Old Carthusians II,Albanian FC,5,0,0.0,5
13383308,Old King's Scholars,"The King's School, Canterbury",4,7,3.0,11
13098829,Old Chigwellians,Old Foresters,1,0,3.0,1
13098771,Old Cholmeleians,Old Malvernians,4,1,2.0,5
13098895,Old Aldenhamians,Old Bradfieldians,2,1,4.0,3
13098922,KCS Old Boys,Old King's Scholars,4,0,1.0,4
13186712,Old Wellingtonians,Old Aldenhamians II,4,2,3.0,6
13186690,Old Cholmeleians II,Old Marlburians,2,7,0.0,9
13455284,Old Brentwoods III,Lancing Old Boys II,2,0,2.0,2
13455279,Old Salopians II,Old Stoics,2,4,3.0,6
13409612,Old Salopians Vets,Old Aldenhamians Vets,3,2,4.0,5
13469468,Old Cholmeleians,Old Harrovians,0,1,3.0,1
13328098,Old Carthusians,Old Foresters,2,2,5.0,4
13289985,Old Radleians,Old Bradfieldians,1,2,4.0,3
13098879,Old King's Scholars,Old Reptonians,0,6,0.0,6
13098880,KCS Old Boys,Old Tonbridgians,2,1,4.0,3
13362726,Old Haileyburians,Old Westminsters,1,4,2.0,5
13455282,Old Malvernians II,Kings College Wimbledon II,5,0,0.0,5
13455287,Old Harrovians II,Old Eastbournians,3,1,3.0,4
13420233,Old Kimboltonians,Old Foresters III,3,3,5.0,6
13455283,Old Cholmeleians II,Old Wellingtonians,3,1,3.0,4
13455278,Old Aldenhamians II,Old Foresters II,2,1,4.0,3
13455286,Old Marlburians,Old Berkhamstedians,7,0,0.0,7
13417926,Winchmore Hill,Old Chigwellians,4,0,1.0,4
13417925,Lancing Old Boys,Alleyn Old Boys,0,4,1.0,4
13457337,Old Carthusians,Old Salopians,2,1,4.0,3
13421731,Old Sennockians,Sevenoaks School 1st XI,1,1,4.0,2
13098832,Old Brentwoods,Lancing Old Boys,2,0,2.0,2
13098753,Old Etonians,Old Chigwellians,3,3,5.0,6
13300470,Old Radleians,Old Aldenhamians,5,0,0.0,5
13186661,Old Carthusians II,Old Aldenhamians II,3,3,5.0,6
13186704,Old Salopians II,Old Chigwellians II,0,3,2.0,3
13097202,Old Harrovians II,Old Brentwoods II,4,5,5.0,9
13097199,Old Cholmeleians III,Old Foresters II,0,2,2.0,2
13097324,Old Brentwoods III,Old Chigwellians III,5,0,0.0,5
13097275,Old Brentwoods IV,Old Harrovians III,3,1,3.0,4
13348361,Old Reptonians,Old Berkhamstedians,8,2,0.0,10
13362312,Old Wykehamists,Old Carthusians,0,5,0.0,5
13348338,Old Foresters,Old Marlburians,4,0,1.0,4
12751555,Old Cholmeleians,Old Salopians,1,6,0.0,7
13391759,Royal Bank of Scotland II,Old Cholmeleians II,10,0,0.0,10
13391758,New College Old Boys,Old Westminsters,3,3,5.0,6
13391732,Old Carthusians III,Civil Service III,1,0,3.0,1
13098789,Old Etonians,Old Brentwoods,3,4,4.0,7
13098792,Old Salopians,Old Harrovians,5,1,2.0,6
13098899,Old Reptonians,Old Bradfieldians,1,3,3.0,4
13339961,Old Westminsters,Old Radleians,1,4,2.0,5
13098870,Old Haileyburians,KCS Old Boys,3,9,0.0,12
13186678,Old Carthusians II,Lancing Old Boys II,3,0,2.0,3
13186664,Old Chigwellians II,Old Aldenhamians II,3,2,4.0,5
13392713,Old Haberdashers,Old Salopians II,2,3,4.0,5
13097194,Old Harrovians II,Kings College Wimbledon II,2,0,2.0,2
13340215,Old Foresters II,Old Brentwoods II,2,2,5.0,4
13399216,Old Cholmeleians III,Old Wykehamists II,1,0,3.0,1
13310579,Old Eastbournians,Old Bancroftians AFC,1,1,4.0,2
13097320,Old Stoics,Old Brentwoods III,3,2,4.0,5
13097322,Old Chigwellians III,Old Westminsters II,0,1,3.0,1
13097242,Old Foresters III,Old Sennockians,1,7,0.0,8
13348123,Old Malvernians,Old Tonbridgians,0,4,1.0,4
13376665,Lancing Old Boys,Bealonians,6,0,0.0,6
13377162,Old Stationers,Old Chigwellians,2,3,4.0,5
13376666,Old Foresters,Old Suttonians,2,3,4.0,5
13363083,Old Carthusians,Old Wilsonians,1,3,3.0,4
13380546,Old Sedcopians,Old Aldenhamians,1,2,4.0,3
13340216,Old Cholmeleians II,UCL Academicals III,0,3,2.0,3
13329168,Old Foresters Vets,Old Aldenhamians Vets,4,1,2.0,5
13377332,Old Cholmeleians,Old Carthusians,0,1,3.0,1
13098813,Old Brentwoods,Old Chigwellians,2,1,4.0,3
13098817,Old Malvernians,Lancing Old Boys,1,2,4.0,3
13328042,Old Foresters,Old Salopians,1,1,4.0,2
13098878,Old Westminsters,Old Bradfieldians,1,3,3.0,4
13098919,Old Radleians,Old Reptonians,2,3,4.0,5
13098918,Old Haileyburians,Old King's Scholars,3,2,4.0,5
13098911,KCS Old Boys,Old Wykehamists,4,2,3.0,6
13300473,Old Tonbridgians,Old Aldenhamians,0,2,2.0,2
13186671,Old Carthusians II,Old Marlburians,1,1,4.0,2
13186669,Old Wellingtonians,Old Salopians II,2,1,4.0,3
13097191,Old Brentwoods II,Old Berkhamstedians,9,2,0.0,11
13340267,Old Cholmeleians III,Old Harrovians II,1,4,2.0,5
13340277,Old Foresters II,Old Wykehamists II,0,0,4.0,0
13097316,Old Chigwellians III,Old Bancroftians AFC,1,1,4.0,2
13097317,Old Westminsters II,Old Brentwoods III,1,7,0.0,8
13097318,Old Malvernians II,Old Eastbournians,2,0,2.0,2
13097319,Old Citizens,Old Stoics,4,2,3.0,6
13097270,Old Amplefordians,Old Harrovians III,2,0,2.0,2
13340145,Old Cholmeleians IV,Old Millhillians,3,5,4.0,8
13383453,Icarus,Old Cholmeleians II,2,1,4.0,3
13367712,Old Carthusians III,Old Meadonians,1,0,3.0,1
13414898,Old Millfieldians,Millfield School 1st XI,3,1,3.0,4
13260192,Old Chigwellians Vets,Old Salopians Vets,4,3,4.0,7
13260193,Old Harrovians Vets,Old Westminsters Vets,3,2,4.0,5
13260189,Old Etonians Vets,Old Wykehamists Vets,7,0,0.0,7
13098797,Old Carthusians,Old Etonians,2,1,4.0,3
13098776,Old Brentwoods,Old Salopians,1,2,4.0,3
13098775,Old Harrovians,Old Malvernians,0,1,3.0,1
13098861,Old Haileyburians,Old Radleians,2,2,5.0,4
13098862,KCS Old Boys,Old Reptonians,2,2,5.0,4
13098863,Old Tonbridgians,Old Wykehamists,3,1,3.0,4
13098864,Old Bradfieldians,Old King's Scholars,5,1,2.0,6
13186680,Old Marlburians,Old Chigwellians II,2,2,5.0,4
13186643,Lancing Old Boys II,Old Haberdashers,3,5,4.0,8
13186709,Old Aldenhamians II,Old Salopians II,2,1,4.0,3
13097187,Old Cholmeleians III,Kings College Wimbledon II,3,5,4.0,8
13097188,Old Berkhamstedians,Old Epsomians,2,1,4.0,3
13097189,Old Brentwoods II,Old Foresters II,0,1,3.0,1
13321426,Old Wykehamists II,Old Harrovians II,2,3,4.0,5
13097315,Old Chigwellians III,Old Stoics,4,1,2.0,5
13340221,Old Cholmeleians IV,Old Foresters III,1,1,4.0,2
13097252,Old Amplefordians,Old Sennockians,2,1,4.0,3
13328018,Old Cholmeleians II,Mill Hill Village,4,2,3.0,6
13359845,Merton,Old Carthusians II,4,1,2.0,5
13328017,Carshalton,Old Westminsters,0,2,2.0,2
13380236,Old Carthusians III,Enfield Old Grammarians,5,1,2.0,6
13328023,Old Chigwellians,Old Hamptonians,0,8,0.0,8
13366204,Old Malvernians,Old Carthusians,0,5,0.0,5
13366205,Old Cholmeleians,Old Salopians,2,1,4.0,3
13098908,Old Bradfieldians,KCS Old Boys,2,3,4.0,5
13296800,Old Westminsters,Old Haileyburians,4,2,3.0,6
13186720,Lancing Old Boys II,Old Aldenhamians II,3,2,4.0,5
13366106,Old Cholmeleians II,Old Haberdashers,2,2,5.0,4
13366267,Old Marlburians,Old Salopians II,4,1,2.0,5
13097221,Old Wykehamists II,Old Berkhamstedians,2,1,4.0,3
13238939,Old Epsomians,Old Brentwoods II,2,3,4.0,5
13097184,Old Harrovians II,Old Foresters II,2,2,5.0,4
13097312,Old Malvernians II,Old Bancroftians AFC,2,1,4.0,3
13097313,Old Citizens,Old Brentwoods III,6,1,0.0,7
13097314,Old Westminsters II,Old Eastbournians,0,0,4.0,0
13321539,Old Sennockians,Old Brentwoods IV,4,5,5.0,9
13368824,Old Millhillians,Old Harrovians III,4,4,6.0,8
13340172,Old Amplefordians,Old Foresters III,3,2,4.0,5
13340286,Old Minchendenians,Kings College Wimbledon II,5,4,5.0,9
13340285,Old Cholmeleians III,UCL Academicals III,1,5,2.0,6
13328072,Lancing Old Boys,Richmond & Kew SAL,3,2,4.0,5
13328071,Old Chigwellians,Merton,3,1,3.0,4
13328069,Globe Rangers,Old Foresters,0,5,0.0,5
13034803,Wood Green Old Boys,Old Carthusians II,1,7,0.0,8
13339942,Old Magdalenians,Old Aldenhamians,1,4,2.0,5
13339941,Witan,Old Reptonians,5,0,0.0,5
13328022,Mayfield,Old Brentwoods,4,3,4.0,7
13260187,Old Carthusians Vets,Old Bradfieldians Vets,4,2,3.0,6
13328841,Old Etonians,Old Malvernians,5,0,0.0,5
13098770,Old Brentwoods,Old Harrovians,1,6,0.0,7
13098855,Old Bradfieldians,Old Westminsters,3,6,3.0,9
13098894,Old Tonbridgians,Old Reptonians,2,2,5.0,4
13098917,KCS Old Boys,Old Aldenhamians,2,0,2.0,2
13098854,Old Radleians,Old King's Scholars,6,2,2.0,8
13356040,Old Aldenhamians II,Old Cholmeleians II,0,7,0.0,7
13355967,Old Wellingtonians,Old Marlburians,1,7,0.0,8
13186730,Old Salopians II,Old Carthusians III,1,4,2.0,5
13280588,Kings College Wimbledon II,Old Epsomians,2,5,2.0,7
13097219,Old Wykehamists II,Old Etonians II,1,1,4.0,2
13097311,Old Stoics,Old Malvernians II,5,0,0.0,5
13097310,Old Eastbournians,Old Citizens,1,6,0.0,7
13340144,Old Foresters III,Old Harrovians III,4,3,4.0,7
13097264,Old Brentwoods IV,Old Millhillians,2,2,5.0,4
12751372,Old Haberdashers,Old Haileyburians,1,5,2.0,6
13328070,Old Carthusians,Old Finchleians,9,3,0.0,12
13328073,Albanian FC,Old Salopians,2,1,4.0,3
13098773,Lancing Old Boys,Old Carthusians,0,3,2.0,3
13328854,Old Cholmeleians,Old Brentwoods,2,4,3.0,6
13337186,Old Radleians,Old Wykehamists,2,2,5.0,4
13334854,Old King's Scholars,Old Aldenhamians,1,7,0.0,8
13334529,Old Marlburians,Old Carthusians III,2,3,4.0,5
13301446,Old Carthusians II,Old Chigwellians II,3,1,3.0,4
13097178,Kings College Wimbledon II,Old Foresters II,5,1,2.0,6
13097179,Old Brentwoods II,Old Harrovians II,3,4,4.0,7
13337239,Old Etonians II,Old Wykehamists II,5,2,2.0,7
13097304,Old Malvernians II,Old Chigwellians III,2,2,5.0,4
13097306,Old Bancroftians AFC,Old Eastbournians,2,6,2.0,8
13097307,Old Brentwoods III,Old Westminsters II,3,3,5.0,6
13097305,Old Stoics,Old Citizens,1,1,4.0,2
13097244,Old Cholmeleians IV,Old Harrovians III,4,2,3.0,6
13097276,Old Sennockians,Old Amplefordians,4,1,2.0,5
12751375,Old Harrovians,Old Reptonians,2,3,4.0,5
12751368,Old Foresters,KCS Old Boys,7,6,5.0,13
12751373,Old Tonbridgians,Old Etonians,2,0,2.0,2
13327057,Old Salopians,Old Wokingians I,1,3,3.0,4
13278604,Old Parmiterians,Old Cholmeleians III,2,0,2.0,2
13282903,Old Westminsters,Old Woodhouseians,1,3,3.0,4
13260150,Old Kimboltonians Vets,Old Foresters Vets,0,1,3.0,1
13300420,Old Etonians,Old Harrovians,2,2,5.0,4
13324183,Old Foresters,Old Malvernians,8,2,0.0,10
13098916,Old Wykehamists,Old Reptonians,0,1,3.0,1
13289645,Old Haileyburians,Old Tonbridgians,3,4,4.0,7
13301405,Old Aldenhamians II,Old Chigwellians II,0,4,1.0,4
13356041,Old Carthusians III,Old Salopians II,4,1,2.0,5
13304933,Old Cholmeleians III,Old Epsomians,2,4,3.0,6
13304934,Old Etonians II,Old Harrovians II,2,0,2.0,2
13097301,Old Stoics,Old Bancroftians AFC,3,3,5.0,6
13325405,Old Citizens,Old Westminsters II,9,0,0.0,9
13301451,Old Cholmeleians IV,Old Sennockians,3,5,4.0,8
13301452,Old Foresters III,Old Millhillians,4,3,4.0,7
13097241,Old Harrovians III,Old Brentwoods IV,3,2,4.0,5
12751377,Old Chigwellians,Lancing Old Boys,1,2,4.0,3
12751369,Old Aldenhamians,Old Berkhamstedians,4,6,4.0,10
12751370,Old Bradfieldians,Old Eastbournians,3,2,4.0,5
12751367,Old Carthusians,Old King's Scholars,5,0,0.0,5
13034757,Old Cholmeleians,Bealonians,1,1,4.0,2
13289583,Phoenix Old Boys,KCS Old Boys,5,4,5.0,9
13262202,Old Brentwoods II,Old Carthusians II,2,2,5.0,4
13299014,Old Aloysians,Old Chigwellians III,4,1,2.0,5
13219853,Wandsworth Borough,Old Cholmeleians II,1,8,0.0,9
13251936,Old Haberdashers,Polytechnic 2s,0,4,1.0,4
13262201,Old Westminsters,Weirside Rangers,3,2,4.0,5
13098764,Old Harrovians,Old Chigwellians,1,1,4.0,2
13098765,Old Malvernians,Old Etonians,2,2,5.0,4
13098763,Old Salopians,Lancing Old Boys,1,3,3.0,4
13098849,Old Haileyburians,Old Bradfieldians,3,3,5.0,6
13098850,Old Reptonians,Old King's Scholars,5,1,2.0,6
13098851,KCS Old Boys,Old Westminsters,3,1,3.0,4
13186666,Old Marlburians,Old Aldenhamians II,8,4,2.0,12
13186654,Old Salopians II,Old Carthusians II,1,3,3.0,4
13186697,Lancing Old Boys II,Old Cholmeleians II,1,5,2.0,6
13186656,Old Wellingtonians,Old Haberdashers,2,1,4.0,3
13238940,Old Etonians II,Old Berkhamstedians,3,2,4.0,5
13097224,Old Epsomians,Old Harrovians II,3,1,3.0,4
13097298,Old Bancroftians AFC,Old Brentwoods III,1,1,4.0,2
13097299,Old Eastbournians,Old Chigwellians III,2,2,5.0,4
13097300,Old Malvernians II,Old Citizens,2,3,4.0,5
13097237,Old Brentwoods IV,Old Foresters III,2,6,2.0,8
13097239,Old Sennockians,Old Millhillians,1,5,2.0,6
13262768,BB Eagles,Kings College Wimbledon II,0,2,2.0,2
13033726,Lea Valley,Old Aldenhamians,4,1,2.0,5
13033725,Old Carthusians,Old Cholmeleians,8,2,0.0,10
13262760,Old Buckwellians,Old Cholmeleians III,1,1,4.0,2
13034802,Old Chigwellians II,Old Tenisonians,1,2,4.0,3
13033724,Old Brentwoods,Polytechnic,2,3,4.0,5
13034676,Old Brentwoods II,Sinjun Grammarians,1,3,3.0,4
13262759,Old Carthusians III,Weirside Rangers,5,0,0.0,5
13198366,Winchester College 1st XI,Old Wykehamists,0,1,3.0,1
13198365,Winchester College 2nd XI,Old Wykehamists II,1,5,2.0,6
13098760,Old Brentwoods,Old Foresters,2,1,4.0,3
13098761,Old Malvernians,Old Harrovians,2,4,3.0,6
13098814,Lancing Old Boys,Old Cholmeleians,3,1,3.0,4
13098836,Old Chigwellians,Old Salopians,3,3,5.0,6
13098900,Old King's Scholars,Old Haileyburians,0,4,1.0,4
13098882,Old Wykehamists,Old Radleians,4,1,2.0,5
13186651,Old Carthusians III,Old Carthusians II,2,0,2.0,2
13186694,Old Chigwellians II,Old Marlburians,2,4,3.0,6
13186653,Old Cholmeleians II,Old Salopians II,3,0,2.0,3
13186644,Old Wellingtonians,Lancing Old Boys II,3,2,4.0,5
13097167,Old Berkhamstedians,Kings College Wimbledon II,5,3,4.0,8
13097169,Old Brentwoods II,Old Epsomians,1,5,2.0,6
13097170,Old Etonians II,Old Foresters II,3,1,3.0,4
13097295,Old Brentwoods III,Old Eastbournians,0,2,2.0,2
13097297,Old Stoics,Old Westminsters II,2,1,4.0,3
13097334,Old Citizens,Old Chigwellians III,4,1,2.0,5
13097296,Old Bancroftians AFC,Old Malvernians II,1,1,4.0,2
13097235,Old Millhillians,Old Cholmeleians IV,6,4,4.0,10
13097234,Old Harrovians III,Old Amplefordians,1,7,0.0,8
13033634,Old Reptonians,Citigroup,3,1,3.0,4
13033633,Old Aldenhamians,Old Edmontonians,4,2,3.0,6
13098756,Old Harrovians,Lancing Old Boys,2,4,3.0,6
13098777,Old Chigwellians,Old Brentwoods,3,3,5.0,6
13098758,Old Foresters,Old Carthusians,2,2,5.0,4
13098759,Old Etonians,Old Cholmeleians,4,3,4.0,7
13098757,Old Malvernians,Old Salopians,1,2,4.0,3
13098847,Old Tonbridgians,Old Bradfieldians,4,2,3.0,6
13098907,Old Wykehamists,Old King's Scholars,6,2,2.0,8
13098926,Old Radleians,Old Westminsters,1,6,0.0,7
13186649,Old Wellingtonians,Old Carthusians II,0,4,1.0,4
13186713,Lancing Old Boys II,Old Carthusians III,1,3,3.0,4
13186650,Old Haberdashers,Old Chigwellians II,2,3,4.0,5
13097186,Kings College Wimbledon II,Old Brentwoods II,3,2,4.0,5
13097166,Old Epsomians,Old Etonians II,4,2,3.0,6
13097190,Old Harrovians II,Old Wykehamists II,2,1,4.0,3
13097165,Old Foresters II,Old Berkhamstedians,4,1,2.0,5
13097308,Old Westminsters II,Old Bancroftians AFC,2,1,4.0,3
13097292,Old Brentwoods III,Old Stoics,1,7,0.0,8
13097232,Old Millhillians,Old Amplefordians,6,4,4.0,10
13034677,Old Aldenhamians II,Latymer Old Boys,2,3,4.0,5
13033627,Old Meadonians,Old Eastbournians,1,0,3.0,1
13033626,Old Cholmeleians III,Old Edmontonians,4,3,4.0,7
13033696,Old Salopians II,Old Westminster Citizens,1,3,3.0,4
13198338,Aldenham School 1st XI,Old Aldenhamians,2,3,4.0,5
13098803,Lancing Old Boys,Old Chigwellians,2,0,2.0,2
13120584,Old Brentwoods,Old Malvernians,3,2,4.0,5
13098755,Old Harrovians,Old Foresters,1,1,4.0,2
13098843,Old Reptonians,Old Haileyburians,2,4,3.0,6
13098844,Old King's Scholars,Old Radleians,3,0,2.0,3
13098845,Old Aldenhamians,Old Tonbridgians,0,4,1.0,4
13186663,Old Salopians II,Lancing Old Boys II,0,2,2.0,2
13186684,Old Marlburians,Old Haberdashers,1,1,4.0,2
13097161,Old Etonians II,Kings College Wimbledon II,3,5,4.0,8
13097162,Old Berkhamstedians,Old Cholmeleians III,1,1,4.0,2
13097163,Old Wykehamists II,Old Epsomians,4,2,3.0,6
13097164,Old Foresters II,Old Harrovians II,3,1,3.0,4
13097290,Old Stoics,Old Chigwellians III,0,7,0.0,7
13097291,Old Citizens,Old Eastbournians,5,1,2.0,6
13097228,Old Foresters III,Old Brentwoods IV,0,6,0.0,6
13097231,Old Harrovians III,Old Sennockians,1,6,0.0,7
13033682,Wake Green Amateur,Old Aldenhamians II,5,1,2.0,6
13035630,Old Salvatorians,Old Bancroftians AFC,5,0,0.0,5
13033684,UCL Academicals,Old Brentwoods II,5,6,5.0,11
13033631,Hale End Athletic,Old Brentwoods III,7,2,0.0,9
13033683,KCS Old Boys,Old Josephians,16,0,1.0,16
13035610,Old Cholmeleians II,Old Millhillians,15,0,1.0,15
13033660,South Bank Cuaco,Old Salopians,0,3,2.0,3
13033685,Old Carthusians II,Old Sedcopians,7,2,0.0,9
13033630,Old Carthusians III,Old Wokingians,2,1,4.0,3
13238922,Forest School 1st XI,Arthurian League Representative Team,2,3,4.0,5
13098750,Old Brentwoods,Old Carthusians,1,3,3.0,4
13098751,Lancing Old Boys,Old Etonians,3,1,3.0,4
13098790,Old Chigwellians,Old Cholmeleians,3,0,2.0,3
13098841,Old Radleians,KCS Old Boys,1,1,4.0,2
13098921,Old Westminsters,Old Aldenhamians,1,1,4.0,2
13098885,Old Tonbridgians,Old Haileyburians,2,2,5.0,4
13098842,Old Reptonians,Old Wykehamists,2,3,4.0,5
13186683,Lancing Old Boys II,Old Chigwellians II,2,1,4.0,3
13186689,Old Carthusians II,Old Haberdashers,5,1,2.0,6
13186699,Old Cholmeleians II,Old Aldenhamians II,2,2,5.0,4
13097160,Old Berkhamstedians,Old Wykehamists II,4,4,6.0,8
13097159,Old Foresters II,Old Etonians II,1,0,3.0,1
13097287,Old Brentwoods III,Old Citizens,0,9,0.0,9
13097289,Old Malvernians II,Old Westminsters II,5,3,4.0,8
13097288,Old Eastbournians,Old Stoics,2,3,4.0,5
13097230,Old Amplefordians,Old Cholmeleians IV,2,0,2.0,2
13033737,Wandsworth Borough,Old Carthusians III,1,6,0.0,7
13033736,Southgate County,Old Cholmeleians III,2,4,3.0,6
13033735,Kings College Wimbledon II,Old Dorkinians,2,0,2.0,2
13098749,Old Foresters,Old Cholmeleians,3,1,3.0,4
13098838,KCS Old Boys,Old Bradfieldians,7,1,0.0,8
13098839,Old Aldenhamians,Old Reptonians,3,4,4.0,7
13098840,Old Westminsters,Old Wykehamists,2,2,5.0,4
13186645,Old Aldenhamians II,Old Carthusians II,0,8,0.0,8
13097213,Old Wykehamists II,Kings College Wimbledon II,0,4,1.0,4
13097156,Old Epsomians,Old Berkhamstedians,0,3,2.0,3
13097285,Old Bancroftians AFC,Old Citizens,0,7,0.0,7
13097286,Old Eastbournians,Old Malvernians II,2,4,3.0,6
13097284,Old Westminsters II,Old Chigwellians III,1,2,4.0,3
13097255,Old Foresters III,Old Amplefordians,1,10,0.0,11
13033674,Civil Service II,Old Chigwellians II,4,1,2.0,5
13033672,Old Owens,Old Cholmeleians II,3,4,4.0,7
13033676,Old Haileyburians,Old Garchonians,2,8,0.0,10
13033677,Old Challoners,Old Millhillians,6,6,6.0,12
13033675,Latymer Old Boys,Old Salopians II,4,1,2.0,5
13033673,Old Haberdashers,Old Vaughanians,7,3,2.0,10
13186314,Old Brentwoods,Brentwood School 1st XI,3,1,3.0,4
13186313,Old Brentwoods II,Brentwood School 2nd XI,0,3,2.0,3
13186312,Old Brentwoods III,Brentwood School 3rd XI,3,3,5.0,6
13186311,Old Brentwoods IV,Brentwood School 4th XI,3,3,5.0,6
13186316,Lancing Old Boys,Lancing College 1st XI,6,2,2.0,8
13186315,Lancing Old Boys II,Lancing College 2nd XI,0,2,2.0,2
13092967,Old Etonians II,Old Harrovians II,6,2,2.0,8
13072601,Old Tonbridgians,Old Malvernians,4,2,3.0,6
13175344,Old Harrovians,KCS Old Boys,1,1,4.0,2
13020710,Old Amplefordians,Old Berkhamstedians,5,7,4.0,12
13182491,Old Cholmeleians IV,Old Cholmeleians III,2,3,4.0,5
13120495,Eton College 1st XI,Old Etonians,0,2,2.0,2
13020745,Old Wilsonians,Old Carthusians,2,1,4.0,3
14275055,Old Malvernians,Old Chigwellians,2,9,0.0,11
14257696,Lancing Old Boys,Old Carthusians,1,2,4.0,3
14273784,Old Carthusians III,Old Carthusians II,4,3,4.0,7
14273927,Old Brentwoods III,Old Cholmeleians III,3,3,5.0,6
14760201,Old Millhillians,Old Alleynians AFC,0,3,2.0,3
14749381,Old Etonians Vets,Lancing Old Boys Vets,2,2,5.0,4
14755936,Old Malvernians Vets,Old Reptonians Vets,2,0,2.0,2
14257719,Old Salopians,Old Etonians,3,2,4.0,5
14257724,Lancing Old Boys,Old Cholmeleians,1,1,4.0,2
14275057,Old Aldenhamians,Old Reptonians,0,2,2.0,2
14275024,Old Chigwellians,Old Westminsters,6,2,2.0,8
14275054,Old Malvernians,Old Wykehamists,3,1,3.0,4
14273815,Old Cholmeleians II,Old Wellingtonians,2,8,0.0,10
14273883,Old Chigwellians II,Old Foresters II,2,1,4.0,3
14273976,Old Carthusians III,Old Haberdashers,2,1,4.0,3
14260372,Old Millfieldians,Old Berkhamstedians,3,0,2.0,3
14260320,Old Citizens,Kings College Wimbledon II,5,1,2.0,6
14260355,Old Harrovians II,Old Epsomians,0,2,2.0,2
14273833,Old Sennockians,Old Brentwoods III,3,1,3.0,4
14273863,Old Tonbridgians II,Old Westminsters II,6,4,4.0,10
14741632,Old Bancroftians AFC,Old Alleynians AFC,1,4,2.0,5
14257672,Old Foresters,Old Etonians,4,3,4.0,7
14749421,Old Westminsters Vets,Old Reptonians Vets,2,2,5.0,4
14257677,Old Tonbridgians,Old Etonians,0,2,2.0,2
14257725,KCS Old Boys,Old Foresters,1,5,2.0,6
14257723,Old Salopians,Old Brentwoods,1,1,4.0,2
14257681,Old Harrovians,Old Cholmeleians,0,3,2.0,3
14275028,Old Malvernians,Old Aldenhamians,4,4,6.0,8
14275015,Old Bradfieldians,Old Westminsters,5,2,2.0,7
14273929,Old Haberdashers,Old King's Scholars,3,0,2.0,3
14273864,Old Chigwellians II,Lancing Old Boys II,2,2,5.0,4
14273961,Old Etonians II,Old Carthusians III,0,5,0.0,5
14260323,Kings College Wimbledon II,Old Berkhamstedians,2,3,4.0,5
14260321,Old Brentwoods II,Old Epsomians,0,7,0.0,7
14260400,Old Citizens,Old Salopians II,2,1,4.0,3
14273915,Old Chigwellians III,Old Cholmeleians III,3,0,2.0,3
14273939,Old Tonbridgians II,Old Westminsters II,2,2,5.0,4
14728090,Old Carthusians,Lancing Old Boys,1,0,3.0,1
14736839,Old Carthusians II,Old Millfieldians,2,0,2.0,2
14748644,Old Sennockians,Old Alleynians AFC,0,3,2.0,3
14707143,Lancing Old Boys Vets,Old Brentwoods Vets,2,1,4.0,3
14691177,Old Wykehamists Vets,Old Malvernians Vets,0,1,3.0,1
14676473,Old Harrovians Vets,Old Reptonians Vets,1,3,3.0,4
14257693,Old Tonbridgians,Old Brentwoods,1,2,4.0,3
14257712,Old Etonians,Lancing Old Boys,2,1,4.0,3
14257675,Old Carthusians,Old Harrovians,4,0,1.0,4
14257673,Old Cholmeleians,Old Foresters,0,4,1.0,4
14275039,Old Haileyburians,Old Wykehamists,1,3,3.0,4
14275041,Old Westminsters,Old Chigwellians,1,5,2.0,6
14275020,Old Bradfieldians,Old Reptonians,5,1,2.0,6
14275032,Old Malvernians,Old Radleians,2,6,2.0,8
14273895,Old King's Scholars,Old Carthusians II,1,4,2.0,5
14273790,Old Wellingtonians,Old Carthusians III,1,2,4.0,3
14273846,Old Etonians II,Old Chigwellians II,0,5,0.0,5
14273898,Old Haberdashers,Old Foresters II,0,2,2.0,2
14260368,Kings College Wimbledon II,Old Brentwoods II,2,3,4.0,5
14260380,Old Harrovians II,Old Millfieldians,2,3,4.0,5
14260357,Old Berkhamstedians,Old Salopians II,2,1,4.0,3
14260393,Old Epsomians,Old Aldenhamians II,1,3,3.0,4
14273940,Old Chigwellians III,Old Brentwoods III,2,1,4.0,3
14273853,Old Amplefordians,Old Cholmeleians III,0,2,2.0,2
14273825,Old Wykehamists II,Old Eastbournians,0,2,2.0,2
14273809,Old Stoics,Old Sennockians,2,2,5.0,4
14273866,Old Cholmeleians IV,Old Bancroftians AFC,0,2,2.0,2
14273879,Old Tonbridgians II,Old Oundelians,0,2,2.0,2
14736578,Old Westminsters II,Old Alleynians AFC,0,3,2.0,3
14741631,Old Millhillians,Old Foresters III,3,0,2.0,3
14273847,Old Bancroftians AFC,Old Foresters III,1,5,2.0,6
14257687,Old Etonians,KCS Old Boys,2,0,2.0,2
14257714,Old Foresters,Old Cholmeleians,1,2,4.0,3
14257680,Old Brentwoods,Lancing Old Boys,3,4,4.0,7
14275051,Old Haileyburians,Old Aldenhamians,2,4,3.0,6
14275017,Old Wykehamists,Old Malvernians,3,1,3.0,4
14275048,Old Chigwellians,Old Radleians,3,1,3.0,4
14273889,Old Carthusians II,Old Haberdashers,1,0,3.0,1
14273871,Old Etonians II,Lancing Old Boys II,0,1,3.0,1
14273933,Old Cholmeleians II,Old Carthusians III,1,4,2.0,5
14273827,Old Chigwellians II,Old King's Scholars,2,2,5.0,4
14260360,Old Harrovians II,Old Brentwoods II,1,2,4.0,3
14260374,Old Aldenhamians II,Old Epsomians,1,2,4.0,3
14260394,Old Berkhamstedians,Old Citizens,3,1,3.0,4
14273903,Old Brentwoods III,Old Amplefordians,0,7,0.0,7
14273960,Old Eastbournians,Old Wykehamists II,3,2,4.0,5
14273980,Old Harrovians III,Old Bancroftians AFC,1,1,4.0,2
14273984,Old Brentwoods IV,Old Cholmeleians IV,1,3,3.0,4
14273972,Old Merchant Taylors,Old Foresters III,0,0,4.0,0
14273787,Old Alleynians AFC,Old Millhillians,6,4,4.0,10
14717294,Old Millfieldians,Kings College Wimbledon II,2,1,4.0,3
14726603,Old Westminsters II,Old Oundelians,5,0,0.0,5
14726578,Old Tonbridgians II,Old Sennockians,1,1,4.0,2
14381560,KCS Old Boys,"King's College School, Wimbledon 1st XI",2,4,3.0,6
14707258,Old Etonians Vets,Old Chigwellians Vets,4,0,1.0,4
14257689,Old Brentwoods,Old Salopians,0,1,3.0,1
14257659,Old Harrovians,Old Foresters,2,4,3.0,6
14275053,Old Marlburians,Old Westminsters,3,1,3.0,4
14273987,Old Etonians II,Old Haberdashers,0,3,2.0,3
14273966,Old King's Scholars,Old Carthusians III,3,7,2.0,10
14711581,Old Aldenhamians II,Kings College Wimbledon II,2,1,4.0,3
14260341,Old Citizens,Old Brentwoods II,0,1,3.0,1
14260386,Old Millfieldians,Old Epsomians,2,1,4.0,3
14350753,Old Wykehamists II,Old Chigwellians III,0,1,3.0,1
14273921,Old Bancroftians AFC,Old Brentwoods IV,3,1,3.0,4
14674208,Old Reptonians,Lancing Old Boys,1,4,2.0,5
14674209,Old Etonians,Old Carthusians,0,2,2.0,2
14716002,Old Carthusians II,Old Harrovians II,3,1,3.0,4
14716150,Old Foresters III,Old Alleynians AFC,1,4,2.0,5
14716088,Old Brentwoods III,Old Oundelians,0,4,1.0,4
14716141,Old Eastbournians,Old Tonbridgians II,0,5,0.0,5
14645938,Old Bradfieldians,Bradfield College,4,1,2.0,5
14287800,Old Stoics,Stowe School,0,9,0.0,9
14689085,Old Foresters II,Forest School 1st XI,0,3,2.0,3
14257685,Old Foresters,Lancing Old Boys,2,3,4.0,5
14257715,Old Salopians,Old Carthusians,0,7,0.0,7
14257701,Old Harrovians,Old Etonians,1,1,4.0,2
14257642,Old Cholmeleians,Old Brentwoods,1,1,4.0,2
14275074,Old Wykehamists,Old Chigwellians,1,3,3.0,4
14275012,Old Reptonians,Old Malvernians,3,3,5.0,6
14273857,Old Haberdashers,Old Cholmeleians II,5,0,0.0,5
14273802,Old Etonians II,Old King's Scholars,2,0,2.0,2
14273830,Lancing Old Boys II,Old Foresters II,1,2,4.0,3
14260365,Old Berkhamstedians,Old Brentwoods II,2,2,5.0,4
14260396,Old Salopians II,Old Millfieldians,0,4,1.0,4
14273925,Old Stoics,Old Amplefordians,3,1,3.0,4
14273881,Old Cholmeleians IV,Old Brentwoods IV,3,5,4.0,8
14695973,Old Chigwellians II,Kings College Wimbledon II,0,1,3.0,1
14703095,Old Carthusians II,Old Carthusians III,1,0,3.0,1
14686766,Old Oundelians,Old Cholmeleians III,5,0,0.0,5
14698225,Old Merchant Taylors,Old Alleynians AFC,2,4,3.0,6
14706362,Old Chigwellians III,Old Eastbournians,1,2,4.0,3
14706963,Old Harrovians III,Old Sennockians,0,4,1.0,4
14706357,Old Bancroftians AFC,Old Tonbridgians II,0,1,3.0,1
14608917,Old Etonians,Eton College 1st XI,2,1,4.0,3
14698264,Old Westminsters,Westminster School 1st XI,2,1,4.0,3
14698263,Old Westminsters II,Westminster School 2nd XI,2,2,5.0,4
14258399,Old Radleians,Radley College 1st XI,3,1,3.0,4
14602926,Old Carthusians Vets,Old Brentwoods Vets,0,1,3.0,1
14613238,Old Cholmeleians Vets,Old Chigwellians Vets,0,4,1.0,4
14650650,Old Tonbridgians Vets,Old Westminsters Vets,0,10,0.0,10
14257658,Old Brentwoods,Old Etonians,3,1,3.0,4
14257668,KCS Old Boys,Old Harrovians,1,0,3.0,1
14257682,Old Cholmeleians,Old Carthusians,0,1,3.0,1
14257716,Old Tonbridgians,Old Foresters,0,5,0.0,5
14274992,Old Aldenhamians,Old Chigwellians,2,6,2.0,8
14275030,Old Westminsters,Old Wykehamists,1,1,4.0,2
14275019,Old Malvernians,Old Marlburians,2,2,5.0,4
14273942,Old Chigwellians II,Old Cholmeleians II,3,5,4.0,8
14273817,Old Carthusians II,Lancing Old Boys II,0,0,4.0,0
14273935,Old Wellingtonians,Old Foresters II,3,1,3.0,4
14260362,Kings College Wimbledon II,Old Salopians II,1,3,3.0,4
14695896,Old Harrovians II,Old Berkhamstedians,3,2,4.0,5
14698224,Old Rugbeians,Old Harrovians III,2,4,3.0,6
14686549,Old Chigwellians III,Old Merchant Taylors II,6,2,2.0,8
14686561,Old Bancroftians AFC,Old Millhillians,2,0,2.0,2
14698226,Old Stoics,Old Sennockians,0,2,2.0,2
14686768,Old Cholmeleians IV,Old Tonbridgians II,2,4,3.0,6
14698223,Old Amplefordians,Old Westminsters II,0,2,2.0,2
14702283,Old Reptonians,Old Millfieldians,3,0,2.0,3
14697855,Old Haberdashers,Haberdashers Aske School 1st XI,0,0,4.0,0
14687853,Lancing Old Boys,Lancing College 1st XI,4,1,2.0,5
14429877,Old Oundelians,Oundle School 1st XI,2,0,2.0,2
14626511,Old Etonians Vets,Old Foresters Vets,4,0,1.0,4
14626512,Old Bradfieldians Vets,Old Malvernians Vets,1,2,4.0,3
14257662,Old Etonians,Old Carthusians,1,1,4.0,2
14257676,KCS Old Boys,Old Tonbridgians,5,2,2.0,7
14275058,Old Westminsters,Old Bradfieldians,1,3,3.0,4
14275031,Old Marlburians,Old Chigwellians,3,3,5.0,6
14274991,Old Aldenhamians,Old Haileyburians,3,1,3.0,4
14275044,Old Wykehamists,Old Radleians,1,3,3.0,4
14273867,Old Carthusians II,Old Cholmeleians II,2,0,2.0,2
14260399,Old Aldenhamians II,Old Millfieldians,1,12,1.0,13
14273958,Old Bancroftians AFC,Old Merchant Taylors,2,1,4.0,3
14273785,Old Oundelians,Old Millhillians,1,2,4.0,3
14273862,Old Millhillians,Old Oundelians,2,1,4.0,3
14652958,Lancing Old Boys II,Old Chigwellians II,0,1,3.0,1
14653091,Old Etonians II,Old Berkhamstedians,0,2,2.0,2
14653032,Old Wellingtonians,Old King's Scholars,0,2,2.0,2
14686547,Old Ardinians,Old Rugbeians,3,3,5.0,6
14686548,Old Uppinghamians,Old Stoics,1,5,2.0,6
14637087,Polytechnic,Old Foresters,3,1,3.0,4
14664241,Old Alleynians AFC,Dulwich College 1st XI,2,3,4.0,5
14257684,Lancing Old Boys,Old Tonbridgians,2,2,5.0,4
14257690,Old Salopians,KCS Old Boys,5,3,4.0,8
14275016,Old Radleians,Old Bradfieldians,2,2,5.0,4
14275070,Old Aldenhamians,Old Wykehamists,3,1,3.0,4
14275056,Old Haileyburians,Old Marlburians,0,11,0.0,11
14273797,Old Haberdashers,Old Carthusians II,0,8,0.0,8
14273975,Old Wellingtonians,Old Cholmeleians II,3,2,4.0,5
14273906,Old King's Scholars,Old Etonians II,0,1,3.0,1
14260378,Old Citizens,Old Berkhamstedians,0,5,0.0,5
14260402,Old Epsomians,Old Brentwoods II,1,1,4.0,2
14273858,Old Brentwoods III,Old Eastbournians,0,1,3.0,1
14273954,Old Millhillians,Old Westminsters II,3,0,2.0,3
14273804,Old Tonbridgians II,Old Oundelians,2,2,5.0,4
14666936,Old Bancroftians AFC,Old Carthusians III,0,5,0.0,5
14653066,Old Foresters II,Old Millfieldians,3,4,4.0,7
14653476,Kings College Wimbledon II,Old Stoics,2,1,4.0,3
14605326,Queen Mary College Old Boys,Old Etonians,2,0,2.0,2
14120751,AFC Representative Team,Arthurian League Representative Team,0,2,2.0,2
14257660,Old Cholmeleians,Old Salopians,1,1,4.0,2
14274993,Old Malvernians,Old Haileyburians,1,5,2.0,6
14275013,Old Chigwellians,Old Wykehamists,1,0,3.0,1
14275037,Old Bradfieldians,Old Aldenhamians,1,1,4.0,2
14275038,Old Reptonians,Old Radleians,4,2,3.0,6
14273812,Old Carthusians II,Old Chigwellians II,0,0,4.0,0
14273842,Old Carthusians III,Old Wellingtonians,3,2,4.0,5
14260384,Old Salopians II,Old Berkhamstedians,1,5,2.0,6
14260347,Old Millfieldians,Old Harrovians II,8,1,0.0,9
14260379,Old Malvernians II,Old Brentwoods II,0,5,0.0,5
14273856,Old Sennockians,Old Chigwellians III,0,1,3.0,1
14273892,Old Cholmeleians III,Old Stoics,3,0,2.0,3
14273912,Old Cholmeleians IV,Old Merchant Taylors,2,2,5.0,4
14273789,Old Alleynians AFC,Old Tonbridgians II,1,2,4.0,3
14574049,Old Etonians,KCS Old Boys,4,1,2.0,5
14629207,Old Bancroftians AFC,Old Brentwoods III,3,0,2.0,3
14602665,Old Sennockians,Old Chigwellians III,0,1,3.0,1
14257678,Old Brentwoods,Old Foresters,2,5,2.0,7
14257695,Old Etonians,Old Salopians,2,1,4.0,3
14257686,Old Cholmeleians,Old Tonbridgians,1,2,4.0,3
14275052,Old Reptonians,Old Bradfieldians,4,3,4.0,7
14275067,Old Radleians,Old Wykehamists,4,2,3.0,6
14275050,Old Marlburians,Old Aldenhamians,3,0,2.0,3
14273822,Old Carthusians III,Old Etonians II,2,0,2.0,2
14260367,Old Citizens,Old Millfieldians,1,2,4.0,3
14260391,Old Brentwoods II,Old Salopians II,5,2,2.0,7
14273920,Old Oundelians,Old Alleynians AFC,1,5,2.0,6
14605265,Lancing Old Boys,Old Harrovians,4,1,2.0,5
14574048,Old Carthusians,Old Haileyburians,5,1,2.0,6
14602666,Old Chigwellians II,Old Epsomians,7,5,4.0,12
14602661,Old Cholmeleians II,Kings College Wimbledon II,1,5,2.0,6
14602663,Old Stoics,Old Aldenhamians II,1,1,4.0,2
14627488,Old Foresters II,Old Ardinians,7,2,0.0,9
14602664,Old Haberdashers,Old Berkhamstedians,0,3,2.0,3
14642166,Old Millhillians,Old Carthusians II,2,3,4.0,5
14605256,Old Harrovians II,Old Merchant Taylors,6,1,0.0,7
14602574,Old Wellingtonians,Old Eastbournians,2,1,4.0,3
14543651,Fulham Compton Old Boys,Old Malvernians,5,0,0.0,5
14257708,Old Etonians,Old Cholmeleians,1,1,4.0,2
14257691,Old Harrovians,Lancing Old Boys,0,1,3.0,1
14257669,Old Foresters,Old Salopians,1,1,4.0,2
14257710,Old Brentwoods,Old Tonbridgians,0,5,0.0,5
14275060,Old Aldenhamians,Old Malvernians,2,7,0.0,9
14274988,Old Marlburians,Old Radleians,3,3,5.0,6
14273981,Old Foresters II,Old Carthusians II,0,2,2.0,2
14260397,Old Harrovians II,Kings College Wimbledon II,1,2,4.0,3
14260403,Old Millfieldians,Old Citizens,2,0,2.0,2
14273900,Old Westminsters II,Old Oundelians,4,3,4.0,7
14574047,Old Westminsters,Old Reptonians,1,2,4.0,3
14605386,Old Tonbridgians II,Lancing Old Boys II,0,6,0.0,6
14602613,Old Malvernians II,Old Wykehamists II,0,3,2.0,3
14629383,Old Millhillians,Old Alleynians AFC,3,2,4.0,5
14602662,Old Brentwoods II,Old King's Scholars,2,2,5.0,4
14602573,Old Salopians II,Old Etonians II,1,6,0.0,7
14618607,Old Bancroftians AFC,UCL Academicals IV,0,2,2.0,2
14257700,Old Carthusians,Old Brentwoods,2,0,2.0,2
14257666,Lancing Old Boys,Old Etonians,2,1,4.0,3
14257697,Old Cholmeleians,Old Harrovians,1,2,4.0,3
14275073,Old Radleians,Old Aldenhamians,1,4,2.0,5
14275069,Old Marlburians,Old Reptonians,7,2,0.0,9
14275046,Old Chigwellians,Old Haileyburians,4,2,3.0,6
14273807,Old Carthusians III,Old Chigwellians II,1,0,3.0,1
14273908,Old Cholmeleians II,Old Haberdashers,4,4,6.0,8
14273901,Old Etonians II,Old Wellingtonians,0,1,3.0,1
14273855,Lancing Old Boys II,Old Carthusians II,1,2,4.0,3
14260351,Old Salopians II,Old Brentwoods II,0,0,4.0,0
14260364,Old Aldenhamians II,Old Harrovians II,0,2,2.0,2
14260390,Old Millfieldians,Old Malvernians II,5,1,2.0,6
14260363,Old Epsomians,Kings College Wimbledon II,1,2,4.0,3
14273971,Old Amplefordians,Old Chigwellians III,2,4,3.0,6
14273885,Old Cholmeleians III,Old Sennockians,2,5,2.0,7
14273917,Old Eastbournians,Old Stoics,4,3,4.0,7
14273955,Old Westminsters II,Old Alleynians AFC,0,3,2.0,3
14514931,Old Millhillians,Old Brentwoods IV,3,0,2.0,3
14514933,Old Bancroftians AFC,Old Cholmeleians IV,6,1,0.0,7
14591082,Old Foresters,NUFC Oilers,1,0,3.0,1
14257655,Old Salopians,Lancing Old Boys,0,3,2.0,3
14257694,Old Harrovians,Old Carthusians,1,10,0.0,11
14257657,KCS Old Boys,Old Cholmeleians,3,1,3.0,4
14275014,Old Chigwellians,Old Aldenhamians,2,0,2.0,2
14275047,Old Haileyburians,Old Bradfieldians,3,3,5.0,6
14275049,Old Reptonians,Old Westminsters,3,1,3.0,4
14275009,Old Radleians,Old Malvernians,1,4,2.0,5
14274987,Old Wykehamists,Old Marlburians,0,6,0.0,6
14273902,Old Wellingtonians,Lancing Old Boys II,1,1,4.0,2
14273964,Old Cholmeleians II,Old King's Scholars,0,0,4.0,0
14273792,Old Chigwellians II,Old Haberdashers,0,2,2.0,2
14260392,Old Malvernians II,Kings College Wimbledon II,1,3,3.0,4
14260358,Old Citizens,Old Aldenhamians II,5,1,2.0,6
14273806,Old Amplefordians,Old Wykehamists II,3,4,4.0,7
14273848,Old Eastbournians,Old Sennockians,1,3,3.0,4
14273916,Old Merchant Taylors,Old Harrovians III,2,3,4.0,5
14273814,Old Tonbridgians II,Old Millhillians,2,3,4.0,5
14514934,Old Kimboltonians,Old Oundelians,2,8,0.0,10
14478336,Old Meadonians,Old Carthusians II,2,1,4.0,3
14519502,Old Carthusians III,Hale End Athletic,2,2,5.0,4
14450871,Bealonians,Old Bancroftians AFC,0,5,0.0,5
14556294,Old Epsomians,Epsom College 1st XI,3,1,3.0,4
14475807,Old Salopians Vets,Old Tonbridgians Vets,3,0,2.0,3
14603100,Old Salopians Vets,Old Tonbridgians Vets,0,3,2.0,3
14257683,Old Harrovians,Old Salopians,2,3,4.0,5
14257653,KCS Old Boys,Old Carthusians,1,4,2.0,5
14257638,Old Tonbridgians,Old Cholmeleians,1,1,4.0,2
14275066,Old Haileyburians,Old Malvernians,1,1,4.0,2
14275000,Old Bradfieldians,Old Radleians,4,3,4.0,7
14275001,Old Aldenhamians,Old Marlburians,3,7,2.0,10
14273826,Old Cholmeleians II,Old Etonians II,2,3,4.0,5
14273956,Old King's Scholars,Old Foresters II,3,3,5.0,6
14273829,Old Haberdashers,Old Wellingtonians,1,2,4.0,3
14260359,Old Epsomians,Old Berkhamstedians,1,0,3.0,1
14260375,Old Salopians II,Old Harrovians II,2,1,4.0,3
14260353,Old Millfieldians,Kings College Wimbledon II,4,0,1.0,4
14273979,Old Cholmeleians III,Old Wykehamists II,2,2,5.0,4
14273893,Old Millhillians,Old Westminsters II,5,1,2.0,6
14436867,Lancing Old Boys,Old Wykehamists,9,0,0.0,9
14588601,Old Rugbeians,Old Tonbridgians II,0,1,3.0,1
14588600,Old Foresters III,Old Merchant Taylors,1,7,0.0,8
14593075,Winchmore Hill,Old Carthusians III,3,2,4.0,5
14573796,Old Salesians,Old Foresters,2,0,2.0,2
14510500,Old Etonians,Lea Valley,5,1,2.0,6
14510387,Old Brentwoods,Brentwood School 1st XI,1,2,4.0,3
14510386,Old Brentwoods II,Brentwood School 2nd XI,1,1,4.0,2
14510385,Old Brentwoods III,Brentwood School 3rd XI,1,2,4.0,3
14510384,Old Brentwoods IV,Brentwood School 4th XI,6,1,0.0,7
14257643,Lancing Old Boys,KCS Old Boys,3,1,3.0,4
14257727,Old Carthusians,Old Tonbridgians,6,1,0.0,7
14257663,Old Brentwoods,Old Cholmeleians,2,3,4.0,5
14275033,Old Westminsters,Old Aldenhamians,10,3,1.0,13
14260395,Old Brentwoods II,Old Harrovians II,0,4,1.0,4
14260377,Kings College Wimbledon II,Old Aldenhamians II,1,1,4.0,2
14273924,Old Brentwoods III,Old Wykehamists II,1,11,0.0,12
14514935,Old Ardinians,Old Merchant Taylors II,4,2,3.0,6
14478335,Old Carthusians III,Fulham Compton Old Boys,4,2,3.0,6
14257665,Old Harrovians,Old Brentwoods,2,8,0.0,10
14436856,Old Westminsters,Old Berkhamstedians,5,3,4.0,8
14436947,Old Etonians,Old Bradfieldians,2,1,4.0,3
14437388,Old Aldenhamians,Old Haileyburians,2,3,4.0,5
14303814,Old Carthusians Vets,Old Westminsters Vets,3,0,2.0,3
14257713,Old Salopians,Old Harrovians,1,0,3.0,1
14257664,Old Foresters,KCS Old Boys,4,3,4.0,7
14275061,Old Bradfieldians,Old Chigwellians,2,5,2.0,7
14275021,Old Haileyburians,Old Westminsters,2,0,2.0,2
14275011,Old Aldenhamians,Old Radleians,0,7,0.0,7
14273962,Old Wellingtonians,Old Chigwellians II,4,2,3.0,6
14273850,Old King's Scholars,Lancing Old Boys II,2,1,4.0,3
14260373,Old Brentwoods II,Old Citizens,2,3,4.0,5
14260376,Kings College Wimbledon II,Old Malvernians II,3,2,4.0,5
14260406,Old Aldenhamians II,Old Salopians II,0,4,1.0,4
14273952,Old Amplefordians,Old Sennockians,1,6,0.0,7
14437001,Old Brentwoods,Old Carthusians,1,7,0.0,8
14514932,Old Westminsters II,Old Foresters III,3,3,5.0,6
14514930,Old Tonbridgians II,Old Harrovians III,4,3,4.0,7
14519334,Old Strand Academicals,Old Malvernians,1,2,4.0,3
14376329,Old Cholmeleians,Old Suttonians,0,8,0.0,8
14303812,Lancing Old Boys Vets,Old Reptonians Vets,8,2,0.0,10
14397403,Old Harrovians Vets,Old Brentwoods Vets,3,7,2.0,10
14257704,Old Carthusians,Old Etonians,1,1,4.0,2
14257652,Old Tonbridgians,Lancing Old Boys,5,2,2.0,7
14275027,Old Radleians,Old Westminsters,5,3,4.0,8
14273840,Old Haberdashers,Old Chigwellians II,3,3,5.0,6
14273876,Lancing Old Boys II,Old Carthusians III,2,3,4.0,5
14273859,Old Foresters II,Old Etonians II,0,2,2.0,2
14273845,Old Wellingtonians,Old Carthusians II,0,1,3.0,1
14260369,Old Salopians II,Old Citizens,2,1,4.0,3
14260370,Old Malvernians II,Old Epsomians,5,7,4.0,12
14260371,Old Berkhamstedians,Old Harrovians II,8,3,0.0,11
14260382,Old Brentwoods II,Kings College Wimbledon II,0,2,2.0,2
14350727,Old Eastbournians,Old Amplefordians,1,0,3.0,1
14273968,Old Sennockians,Old Wykehamists II,5,0,0.0,5
14273953,Old Chigwellians III,Old Stoics,0,1,3.0,1
14273880,Old Westminsters II,Old Alleynians AFC,3,5,4.0,8
14273936,Old Millhillians,Old Tonbridgians II,3,0,2.0,3
14436950,Old Marlburians,Old Reptonians,0,2,2.0,2
14437576,Old Chigwellians,Old Harrovians,1,2,4.0,3
14436868,KCS Old Boys,Old King's Scholars,7,1,0.0,8
14492036,Old Bancroftians AFC,Old Buckwellians,0,5,0.0,5
14345986,Old Hamptonians,Old Cholmeleians II,2,1,4.0,3
14455567,Latymer Old Boys,Old Foresters,1,4,2.0,5
14455566,Old Brentwoods,UCL Academicals,0,3,2.0,3
14412570,Old Wilsonians,Old Brentwoods III,5,1,2.0,6
14342559,Arthurian League Representative Team,Royal Navy Development XI,3,2,4.0,5
14303809,Old Wykehamists Vets,Old Chigwellians Vets,0,1,3.0,1
14257711,Old Brentwoods,KCS Old Boys,0,1,3.0,1
14257679,Old Carthusians,Old Salopians,2,1,4.0,3
14257720,Old Harrovians,Old Tonbridgians,0,1,3.0,1
14275064,Old Wykehamists,Old Westminsters,2,2,5.0,4
14275029,Old Reptonians,Old Chigwellians,2,3,4.0,5
14273823,Old Foresters II,Old Carthusians III,3,3,5.0,6
14273904,Old Chigwellians II,Old Carthusians II,0,4,1.0,4
14273813,Old Haberdashers,Old Etonians II,2,2,5.0,4
14260385,Old Harrovians II,Old Citizens,1,6,0.0,7
14260330,Old Epsomians,Old Millfieldians,2,3,4.0,5
14260366,Old Salopians II,Old Malvernians II,3,2,4.0,5
14273877,Old Eastbournians,Old Chigwellians III,3,1,3.0,4
14273986,Old Brentwoods III,Old Stoics,3,2,4.0,5
14273949,Old Foresters III,Old Cholmeleians IV,3,1,3.0,4
14345978,Winchmore Hill,Old Aldenhamians,3,0,2.0,3
14460046,Polytechnic,Old Cholmeleians,3,1,3.0,4
14460045,Norsemen,Old Foresters,1,6,0.0,7
14257674,Old Cholmeleians,Lancing Old Boys,2,1,4.0,3
14257707,Old Foresters,Old Carthusians,1,3,3.0,4
14257647,Old Brentwoods,Old Harrovians,1,5,2.0,6
14275022,Old Bradfieldians,Old Malvernians,2,3,4.0,5
14275043,Old Reptonians,Old Marlburians,4,1,2.0,5
14275071,Old Radleians,Old Haileyburians,2,7,0.0,9
14273838,Lancing Old Boys II,Old Wellingtonians,2,3,4.0,5
14273910,Old Cholmeleians II,Old Foresters II,2,3,4.0,5
14260383,Old Malvernians II,Old Aldenhamians II,1,2,4.0,3
14260327,Old Salopians II,Kings College Wimbledon II,4,1,2.0,5
14260389,Old Epsomians,Old Harrovians II,4,5,5.0,9
14273897,Old Cholmeleians III,Old Eastbournians,2,2,5.0,4
14273849,Old Chigwellians III,Old Wykehamists II,0,0,4.0,0
14273865,Old Sennockians,Old Amplefordians,4,1,2.0,5
14273888,Old Merchant Taylors,Old Bancroftians AFC,2,4,3.0,6
14273957,Old Foresters III,Old Harrovians III,3,2,4.0,5
14431045,Old Carthusians II,Fulham Compton Old Boys,0,1,3.0,1
14431029,Nottsborough FC,Old Aldenhamians,3,2,4.0,5
14005866,Old Etonians,Old Pauline,5,0,0.0,5
14303787,Old Salopians Vets,Old Aldenhamians Vets,4,2,3.0,6
14257702,Lancing Old Boys,Old Foresters,1,3,3.0,4
14257709,KCS Old Boys,Old Salopians,2,0,2.0,2
14275065,Old Aldenhamians,Old Bradfieldians,5,2,2.0,7
14275010,Old Westminsters,Old Marlburians,0,4,1.0,4
14275036,Old Malvernians,Old Reptonians,3,4,4.0,7
14273974,Old Foresters II,Lancing Old Boys II,1,2,4.0,3
14273918,Old King's Scholars,Old Wellingtonians,0,2,2.0,2
14260354,Old Brentwoods II,Old Aldenhamians II,3,0,2.0,3
14260356,Old Citizens,Old Malvernians II,2,0,2.0,2
14273841,Old Bancroftians AFC,Old Cholmeleians IV,6,2,2.0,8
14273869,Old Brentwoods IV,Old Foresters III,2,2,5.0,4
14273816,Old Oundelians,Old Westminsters II,7,6,5.0,13
14402428,Nottsborough FC,Old Carthusians III,1,3,3.0,4
14005852,Old Cholmeleians II,Egbertian FC,1,4,2.0,5
14005851,Old Isleworthians II,Old Carthusians II,3,7,2.0,10
14397012,Old Aloysians,Old Brentwoods,3,2,4.0,5
14287990,Old Harrovians,Harrow School 1st XI,6,1,0.0,7
14287989,Old Harrovians II,Harrow School 2nd XI,1,0,3.0,1
14376587,Old Etonians,Eton College 1st XI,1,2,4.0,3
14376589,Old Etonians II,Eton College 2nd XI,3,7,2.0,10
14294342,Old Etonians Vets,Eton College 3rd XI,3,5,4.0,8
14257699,Old Tonbridgians,KCS Old Boys,2,3,4.0,5
14257726,Old Etonians,Old Harrovians,0,0,4.0,0
14275045,Old Wykehamists,Old Aldenhamians,4,2,3.0,6
14275007,Old Marlburians,Old Bradfieldians,3,0,2.0,3
14275008,Old Reptonians,Old Haileyburians,2,3,4.0,5
14273913,Old Chigwellians II,Old Wellingtonians,1,1,4.0,2
14273973,Lancing Old Boys II,Old Haberdashers,0,0,4.0,0
14273836,Old Foresters II,Old King's Scholars,4,4,6.0,8
14273852,Old Etonians II,Old Cholmeleians II,0,2,2.0,2
14273834,Old Carthusians II,Old Carthusians III,1,1,4.0,2
14260349,Old Millfieldians,Old Aldenhamians II,3,0,2.0,3
14260350,Old Harrovians II,Old Berkhamstedians,1,3,3.0,4
14260352,Old Citizens,Old Epsomians,0,1,3.0,1
14273820,Old Cholmeleians III,Old Chigwellians III,2,2,5.0,4
14273909,Old Sennockians,Old Eastbournians,2,1,4.0,3
14273978,Old Amplefordians,Old Stoics,3,2,4.0,5
14273818,Old Brentwoods IV,Old Bancroftians AFC,2,0,2.0,2
14273989,Old Cholmeleians IV,Old Harrovians III,4,3,4.0,7
14273832,Old Millhillians,Old Alleynians AFC,2,4,3.0,6
14376470,Richmond & Kew SAL,Lancing Old Boys,2,0,2.0,2
14376233,Old Brentwoods,Mayfield,6,3,3.0,9
14376283,Old Foresters,Norsemen,7,1,0.0,8
14146096,Old Chigwellians,Old Finchleians,2,3,4.0,5
14376232,Old Cholmeleians,Old Wilsonians,1,3,3.0,4
14146092,NUFC Oilers,Old Salopians,2,0,2.0,2
14275063,Old Bradfieldians,Old Haileyburians,1,0,3.0,1
14275006,Old Reptonians,Old Wykehamists,4,1,2.0,5
14273982,Old Cholmeleians II,Old Chigwellians II,4,2,3.0,6
14273882,Old Carthusians II,Old Etonians II,1,0,3.0,1
14273868,Old Carthusians III,Old Foresters II,2,1,4.0,3
14260345,Old Salopians II,Old Aldenhamians II,2,0,2.0,2
14260405,Old Brentwoods II,Old Millfieldians,0,4,1.0,4
14260404,Old Malvernians II,Old Harrovians II,0,5,0.0,5
14260346,Kings College Wimbledon II,Old Citizens,3,5,4.0,8
14273831,Old Stoics,Old Wykehamists II,2,5,2.0,7
14273839,Old Chigwellians III,Old Amplefordians,1,1,4.0,2
14273911,Old Harrovians III,Old Foresters III,5,3,4.0,8
14273828,Old Alleynians AFC,Old Tonbridgians II,3,3,5.0,6
13920072,Old Bancroftians AFC,Old Berkhamstedians,1,5,2.0,6
13920079,Old Salopians,Old Carthusians,2,3,4.0,5
13920070,Old King's Scholars,Old Epsomians,4,3,4.0,7
13920071,Old Aldenhamians,Old Tonbridgians,2,1,4.0,3
13920076,Old Malvernians,Old Marlburians,2,4,3.0,6
13920074,Old Etonians,Old Radleians,6,0,0.0,6
13920073,Old Chigwellians,Old Wellingtonians,3,1,3.0,4
13920078,Old Eastbournians,KCS Old Boys,1,7,0.0,8
13920082,Lancing Old Boys,Old Sennockians,6,1,0.0,7
14146015,Old Foresters,Enfield Old Grammarians,2,1,4.0,3
14303813,Old Etonians Vets,Old Kimboltonians Vets,6,1,0.0,7
14257650,Old Carthusians,Lancing Old Boys,1,1,4.0,2
14257651,Old Etonians,Old Brentwoods,1,1,4.0,2
14257698,Old Tonbridgians,Old Salopians,4,0,1.0,4
14257703,Old Harrovians,KCS Old Boys,3,1,3.0,4
14275004,Old Westminsters,Old Haileyburians,1,2,4.0,3
14275005,Old Radleians,Old Reptonians,1,4,2.0,5
14275042,Old Chigwellians,Old Malvernians,4,0,1.0,4
14273944,Old Wellingtonians,Old Etonians II,0,5,0.0,5
14273890,Lancing Old Boys II,Old King's Scholars,3,2,4.0,5
14273950,Old Foresters II,Old Haberdashers,2,1,4.0,3
14273947,Old Chigwellians II,Old Carthusians III,1,6,0.0,7
14260344,Old Millfieldians,Old Salopians II,4,0,1.0,4
14260340,Old Malvernians II,Old Berkhamstedians,2,5,2.0,7
14260343,Old Harrovians II,Old Aldenhamians II,3,0,2.0,3
14260342,Kings College Wimbledon II,Old Epsomians,3,3,5.0,6
14273905,Old Stoics,Old Chigwellians III,1,1,4.0,2
14292573,Old Amplefordians,Old Brentwoods III,0,1,3.0,1
14273824,Old Sennockians,Old Cholmeleians III,3,4,4.0,7
14273907,Old Cholmeleians IV,Old Foresters III,0,1,3.0,1
14273988,Old Merchant Taylors,Old Brentwoods IV,4,2,3.0,6
14273886,Old Millhillians,Old Tonbridgians II,7,1,0.0,8
14273843,Old Oundelians,Old Alleynians AFC,3,2,4.0,5
13920077,Old Wykehamists,Old Foresters,2,1,4.0,3
13920080,Old Bradfieldians,Old Kimboltonians,3,1,3.0,4
14362006,Southgate County,Old Aldenhamians,0,5,0.0,5
14350697,Old Garchonians,Old Carthusians II,0,1,3.0,1
14350698,Old Cholmeleians II,Old Sedcopians,1,2,4.0,3
14350690,Hale End Athletic,Old Cholmeleians,0,3,2.0,3
14371093,Old Eastbournians,Mayfield,1,2,4.0,3
14371099,UCL Academicals V,Old Bancroftians AFC,0,1,3.0,1
14303788,Old Malvernians Vets,Old Brentwoods Vets,0,1,3.0,1
14257656,Old Tonbridgians,Old Carthusians,0,4,1.0,4
14257705,Old Etonians,Old Foresters,0,2,2.0,2
14257649,Lancing Old Boys,Old Salopians,4,1,2.0,5
14257648,KCS Old Boys,Old Brentwoods,2,3,4.0,5
14275068,Old Malvernians,Old Bradfieldians,4,4,6.0,8
14275034,Old Haileyburians,Old Chigwellians,1,2,4.0,3
14275035,Old Radleians,Old Marlburians,1,0,3.0,1
14273928,Old Chigwellians II,Old Etonians II,1,3,3.0,4
14273946,Old Cholmeleians II,Lancing Old Boys II,4,4,6.0,8
14273884,Old Wellingtonians,Old Haberdashers,5,2,2.0,7
14273854,Old Carthusians II,Old Foresters II,0,1,3.0,1
14260388,Old Aldenhamians II,Old Citizens,3,2,4.0,5
14260337,Old Salopians II,Old Epsomians,1,2,4.0,3
14260339,Old Berkhamstedians,Old Millfieldians,2,1,4.0,3
14273819,Old Stoics,Old Brentwoods III,3,1,3.0,4
14273983,Old Eastbournians,Old Cholmeleians III,7,6,5.0,13
14273891,Old Chigwellians III,Old Sennockians,1,5,2.0,6
14273821,Old Harrovians III,Old Cholmeleians IV,2,2,5.0,4
14273878,Old Foresters III,Old Merchant Taylors,3,3,5.0,6
14273919,Old Alleynians AFC,Old Westminsters II,6,3,3.0,9
14273930,Old Oundelians,Old Tonbridgians II,4,1,2.0,5
13920081,Old Cholmeleians,Old Harrovians,2,3,4.0,5
14361524,Old Actonians Association FC,Old Carthusians III,1,4,2.0,5
14361514,Kings College Wimbledon II,Old Salesians,1,2,4.0,3
14005856,Old Westminsters,Old Isleworthians,4,1,2.0,5
14005854,Old Reptonians,Sinjun Grammarians,3,4,4.0,7
14005789,Old Meadonians,Old Brentwoods II,5,3,4.0,8
13919337,Old Amplefordians,Ampleforth College 1st XI,4,2,3.0,6
13919264,Old Wykehamists,Winchester College 1st XI,8,0,0.0,8
13919263,Old Wykehamists II,Winchester College 2nd XI,5,1,2.0,6
14328610,Arthurian League Representative Team,Oxford University Football Club,2,3,4.0,5
14257717,Old Foresters,Old Brentwoods,2,0,2.0,2
14257671,Old Salopians,Old Cholmeleians,1,2,4.0,3
14257646,KCS Old Boys,Old Etonians,6,2,2.0,8
14257706,Old Tonbridgians,Old Harrovians,5,3,4.0,8
14275026,Old Wykehamists,Old Bradfieldians,2,1,4.0,3
14274999,Old Chigwellians,Old Marlburians,0,3,2.0,3
14275075,Old Westminsters,Old Reptonians,1,2,4.0,3
14275062,Old Haileyburians,Old Radleians,4,3,4.0,7
14273970,Old Foresters II,Old Chigwellians II,1,2,4.0,3
14273873,Old Carthusians III,Old Cholmeleians II,1,3,3.0,4
14273870,Old King's Scholars,Old Haberdashers,5,2,2.0,7
14273985,Lancing Old Boys II,Old Etonians II,2,1,4.0,3
14273805,Old Carthusians II,Old Wellingtonians,2,1,4.0,3
14260401,Old Aldenhamians II,Old Berkhamstedians,0,5,0.0,5
14260332,Old Malvernians II,Old Citizens,2,1,4.0,3
14260334,Kings College Wimbledon II,Old Millfieldians,1,3,3.0,4
14260335,Old Harrovians II,Old Salopians II,1,1,4.0,2
14273811,Old Cholmeleians III,Old Brentwoods III,5,1,2.0,6
14273923,Old Chigwellians III,Old Eastbournians,1,3,3.0,4
14273945,Old Wykehamists II,Old Stoics,3,4,4.0,7
14065937,Old Dorkinians,Lancing Old Boys,2,3,4.0,5
14065938,Old Wilsonians,Old Carthusians,2,2,5.0,4
14290476,Old Cholmeleians IV,Old Millhillians,4,3,4.0,7
14290479,Old Harrovians III,Old Oundelians,2,3,4.0,5
14290478,Old Brentwoods IV,Old Westminsters II,1,5,2.0,6
14290477,Old Bancroftians AFC,Old Tonbridgians II,2,2,5.0,4
14290475,Old Foresters III,Old Alleynians AFC,0,8,0.0,8
14005855,Old Malvernians,Old Tiffinians,5,2,2.0,7
14005853,Old Aldenhamians,Wandsworth Borough,0,4,1.0,4
14257721,Old Salopians,Old Foresters,0,6,0.0,6
14257645,Old Etonians,Old Tonbridgians,1,2,4.0,3
14257644,Old Brentwoods,Old Carthusians,2,0,2.0,2
14257722,Lancing Old Boys,Old Harrovians,6,1,0.0,7
14257692,Old Cholmeleians,KCS Old Boys,0,2,2.0,2
14275072,Old Westminsters,Old Malvernians,1,2,4.0,3
14274998,Old Wykehamists,Old Reptonians,6,5,5.0,11
14274997,Old Marlburians,Old Haileyburians,4,2,3.0,6
14273937,Old Etonians II,Old Carthusians II,2,1,4.0,3
14273808,Old King's Scholars,Old Cholmeleians II,1,1,4.0,2
14273914,Old Carthusians III,Lancing Old Boys II,2,2,5.0,4
14273875,Old Foresters II,Old Wellingtonians,0,0,4.0,0
14260328,Old Brentwoods II,Old Berkhamstedians,1,4,2.0,5
14260361,Old Malvernians II,Old Millfieldians,3,3,5.0,6
14260381,Old Epsomians,Old Salopians II,1,1,4.0,2
14273963,Old Stoics,Old Cholmeleians III,1,0,3.0,1
14273887,Old Wykehamists II,Old Amplefordians,2,3,4.0,5
14273959,Old Brentwoods III,Old Sennockians,0,3,2.0,3
14273844,Old Harrovians III,Old Brentwoods IV,2,4,3.0,6
14273872,Old Tonbridgians II,Old Alleynians AFC,0,5,0.0,5
14005988,Old Crosbeians,Old Aldenhamians II,0,3,2.0,3
14025745,Old Bancroftians AFC,Egbertian FC,3,2,4.0,5
14005872,Fulham Compton Old Boys,Old Eastbournians,3,4,4.0,7
14257654,Old Foresters,Old Tonbridgians,1,1,4.0,2
14257718,Old Carthusians,Old Cholmeleians,3,1,3.0,4
14257661,KCS Old Boys,Lancing Old Boys,1,1,4.0,2
14274995,Old Westminsters,Old Radleians,3,1,3.0,4
14275002,Old Chigwellians,Old Reptonians,4,2,3.0,6
14274996,Old Bradfieldians,Old Wykehamists,0,2,2.0,2
14274994,Old Marlburians,Old Malvernians,1,1,4.0,2
14273801,Old Foresters II,Old Cholmeleians II,3,7,2.0,10
14273922,Lancing Old Boys II,Old Chigwellians II,2,2,5.0,4
14273860,Old Wellingtonians,Old King's Scholars,2,1,4.0,3
14260387,Old Berkhamstedians,Kings College Wimbledon II,0,1,3.0,1
14260324,Old Millfieldians,Old Brentwoods II,0,6,0.0,6
14260325,Old Citizens,Old Harrovians II,3,3,5.0,6
14260326,Old Malvernians II,Old Salopians II,0,6,0.0,6
14273835,Old Stoics,Old Eastbournians,2,3,4.0,5
14273851,Old Brentwoods III,Old Chigwellians III,1,2,4.0,3
14273894,Old Foresters III,Old Brentwoods IV,0,0,4.0,0
14273899,Old Bancroftians AFC,Old Harrovians III,2,2,5.0,4
14273803,Old Alleynians AFC,Old Millhillians,5,3,4.0,8
14273837,Old Westminsters II,Old Oundelians,4,3,4.0,7
14106074,Old Hamptonians,Old Aldenhamians,1,2,4.0,3
14106073,Bank of England,Old Haberdashers,1,0,3.0,1
14005985,Old Carthusians III,John Fisher Old Boys,4,1,2.0,5
14005993,Oakhill Tigers,Old Cholmeleians III,8,1,0.0,9
14257688,Old Carthusians,Old Foresters,2,2,5.0,4
14257670,Lancing Old Boys,Old Brentwoods,5,2,2.0,7
14257667,Old Cholmeleians,Old Etonians,1,5,2.0,6
14275040,Old Reptonians,Old Aldenhamians,1,7,0.0,8
14275018,Old Radleians,Old Chigwellians,0,6,0.0,6
14275003,Old Malvernians,Old Westminsters,0,3,2.0,3
14275059,Old Wykehamists,Old Haileyburians,2,4,3.0,6
14274986,Old Bradfieldians,Old Marlburians,1,4,2.0,5
14273967,Old Etonians II,Old Foresters II,4,2,3.0,6
14273931,Old Haberdashers,Lancing Old Boys II,0,1,3.0,1
14273926,Old Cholmeleians II,Old Carthusians II,1,1,4.0,2
14273798,Old King's Scholars,Old Chigwellians II,0,0,4.0,0
14260348,Old Brentwoods II,Old Malvernians II,3,0,2.0,3
14260333,Old Berkhamstedians,Old Epsomians,4,2,3.0,6
14273795,Old Cholmeleians III,Old Amplefordians,2,4,3.0,6
14273796,Old Eastbournians,Old Brentwoods III,2,1,4.0,3
14273800,Old Wykehamists II,Old Sennockians,4,4,6.0,8
14273932,Old Foresters III,Old Bancroftians AFC,2,1,4.0,3
14273943,Old Merchant Taylors,Old Cholmeleians IV,4,1,2.0,5
14273788,Old Westminsters II,Old Tonbridgians II,1,4,2.0,5
14107546,Bealonians,Old Aldenhamians II,6,2,2.0,8
14107547,Merton,Old Carthusians III,2,4,3.0,6
14298599,Kings College Wimbledon II,Old Lyonians,9,3,0.0,12
13975698,Old Salopians,Shrewsbury School 1st XI,0,0,4.0,0
13975697,Old Salopians II,Shrewsbury School 2nd XI,2,5,2.0,7
14257639,Old Carthusians,KCS Old Boys,2,1,4.0,3
14257640,Old Foresters,Old Harrovians,8,1,0.0,9
14257641,Old Salopians,Old Tonbridgians,2,1,4.0,3
14274990,Old Chigwellians,Old Bradfieldians,3,2,4.0,5
14275023,Old Haileyburians,Old Reptonians,1,2,4.0,3
14274989,Old Aldenhamians,Old Westminsters,1,3,3.0,4
14275025,Old Marlburians,Old Wykehamists,5,1,2.0,6
14273941,Old Haberdashers,Old Carthusians III,1,5,2.0,6
14260317,Old Berkhamstedians,Old Aldenhamians II,1,0,3.0,1
14260318,Old Epsomians,Old Citizens,6,1,0.0,7
14260319,Kings College Wimbledon II,Old Harrovians II,2,3,4.0,5
14273948,Old Wykehamists II,Old Cholmeleians III,3,2,4.0,5
14273791,Old Amplefordians,Old Eastbournians,3,1,3.0,4
14273874,Old Sennockians,Old Stoics,2,1,4.0,3
14273799,Old Harrovians III,Old Merchant Taylors,1,1,4.0,2
14273793,Old Westminsters II,Old Millhillians,1,2,4.0,3
14273794,Old Alleynians AFC,Old Oundelians,2,1,4.0,3
14106066,Old Foresters II,Broomfield FC,7,7,6.0,14
14106067,Parkfield,Old Cholmeleians II,0,11,0.0,11
14106065,Old Isleworthians,Old Millfieldians,5,3,4.0,8
14106068,Old Woodhouseians,Old Salopians II,5,1,2.0,6
14216872,Old Carthusians II,Royal Bank of Scotland,3,3,5.0,6
14240980,Old Bancroftians AFC,St. James' Old Boys,2,5,2.0,7
14284233,Old Brentwoods II,UCL Academicals II,0,4,1.0,4
13919437,Old Etonians II,Old Etonians,0,3,2.0,3
13971835,Old Brentwoods,Brentwood School 1st XI,1,1,4.0,2
13971834,Old Brentwoods II,Brentwood School 2nd XI,2,5,2.0,7
13971833,Old Brentwoods III,Brentwood School 3rd XI,1,7,0.0,8
13971832,Old Brentwoods IV,Brentwood School 4th XI,0,0,4.0,0
13919339,Lancing Old Boys,Lancing College 1st XI,5,2,2.0,7
13919338,Lancing Old Boys II,Lancing College 2nd XI,3,1,3.0,4
13920686,TBC,Old Malvernians,1,2,4.0,3
13919255,TBC,Old Malvernians II,5,0,0.0,5
14273699,Old Foresters,Old Carthusians,1,2,4.0,3
14273607,Lancing Old Boys,Old Carthusians,0,2,2.0,2
14273608,Old Foresters II,Old Foresters,0,1,3.0,1
14266008,Old Aldenhamians,Lancing Old Boys,0,2,2.0,2
14265983,Old Reptonians,Old Carthusians,1,2,4.0,3
14265988,Old Marlburians,Old Carthusians,0,2,2.0,2
14266004,Old King's Scholars,Old Foresters,1,0,3.0,1
14266006,Old Aldenhamians,Old Foresters,0,1,3.0,1
14265987,Old Foresters II,Old Harrovians,1,0,3.0,1
14265993,Old Marlburians,Old Harrovians,1,0,3.0,1
14265990,Old Foresters II,Old Reptonians,2,1,4.0,3
14266001,Old King's Scholars,Lancing Old Boys,1,2,4.0,3
14265961,Old Harrovians,Old Carthusians,0,2,2.0,2
14265979,Old Foresters II,Old Carthusians,0,1,3.0,1
14265998,Lancing Old Boys,Old Foresters,1,3,3.0,4
14265980,Old Reptonians,Old Harrovians,4,0,1.0,4
14265999,Old Aldenhamians,Old King's Scholars,2,2,5.0,4
14265982,Old Foresters II,Old Marlburians,0,0,4.0,0
14265968,Old Marlburians,Old Reptonians,0,0,4.0,0
14273704,Old Reptonians,Old King's Scholars,2,0,2.0,2
13919342,Old Millfieldians,Old Berkhamstedians,0,0,4.0,0
13977320,Steuerman Select Work XI,Old Westminsters II,1,2,4.0,3
13975245,KCS Old Boys,Old Malvernians,5,0,0.0,5
13919344,Old Chigwellians III,Old Brentwoods III,0,0,4.0,0
13919184,Old Etonians,Eton College 1st XI,3,3,5.0,6
13975244,Old Epsomians,Old Malvernians,2,6,2.0,8
13975695,Old Tonbridgians,Old Oundelians,4,1,2.0,5
14249668,Old Carthusians,Nottsborough FC,4,3,4.0,7
14249681,Old Carthusians III,Nottsborough FC III,1,1,4.0,2
13975243,KCS Old Boys,Old Tiffinians,9,1,0.0,10
13975241,KCS Old Boys,Montpellier Villa FC,1,1,4.0,2
13975239,Dulwich College 1st XI,Old Alleynians AFC,2,3,4.0,5
13975256,Old Marlburians,Old Carthusians II,3,1,3.0,4
13975240,Old Citizens,Old Malvernians,0,1,3.0,1
13919370,Old Cholmeleians II,Old Merchant Taylors,0,4,1.0,4
14121337,Old Pauline,Kings College Wimbledon II,0,3,2.0,3
13977319,Shene FC,Old Westminsters,4,4,6.0,8
14211716,Old Millhillians,Old Aldenhamians,3,4,4.0,7
13919369,Old Chigwellians,Old Cholmeleians,2,1,4.0,3
13919345,Old Bancroftians AFC,Old Chigwellians III,2,2,5.0,4
13919390,Old Carthusians,Old Owens,2,4,3.0,6
13975242,KCS Old Boys,Old Bradfieldians,1,1,4.0,2
13975694,Old Parkonians,Old Chigwellians,4,1,2.0,5
14254580,Old Chigwellians Vets,Old Chigwellians III,1,0,3.0,1
13977273,New College Old Boys,Old Westminsters,1,6,0.0,7
13977272,Old Sennockians,Old Westminsters II,6,0,0.0,6
13990294,Lancing Old Boys,Corinthian-Casuals,1,2,4.0,3
13975246,Parklife FC,Old Alleynians AFC,2,2,5.0,4
14052140,FC Brotherhood,Old Cholmeleians,1,1,4.0,2
13975250,Old Cholmeleians II,Old Aldenhamians II,2,4,3.0,6
13919343,Northchurch Baptist Church FC,Old Berkhamstedians,2,4,3.0,6
13975679,Old Brentwoods,Old Chigwellians,1,2,4.0,3
13975252,Old Reptonians,Old Millfieldians,1,1,4.0,2
13928126,Old Cholmeleians,Old Owens,1,5,2.0,6
16056608,Old Berkhamstedians,Old Suttonians SV,8,3,0.0,11
15312581,Old Westminsters,Old Carthusians III,0,0,4.0,0
15299945,Old Tonbridgians,Old Cholmeleians,4,3,4.0,7
15312594,Old Carthusians III,Old Millfieldians,7,1,0.0,8
15315305,Old Cholmeleians III,Old Alleynians AFC,1,10,0.0,11
15869583,Old Merchant Taylors,Old Bancroftians AFC,1,0,3.0,1
15299986,Old Salopians,Old Cholmeleians,2,2,5.0,4
15304615,Old Aldenhamians,Old Bradfieldians,3,2,4.0,5
15304631,Old Brentwoods,Old Wellingtonians,3,1,3.0,4
15304642,Old Wellingtonians,Old Brentwoods,0,1,3.0,1
15312617,Old Millfieldians,Old Carthusians III,3,4,4.0,7
15816861,Old Bancroftians AFC,Old Tonbridgians II,1,2,4.0,3
15299991,Old Cholmeleians,Old Tonbridgians,2,3,4.0,5
15300022,Old Foresters,Old Salopians,3,3,5.0,6
15299937,Lancing Old Boys,Old Chigwellians,3,3,5.0,6
15315321,Old Stoics,Old Millhillians,2,7,0.0,9
15315311,Old Aldenhamians II,Old Alleynians AFC,0,0,4.0,0
15743090,Old Carthusians III,Old Salvatorians,3,1,3.0,4
15299944,Old Foresters,KCS Old Boys,2,2,5.0,4
15304605,Old Harrovians,Old Brentwoods,0,2,2.0,2
15312613,Old Chigwellians II,Old Millfieldians,0,7,0.0,7
15315323,Old Cholmeleians III,Old Wykehamists II,3,9,0.0,12
15315360,Old Cholmeleians IV,Old Brentwoods III,2,4,3.0,6
15315441,Old Amplefordians,Old Westminsters II,3,0,2.0,3
15839289,Old Tonbridgians,Old Salopians,1,0,3.0,1
15816750,Old Carthusians III,Lancing Old Boys II,4,1,2.0,5
15853891,Old Alleynians AFC,Old Merchant Taylors,1,2,4.0,3
15846001,Old Harrovians Vets,Old Brentwoods Vets,2,0,2.0,2
15849309,Old Westminsters Vets,Old Bradfieldians Vets,1,0,3.0,1
15299952,Old Etonians,Lancing Old Boys,2,2,5.0,4
15299994,Old Tonbridgians,Old Marlburians,5,2,2.0,7
15304637,Old Aldenhamians,Old Brentwoods,0,8,0.0,8
15304621,Old Haileyburians,Old Reptonians,0,7,0.0,7
15304643,Old Radleians,Old Harrovians,4,3,4.0,7
15312625,Old Westminsters,Old Carthusians II,1,4,2.0,5
15312568,Old Foresters II,Old Millfieldians,6,7,5.0,13
15314170,Old Haberdashers,Old Salopians II,3,3,5.0,6
15315341,Old Stoics,Old Wykehamists II,6,2,2.0,8
15839055,Old Millhillians,Old Merchant Taylors,2,4,3.0,6
15846329,Old Tonbridgians II,Old Alleynians AFC,0,1,3.0,1
15818606,Old Chigwellians Vets,Old Bradfieldians Vets,1,5,2.0,6
15299989,Old Foresters,Old Marlburians,2,0,2.0,2
15299974,Old Etonians,Old Salopians,3,2,4.0,5
15299996,Lancing Old Boys,KCS Old Boys,0,2,2.0,2
15304650,Old Brentwoods,Old Bradfieldians,6,1,0.0,7
15304656,Old Wellingtonians,Old Haileyburians,6,2,2.0,8
15304648,Old Aldenhamians,Old Radleians,0,1,3.0,1
15304654,Old Reptonians,Old Wykehamists,4,1,2.0,5
15312603,Old Carthusians III,Old Etonians II,5,1,2.0,6
15314201,Old Eastbournians,Old Haberdashers,3,3,5.0,6
15816860,Old Tonbridgians II,Old Bancroftians AFC,0,2,2.0,2
15781719,Old Brentwoods Vets,Old Aldenhamians Vets,6,0,0.0,6
15299953,Old Marlburians,Old Chigwellians,1,2,4.0,3
15299984,Old Foresters,Old Carthusians,2,2,5.0,4
15304633,Old Malvernians,Old Aldenhamians,3,2,4.0,5
15304616,Old Brentwoods,Old Haileyburians,13,1,1.0,14
15304630,Old Harrovians,Old Radleians,2,2,5.0,4
15304622,Old Bradfieldians,Old Wellingtonians,0,2,2.0,2
15312552,Old Carthusians III,Old Foresters II,1,1,4.0,2
15312596,Old Foresters II,Old Carthusians III,1,2,4.0,3
15312573,Lancing Old Boys II,Old Etonians II,3,0,2.0,3
15312622,Old Carthusians II,Old Millfieldians,1,4,2.0,5
15312588,Old Westminsters,Old Chigwellians II,5,2,2.0,7
15314213,Kings College Wimbledon II,Old Haberdashers,8,2,0.0,10
15314184,Old Citizens,Old Sennockians,0,2,2.0,2
15315334,Old Chigwellians III,Old Wykehamists II,2,5,2.0,7
15315386,Old Brentwoods III,Old Foresters III,1,2,4.0,3
15315358,Old Cholmeleians IV,Old Merchant Taylors,0,6,0.0,6
15315433,Old Tonbridgians II,Old Oundelians,0,2,2.0,2
15315449,Old Westminsters II,Old Malvernians II,4,1,2.0,5
15755859,Old Tonbridgians,Old Reptonians,1,0,3.0,1
15755858,Old Salopians,Old Alleynians AFC,2,0,2.0,2
15816492,Old Millhillians,Kings College Wimbledon III,3,3,5.0,6
15786660,Old Harrovians Vets,Old Etonians Vets,1,0,3.0,1
15789426,Old Salopians Vets,Old Bradfieldians Vets,5,6,5.0,11
15795643,Old Malvernians Vets,Old Westminsters Vets,1,2,4.0,3
15476829,Old Stoics,Stowe School,3,1,3.0,4
15299964,Old Carthusians,Old Chigwellians,9,1,0.0,10
15300011,Old Salopians,Old Tonbridgians,1,5,2.0,6
15300002,Old Foresters,Old Etonians,3,2,4.0,5
15304636,Old Wykehamists,Old Reptonians,1,0,3.0,1
15304651,Old Radleians,Old Haileyburians,5,1,2.0,6
15312548,Old Etonians II,Old Chigwellians II,3,1,3.0,4
15312576,Old Carthusians II,Old Westminsters,2,2,5.0,4
15314176,Old Eastbournians,Old Citizens,2,0,2.0,2
15314196,Old Harrovians II,Old Salopians II,4,0,1.0,4
15314160,Old Sennockians,Kings College Wimbledon II,1,1,4.0,2
15315373,Old Harrovians III,Old Foresters III,1,1,4.0,2
15780022,Lancing Old Boys II,Old Millfieldians,6,4,4.0,10
15779846,Old Carthusians III,Old Berkhamstedians,4,2,3.0,6
15789819,Old Rugbeians,Old Millhillians,2,3,4.0,5
15778753,Old Westminsters II,Old Alleynians AFC,2,3,4.0,5
15804510,Old Amplefordians,Old Tonbridgians II,1,3,3.0,4
15797886,Old Aldenhamians,Hampstead Heathens,2,1,4.0,3
15787769,Old Bradfieldians,Bradfield College,3,1,3.0,4
15787772,Old Epsomians,Epsom College 1st XI,1,1,4.0,2
15771102,Old Haberdashers,Haberdashers Aske School 1st XI,3,3,5.0,6
15586506,Old Cholmeleians,Highgate School 1st XI,1,2,4.0,3
15586504,Old Cholmeleians III,Highgate School 3rd XI,1,1,4.0,2
15800278,Old Foresters II,Forest School 1st XI,2,5,2.0,7
15300003,Old Cholmeleians,Lancing Old Boys,1,1,4.0,2
15299993,Old Chigwellians,Old Foresters,0,3,2.0,3
15300014,Old Etonians,Old Marlburians,0,2,2.0,2
15299995,KCS Old Boys,Old Salopians,3,4,4.0,7
15300023,Old Carthusians,Old Tonbridgians,3,2,4.0,5
15304634,Old Radleians,Old Bradfieldians,3,6,3.0,9
15304602,Old Haileyburians,Old Aldenhamians,1,10,0.0,11
15304600,Old Harrovians,Old Malvernians,4,1,2.0,5
15312624,Old Carthusians III,Old Berkhamstedians,0,3,2.0,3
15312578,Old Berkhamstedians,Old Carthusians III,0,0,4.0,0
15312612,Old Carthusians II,Old Foresters II,1,2,4.0,3
15312600,Old Millfieldians,Lancing Old Boys II,2,2,5.0,4
15314177,Old Harrovians II,Old Epsomians,1,4,2.0,5
15784577,Old Cholmeleians III,Old Harrovians III,3,1,3.0,4
15793776,Old Aldenhamians II,Old Merchant Taylors,0,1,3.0,1
15764210,Old Stoics,Old Amplefordians,2,2,5.0,4
15789418,Old Cholmeleians IV,Old Tonbridgians II,0,10,0.0,10
15764439,Old Bancroftians AFC,Kings College Wimbledon III,1,4,2.0,5
15776297,Old Westminsters,Westminster School 1st XI,1,1,4.0,2
15787770,Old Westminsters II,Westminster School 2nd XI,2,0,2.0,2
15314195,Old Sennockians,Old Brentwoods II,2,2,5.0,4
15762515,Old Sennockians,Sevenoaks School 1st XI,0,2,2.0,2
15300020,Old Tonbridgians,Old Foresters,2,1,4.0,3
15299990,Lancing Old Boys,Old Salopians,2,1,4.0,3
15300012,Old Chigwellians,Old Carthusians,1,1,4.0,2
15299950,Old Cholmeleians,Old Marlburians,4,1,2.0,5
15300024,Old Etonians,KCS Old Boys,2,0,2.0,2
15304667,Old Reptonians,Old Wellingtonians,0,0,4.0,0
15304647,Old Haileyburians,Old Harrovians,1,10,0.0,11
15304669,Old Brentwoods,Old Aldenhamians,11,1,0.0,12
15312619,Old Etonians II,Old Carthusians III,0,5,0.0,5
15312621,Lancing Old Boys II,Old Foresters II,3,0,2.0,3
15315330,Old Alleynians AFC,Old Wykehamists II,2,3,4.0,5
15315310,Old Aldenhamians II,Old Stoics,2,2,5.0,4
15315445,Old Tonbridgians II,Old Amplefordians,2,3,4.0,5
15315424,Old Malvernians II,Old Westminsters II,1,2,4.0,3
15746347,Old Chigwellians III,Old Merchant Taylors,1,3,3.0,4
15484527,Old Oundelians,Oundle School 1st XI,4,4,6.0,8
15314185,Kings College Wimbledon II,Old Brentwoods II,0,5,0.0,5
15694712,Arthurian League Representative Team,Lloyds of London Representative Team,2,2,5.0,4
15666583,Lancing Old Boys Vets,Old Brentwoods Vets,1,1,4.0,2
15675163,Old Chigwellians Vets,Old Reptonians Vets,6,4,4.0,10
15391319,Old Haileyburians,Haileybury College,2,0,2.0,2
15299967,Old Foresters,Lancing Old Boys,3,1,3.0,4
15299997,Old Salopians,Old Chigwellians,3,1,3.0,4
15300025,Old Tonbridgians,Old Etonians,1,0,3.0,1
15300000,Old Cholmeleians,KCS Old Boys,0,4,1.0,4
15304644,Old Aldenhamians,Old Wykehamists,1,4,2.0,5
15304629,Old Reptonians,Old Malvernians,1,3,3.0,4
15312597,Lancing Old Boys II,Old Chigwellians II,2,1,4.0,3
15312628,Old Carthusians II,Old Carthusians III,1,3,3.0,4
15314216,Old Harrovians II,Old Eastbournians,2,1,4.0,3
15314214,Old Salopians II,Old Sennockians,3,1,3.0,4
15314193,Old Epsomians,Old Citizens,3,1,3.0,4
15315337,Old Chigwellians III,Old Cholmeleians III,2,1,4.0,3
15315377,Old Bancroftians AFC,Old Merchant Taylors,4,1,2.0,5
15315446,Old Rugbeians,Old Malvernians II,7,3,2.0,10
15764173,Old Millfieldians,Old Alleynians AFC,3,2,4.0,5
15764448,Old Berkhamstedians,Old Stoics,4,1,2.0,5
15664517,Old Westminsters Vets,Old Wykehamists Vets,8,1,0.0,9
15299992,Lancing Old Boys,Old Cholmeleians,0,1,3.0,1
15299959,Old Etonians,Old Foresters,1,0,3.0,1
15299941,KCS Old Boys,Old Marlburians,1,1,4.0,2
15304609,Old Radleians,Old Aldenhamians,0,3,2.0,3
15304677,Old Brentwoods,Old Reptonians,10,0,0.0,10
15304626,Old Wykehamists,Old Harrovians,1,8,0.0,9
15304676,Old Haileyburians,Old Wellingtonians,0,10,0.0,10
15312591,Old Westminsters,Old Berkhamstedians,1,6,0.0,7
15314154,Old Haberdashers,Old Eastbournians,2,3,4.0,5
15314169,Old Sennockians,Old Epsomians,1,5,2.0,6
15315314,Old Chigwellians III,Old Alleynians AFC,0,2,2.0,2
15315421,Old Westminsters II,Old Rugbeians,3,1,3.0,4
15315426,Old Malvernians II,Old Oundelians,1,2,4.0,3
15719459,Old Stoics,Old Merchant Taylors,2,1,4.0,3
15745846,Lancing Old Boys II,Old Harrovians II,4,0,1.0,4
15719430,Old Etonians II,Old Millfieldians,2,4,3.0,6
15733641,Old Foresters II,Old Carthusians III,4,5,5.0,9
15746294,Kings College Wimbledon III,Old Wykehamists II,4,3,4.0,7
15746296,Old Amplefordians,Old Foresters III,1,0,3.0,1
15706355,NUFC Oilers,Old Carthusians II,3,2,4.0,5
15314191,Old Brentwoods II,Old Citizens,1,6,0.0,7
15656447,Old Etonians Vets,Old Tonbridgians Vets,1,1,4.0,2
15299988,Old Carthusians,Old Etonians,2,1,4.0,3
15300016,Old Chigwellians,KCS Old Boys,3,4,4.0,7
15300015,Old Cholmeleians,Old Salopians,0,6,0.0,6
15304598,Old Wykehamists,Old Aldenhamians,2,2,5.0,4
15304590,Old Haileyburians,Old Brentwoods,1,3,3.0,4
15304670,Old Bradfieldians,Old Harrovians,3,0,2.0,3
15304672,Old Malvernians,Old Wellingtonians,6,3,3.0,9
15312554,Lancing Old Boys II,Old Carthusians III,1,0,3.0,1
15312577,Old Foresters II,Old Carthusians II,2,3,4.0,5
15312563,Old Millfieldians,Old Etonians II,1,1,4.0,2
15314190,Old Salopians II,Old Harrovians II,0,2,2.0,2
15314207,Old Haberdashers,Old Sennockians,0,3,2.0,3
15315343,Old Millhillians,Old Wykehamists II,6,1,0.0,7
15315317,Old Aldenhamians II,Old Chigwellians III,1,0,3.0,1
15315333,Old Cholmeleians III,Old Stoics,1,1,4.0,2
15315366,Old Harrovians III,Old Merchant Taylors,1,1,4.0,2
15315380,Old Brentwoods III,Old Cholmeleians IV,4,5,5.0,9
15315434,Old Malvernians II,Old Rugbeians,2,1,4.0,3
15315429,Old Oundelians,Old Westminsters II,2,1,4.0,3
15656205,Old Tonbridgians,Old Radleians,4,1,2.0,5
15702393,Lancing Old Boys,Old Alleynians AFC,2,3,4.0,5
15702471,Old Brentwoods II,Old Berkhamstedians,2,3,4.0,5
15740457,Old Barryians,Old Wykehamists,1,0,3.0,1
15300013,KCS Old Boys,Old Foresters,1,2,4.0,3
15299936,Old Cholmeleians,Old Carthusians,2,2,5.0,4
15299985,Old Etonians,Old Chigwellians,0,2,2.0,2
15299943,Lancing Old Boys,Old Tonbridgians,1,1,4.0,2
15304674,Old Malvernians,Old Bradfieldians,3,3,5.0,6
15304668,Old Brentwoods,Old Wykehamists,3,2,4.0,5
15304671,Old Radleians,Old Reptonians,3,0,2.0,3
15304628,Old Aldenhamians,Old Haileyburians,2,2,5.0,4
15312561,Old Carthusians III,Old Westminsters,3,2,4.0,5
15312606,Old Chigwellians II,Old Berkhamstedians,1,3,3.0,4
15312592,Old Carthusians II,Old Etonians II,2,2,5.0,4
15314179,Old Haberdashers,Old Epsomians,0,6,0.0,6
15315304,Old Wykehamists II,Old Cholmeleians III,4,2,3.0,6
15656204,Old Salopians,Old Harrovians,2,1,4.0,3
15719455,Old Alleynians AFC,Old Tonbridgians II,3,2,4.0,5
15702532,Old Citizens,Old Foresters II,3,5,4.0,8
15719456,Old Westminsters,Old Carthusians III,2,3,4.0,5
15702472,Lancing Old Boys II,Old Sennockians,2,0,2.0,2
15314181,Old Eastbournians,Old Brentwoods II,1,2,4.0,3
15596043,SAL Representative Team,Arthurian League Representative Team,2,2,5.0,4
15611402,Old Radleians,Radley College 1st XI,4,1,2.0,5
15300009,Old Foresters,Old Chigwellians,3,1,3.0,4
15299968,Old Salopians,Old Carthusians,1,3,3.0,4
15299969,KCS Old Boys,Old Cholmeleians,4,1,2.0,5
15304661,Old Bradfieldians,Old Reptonians,0,1,3.0,1
15304673,Old Haileyburians,Old Wykehamists,1,7,0.0,8
15304613,Old Brentwoods,Old Malvernians,5,1,2.0,6
15304653,Old Harrovians,Old Wellingtonians,2,0,2.0,2
15312615,Old Foresters II,Old Berkhamstedians,1,3,3.0,4
15314163,Old Eastbournians,Old Harrovians II,3,3,5.0,6
15315344,Old Aldenhamians II,Old Wykehamists II,3,3,5.0,6
15315381,Old Bancroftians AFC,Old Foresters III,4,0,1.0,4
15315420,Old Amplefordians,Old Oundelians,0,9,0.0,9
15664992,Old Merchant Taylors,Kings College Wimbledon II,1,0,3.0,1
15664881,Old Cholmeleians II,Old Carthusians III,0,5,0.0,5
15664999,Old Etonians II,Old Salopians II,3,1,3.0,4
15682349,Old Carthusians II,Old Tonbridgians II,4,4,6.0,8
15664839,Old Strand Academicals,Old Aldenhamians,2,3,4.0,5
15716314,Kings College Wimbledon III,Old Alleynians AFC,4,1,2.0,5
15404277,Old Harrovians Vets,Old Malvernians Vets,4,3,4.0,7
15300004,Old Tonbridgians,Old Chigwellians,5,1,2.0,6
15300018,Old Marlburians,Old Cholmeleians,1,0,3.0,1
15304610,Old Harrovians,Old Bradfieldians,5,0,0.0,5
15304678,Old Wellingtonians,Old Wykehamists,2,1,4.0,3
15304666,Old Malvernians,Old Radleians,2,1,4.0,3
15312604,Old Westminsters,Old Foresters II,1,1,4.0,2
15312583,Old Chigwellians II,Old Etonians II,2,2,5.0,4
15314178,Old Salopians II,Old Eastbournians,2,2,5.0,4
15315331,Old Aldenhamians II,Old Millhillians,2,0,2.0,2
15315376,Old Cholmeleians IV,Old Harrovians III,0,6,0.0,6
15315368,Old Merchant Taylors,Old Foresters III,2,2,5.0,4
15315439,Old Tonbridgians II,Old Malvernians II,4,2,3.0,6
15550535,Old Foresters,Lancing Old Boys,2,3,4.0,5
15656203,Old Reptonians,Old Haileyburians,1,0,3.0,1
15664943,Old Citizens,Old King's Scholars,5,0,0.0,5
15665039,Old Brentwoods II,Old Wellingburians,8,0,0.0,8
15664874,Old Haberdashers,Old Oundelians,4,5,5.0,9
15664944,Old Stoics,Old Epsomians,3,2,4.0,5
15664996,Old Amplefordians,Old Millfieldians,1,10,0.0,11
15665000,Old Brentwoods III,Old Sennockians,0,5,0.0,5
15683664,Old Westminsters II,Old Harrovians II,2,2,5.0,4
15653171,Old Owens,Old Carthusians II,0,2,2.0,2
15654405,Old Carthusians III,Old Whitgiftians,3,0,2.0,3
15699116,Old Alleynians AFC,Kings College Wimbledon III,5,3,4.0,8
15300001,Old Salopians,Lancing Old Boys,5,0,0.0,5
15300007,Old Carthusians,KCS Old Boys,2,0,2.0,2
15299999,Old Etonians,Old Tonbridgians,1,2,4.0,3
15299973,Old Chigwellians,Old Marlburians,1,2,4.0,3
15304664,Old Bradfieldians,Old Aldenhamians,1,0,3.0,1
15304675,Old Harrovians,Old Reptonians,0,0,4.0,0
15304660,Old Haileyburians,Old Malvernians,2,1,4.0,3
15304618,Old Radleians,Old Wellingtonians,3,3,5.0,6
15312595,Old Millfieldians,Old Carthusians II,3,3,5.0,6
15314208,Old Sennockians,Old Citizens,0,4,1.0,4
15314183,Kings College Wimbledon II,Old Salopians II,4,3,4.0,7
15315320,Old Aldenhamians II,Old Cholmeleians III,1,0,3.0,1
15315313,Old Millhillians,Old Stoics,1,3,3.0,4
15664961,Old Chigwellians III,Old Berkhamstedians,1,8,0.0,9
15665327,Old Foresters II,Old Wykehamists II,4,4,6.0,8
15664883,Old Eastbournians,Old Westminsters,1,5,2.0,6
15664998,Old Chigwellians II,Lancing Old Boys II,1,3,3.0,4
15593994,Old Foresters III,Old Westminsters II,1,4,2.0,5
15598150,Old Garchonians,Old Brentwoods,4,1,2.0,5
15598147,Old Hamptonians,Old Foresters,4,3,4.0,7
15605918,Old Merchant Taylors,East Barnet Old Grammarians,1,1,4.0,2
15314215,Old Haberdashers,Old Brentwoods II,2,4,3.0,6
15312611,Old Carthusians III,Old Cholmeleians II,3,0,2.0,3
15681055,Old Bancroftians AFC,Kings College Wimbledon III,1,3,3.0,4
15492116,Old Brentwoods Vets,Old Chigwellians Vets,2,0,2.0,2
15299998,Old Carthusians,Old Marlburians,6,0,0.0,6
15304649,Old Malvernians,Old Reptonians,0,3,2.0,3
15312601,Old Carthusians II,Old Berkhamstedians,4,3,4.0,7
15312629,Old Etonians II,Old Westminsters,2,4,3.0,6
15314171,Kings College Wimbledon II,Old Eastbournians,1,1,4.0,2
15314156,Old Sennockians,Old Harrovians II,3,4,4.0,7
15315328,Old Cholmeleians III,Old Millhillians,3,5,4.0,8
15315325,Old Alleynians AFC,Old Stoics,8,1,0.0,9
15315365,Old Bancroftians AFC,Old Harrovians III,5,2,2.0,7
15315436,Old Amplefordians,Old Tonbridgians II,0,0,4.0,0
15593993,Old Rugbeians,Old Wykehamists II,1,5,2.0,6
15594002,Old Aldenhamians II,Old Wellingburians,4,4,6.0,8
15598166,KCS Old Boys,Honourable Artillery Company,1,4,2.0,5
15654246,Old Aldenhamians,Southgate County,2,0,2.0,2
15378375,Old Brentwoods II,Brentwood School 2nd XI,3,4,4.0,7
15378374,Old Brentwoods III,Brentwood School 3rd XI,2,2,5.0,4
15646853,Old Chigwellians II,Old Parmiterians,0,0,4.0,0
15392443,KCS Old Boys,KCS Wimbledon 1st XI,5,1,2.0,6
15392442,Kings College Wimbledon II,KCS Wimbledon 2nd XI,6,1,0.0,7
15312570,Old Carthusians III,Old Carthusians II,6,2,2.0,8
15509114,Old Carthusians Vets,Old Foresters Vets,2,4,3.0,6
15304640,Old Radleians,Old Wykehamists,3,2,4.0,5
15304638,Old Bradfieldians,Old Malvernians,2,2,5.0,4
15557306,London Welsh F.C.,Old Carthusians III,0,6,0.0,6
15312541,Old Cholmeleians II,Old Carthusians II,1,8,0.0,9
15404275,Lancing Old Boys Vets,Old Bradfieldians Vets,5,0,0.0,5
15300010,Old Etonians,Old Cholmeleians,3,2,4.0,5
15300005,Old Carthusians,Old Foresters,0,3,2.0,3
15304665,Old Harrovians,Old Haileyburians,1,0,3.0,1
15312614,Old Westminsters,Lancing Old Boys II,1,8,0.0,9
15312593,Old Chigwellians II,Old Foresters II,0,0,4.0,0
15314175,Old Eastbournians,Old Salopians II,3,2,4.0,5
15550538,Old Reptonians,Old Bradfieldians,4,3,4.0,7
15550536,Old Brentwoods,Old Salopians,1,2,4.0,3
15550532,Old Chigwellians,Old Alleynians AFC,2,3,4.0,5
15550533,KCS Old Boys,Old Radleians,1,2,4.0,3
15550534,Old Millfieldians,Old Tonbridgians,1,5,2.0,6
15593999,Old Merchant Taylors,Old Cholmeleians III,3,1,3.0,4
15593996,Old Bancroftians AFC,Old Oundelians,2,5,2.0,7
15593991,Old Amplefordians,Kings College Wimbledon III,2,1,4.0,3
15557289,Old Carthusians II,Old Minchendenians,3,2,4.0,5
15585826,Old Carthusians III,Old Kingsburians,2,2,5.0,4
15073175,Old Wellingtonians,Wellington College 1st XI,1,1,4.0,2
15593726,Old Aldenhamians,Aldenham School 1st XI,0,1,3.0,1
15593725,Old Aldenhamians II,Aldenham School 2nd XI,0,1,3.0,1
15312618,Old Cholmeleians II,Old Etonians II,0,1,3.0,1
15460818,Royal Navy Development XI,Arthurian League Representative Team,1,4,2.0,5
15300008,Old Marlburians,Lancing Old Boys,6,1,0.0,7
15300019,Old Salopians,Old Etonians,0,0,4.0,0
15304658,Old Wykehamists,Old Radleians,1,6,0.0,7
15304645,Old Wellingtonians,Old Bradfieldians,1,4,2.0,5
15312575,Old Berkhamstedians,Old Millfieldians,3,3,5.0,6
15312607,Old Etonians II,Old Carthusians II,1,3,3.0,4
15312585,Old Foresters II,Lancing Old Boys II,0,1,3.0,1
15314194,Kings College Wimbledon II,Old Harrovians II,4,3,4.0,7
15314161,Old Epsomians,Old Eastbournians,3,0,2.0,3
15314172,Old Sennockians,Old Salopians II,3,0,2.0,3
15315335,Old Cholmeleians III,Old Aldenhamians II,0,2,2.0,2
15550537,Old Cholmeleians,Old Haileyburians,2,3,4.0,5
15550531,Old Harrovians,Old Westminsters,3,1,3.0,4
15529745,Old Foresters,Broomfield FC,6,1,0.0,7
15529743,Old Pauline,Old Brentwoods,0,2,2.0,2
15529744,Old Parmiterians,KCS Old Boys,1,3,3.0,4
15483833,Old Strand Academicals,Old Aldenhamians,3,1,3.0,4
15550644,Old Chigwellians,Chigwell School 1st XI,0,0,4.0,0
15550643,Old Chigwellians II,Chigwell School 2nd XI,0,0,4.0,0
15550642,Old Chigwellians III,Chigwell School 3rd XI,3,3,5.0,6
15312587,Old Cholmeleians II,Old Carthusians III,2,2,5.0,4
15581684,Old Alleynians AFC,Old Tonbridgians II,0,2,2.0,2
15299980,Old Cholmeleians,Old Chigwellians,2,4,3.0,6
15299982,Old Salopians,Old Foresters,0,2,2.0,2
15299979,Lancing Old Boys,Old Carthusians,1,3,3.0,4
15299978,Old Tonbridgians,KCS Old Boys,2,1,4.0,3
15304663,Old Harrovians,Old Wykehamists,2,1,4.0,3
15304625,Old Bradfieldians,Old Haileyburians,7,3,2.0,10
15304627,Old Radleians,Old Malvernians,2,2,5.0,4
15304624,Old Reptonians,Old Brentwoods,2,2,5.0,4
15304662,Old Aldenhamians,Old Wellingtonians,3,6,3.0,9
15312572,Old Westminsters,Old Etonians II,3,2,4.0,5
15312584,Old Millfieldians,Old Foresters II,3,1,3.0,4
15312605,Old Carthusians III,Lancing Old Boys II,0,2,2.0,2
15312586,Old Berkhamstedians,Old Carthusians II,3,2,4.0,5
15314210,Kings College Wimbledon II,Old Citizens,0,2,2.0,2
15314209,Old Salopians II,Old Haberdashers,1,1,4.0,2
15314217,Old Epsomians,Old Sennockians,2,1,4.0,3
15315324,Old Millhillians,Old Aldenhamians II,2,4,3.0,6
15315326,Old Wykehamists II,Old Stoics,0,3,2.0,3
15315430,Old Malvernians II,Old Amplefordians,0,0,4.0,0
15315444,Old Tonbridgians II,Old Westminsters II,2,0,2.0,2
15509442,Old Etonians,Old Parmiterians,1,3,3.0,4
15314168,Old Brentwoods II,Old Eastbournians,4,1,2.0,5
15299972,Old Foresters,Old Cholmeleians,4,0,1.0,4
15299977,Old Tonbridgians,Old Salopians,2,2,5.0,4
15299975,KCS Old Boys,Lancing Old Boys,1,2,4.0,3
15299976,Old Marlburians,Old Carthusians,1,3,3.0,4
15304619,Old Aldenhamians,Old Harrovians,1,2,4.0,3
15304623,Old Malvernians,Old Wykehamists,1,4,2.0,5
15304641,Old Haileyburians,Old Bradfieldians,1,6,0.0,7
15304620,Old Brentwoods,Old Radleians,6,3,3.0,9
15312579,Lancing Old Boys II,Old Millfieldians,1,2,4.0,3
15312623,Old Chigwellians II,Old Westminsters,0,5,0.0,5
15314187,Old Haberdashers,Old Harrovians II,2,1,4.0,3
15314166,Old Sennockians,Old Eastbournians,3,2,4.0,5
15314147,Old Epsomians,Old Salopians II,5,5,6.0,10
15315385,Old Harrovians III,Old Bancroftians AFC,0,1,3.0,1
15367007,Old Foresters III,Old Cholmeleians IV,1,1,4.0,2
15315363,Old Brentwoods III,Old Merchant Taylors,1,4,2.0,5
15544236,Old Parmiterians,Old Carthusians II,2,4,3.0,6
15483830,Old Cholmeleians III,Weirside Rangers,0,4,1.0,4
15509552,Economicals,Old Carthusians III,1,2,4.0,3
15509620,Old Aldenhamians II,Oakhill Tigers,0,7,0.0,7
15143206,Old Etonians,Eton College 1st XI,1,2,4.0,3
15143205,Old Etonians II,Eton College 2nd XI,1,2,4.0,3
15314165,Old Citizens,Old Brentwoods II,1,3,3.0,4
15551727,Old Rugbeians,Kings College Wimbledon III,4,3,4.0,7
15404281,Old Tonbridgians Vets,Old Wykehamists Vets,3,0,2.0,3
15299970,Old Tonbridgians,Lancing Old Boys,1,1,4.0,2
15299971,KCS Old Boys,Old Carthusians,2,4,3.0,6
15300006,Old Salopians,Old Marlburians,6,1,0.0,7
15304646,Old Wykehamists,Old Brentwoods,3,7,2.0,10
15312589,Old Etonians II,Old Millfieldians,1,4,2.0,5
15312580,Old Berkhamstedians,Lancing Old Boys II,0,3,2.0,3
15314164,Old Haberdashers,Kings College Wimbledon II,1,3,3.0,4
15315322,Old Chigwellians III,Old Aldenhamians II,5,0,0.0,5
15315336,Old Stoics,Old Alleynians AFC,1,6,0.0,7
15315374,Old Cholmeleians IV,Old Bancroftians AFC,0,10,0.0,10
15315440,Old Rugbeians,Old Tonbridgians II,0,4,1.0,4
15315442,Old Amplefordians,Old Malvernians II,4,1,2.0,5
15249270,Old Haileyburians,Old Eastbournians,4,0,1.0,4
15429421,Old Radleians,Old Merchant Taylors,4,3,4.0,7
15249273,Old Chigwellians,Old Etonians,3,2,4.0,5
15487275,Queen Mary College Old Boys,Old Brentwoods III,5,5,6.0,10
15483832,Polytechnic 3s,Old Carthusians III,1,3,3.0,4
15483831,Hale End Athletic,Old Westminsters II,7,1,0.0,8
15509443,Old Cholmeleians,Fulham Compton Old Boys,0,3,2.0,3
15445249,Old Aldenhamians,Old Malvernians,2,0,2.0,2
15445250,Old Carthusians II,Old Hamptonians,4,5,5.0,9
15513385,Old Harrovians,Harrow School 1st XI,4,2,3.0,6
15513384,Old Harrovians II,Harrow School 2nd XI,3,1,3.0,4
15538999,Old Foresters,Chingford Athletic,5,0,0.0,5
15312574,Old Cholmeleians II,Old Foresters II,2,8,0.0,10
15314198,Old Brentwoods II,Old Salopians II,2,0,2.0,2
15300021,Lancing Old Boys,Old Etonians,2,0,2.0,2
15304597,Old Wykehamists,Old Wellingtonians,3,4,4.0,7
15304652,Old Aldenhamians,Old Malvernians,1,4,2.0,5
15304614,Old Reptonians,Old Radleians,1,3,3.0,4
15312610,Lancing Old Boys II,Old Berkhamstedians,1,1,4.0,2
15312627,Old Foresters II,Old Etonians II,1,2,4.0,3
15312616,Old Chigwellians II,Old Carthusians II,0,1,3.0,1
15314157,Old Harrovians II,Old Citizens,3,8,0.0,11
15314146,Old Epsomians,Kings College Wimbledon II,1,1,4.0,2
15315303,Old Stoics,Old Aldenhamians II,1,1,4.0,2
15315312,Old Cholmeleians III,Old Chigwellians III,0,1,3.0,1
15315370,Old Harrovians III,Old Brentwoods III,2,1,4.0,3
15315369,Old Foresters III,Old Bancroftians AFC,0,2,2.0,2
15315438,Old Rugbeians,Old Amplefordians,2,3,4.0,5
15249279,Old Bradfieldians,Old Haberdashers,2,1,4.0,3
15425848,Old Sennockians,Old Alleynians AFC,0,5,0.0,5
15249277,Old Marlburians,Old Harrovians,0,4,1.0,4
15509152,KCS Old Boys,Old Blues,4,0,1.0,4
15430486,Old Suttonians,Old Brentwoods,3,3,5.0,6
15430489,Nottsborough FC,Old Carthusians,2,1,4.0,3
15430490,Old Wilsonians,Old Chigwellians,2,1,4.0,3
15445304,Broomfield FC,Old Salopians,4,2,3.0,6
15445306,Old Foresters,Old Wokingians,2,1,4.0,3
15478798,Old Merchant Taylors,Old Wilsonians,3,0,2.0,3
15460826,Arthurian League Representative Team,AFC Representative Team,3,2,4.0,5
15438559,Old Aldenhamians,Old Millfieldians,0,5,0.0,5
15404258,Old Reptonians Vets,Old Carthusians Vets,1,3,3.0,4
15299965,KCS Old Boys,Old Etonians,0,1,3.0,1
15312566,Old Carthusians III,Old Chigwellians II,3,1,3.0,4
15312565,Old Carthusians II,Lancing Old Boys II,4,0,1.0,4
15314158,Old Sennockians,Old Haberdashers,3,0,2.0,3
15314199,Old Citizens,Kings College Wimbledon II,0,2,2.0,2
15315339,Old Chigwellians III,Old Millhillians,1,3,3.0,4
15315378,Old Brentwoods III,Old Bancroftians AFC,0,4,1.0,4
15315383,Old Cholmeleians IV,Old Foresters III,1,8,0.0,9
15315447,Old Westminsters II,Old Oundelians,1,6,0.0,7
15249278,Old Brentwoods,Old Berkhamstedians,4,3,4.0,7
15249280,Old Salopians,Old Malvernians,3,1,3.0,4
15249268,Old Wykehamists,Old Westminsters,1,2,4.0,3
15249272,Lancing Old Boys,Old King's Scholars,9,0,0.0,9
15249276,Old Epsomians,Old Tonbridgians,1,5,2.0,6
15498109,Old Parkonians,Old Foresters,4,3,4.0,7
15479125,Old Cholmeleians,Park View,4,3,4.0,7
15312567,Old Etonians II,Old Cholmeleians II,8,2,0.0,10
15314159,Old Brentwoods II,Old Harrovians II,2,6,2.0,8
15404257,Old Chigwellians Vets,Old Westminsters Vets,4,2,3.0,6
15299963,Old Marlburians,Old Tonbridgians,3,5,4.0,8
15299961,Old Chigwellians,Lancing Old Boys,1,2,4.0,3
15304632,Old Bradfieldians,Old Wykehamists,4,2,3.0,6
15304608,Old Aldenhamians,Old Reptonians,1,4,2.0,5
15304607,Old Haileyburians,Old Radleians,1,3,3.0,4
15304606,Old Wellingtonians,Old Malvernians,1,2,4.0,3
15304635,Old Brentwoods,Old Harrovians,1,2,4.0,3
15312564,Lancing Old Boys II,Old Westminsters,2,3,4.0,5
15312598,Old Berkhamstedians,Old Etonians II,3,1,3.0,4
15312555,Old Millfieldians,Old Chigwellians II,5,1,2.0,6
15314192,Old Epsomians,Old Haberdashers,5,2,2.0,7
15314180,Kings College Wimbledon II,Old Sennockians,0,2,2.0,2
15314174,Old Citizens,Old Harrovians II,2,2,5.0,4
15315340,Old Alleynians AFC,Old Chigwellians III,1,1,4.0,2
15315315,Old Millhillians,Old Cholmeleians III,3,1,3.0,4
15315375,Old Foresters III,Old Brentwoods III,4,3,4.0,7
15315371,Old Merchant Taylors,Old Cholmeleians IV,5,5,6.0,10
15315443,Old Oundelians,Old Rugbeians,5,4,5.0,9
15249269,Old Foresters,Old Carthusians,3,0,2.0,3
15251428,Old Salopians II,Alexandra Park FC,2,3,4.0,5
15251427,Old Carthusians II,Old Wokingians,2,0,2.0,2
15341655,Latymer Old Boys,Old Etonians,1,4,2.0,5
15445268,Old Carthusians III,Reigatians,3,0,2.0,3
15465267,Old Parmiterians,Old Bancroftians AFC,1,7,0.0,8
15299949,Lancing Old Boys,Old Foresters,1,2,4.0,3
15299958,Old Chigwellians,Old Cholmeleians,1,1,4.0,2
15299957,Old Tonbridgians,Old Carthusians,3,1,3.0,4
15299956,Old Salopians,KCS Old Boys,2,0,2.0,2
15299981,Old Marlburians,Old Etonians,0,5,0.0,5
15304639,Old Wellingtonians,Old Reptonians,2,1,4.0,3
15304603,Old Bradfieldians,Old Brentwoods,2,4,3.0,6
15304617,Old Malvernians,Old Harrovians,0,1,3.0,1
15312558,Old Carthusians II,Old Chigwellians II,1,0,3.0,1
15312559,Old Berkhamstedians,Old Foresters II,3,3,5.0,6
15312609,Old Millfieldians,Old Westminsters,2,2,5.0,4
15312557,Old Etonians II,Lancing Old Boys II,1,1,4.0,2
15314204,Old Citizens,Old Salopians II,1,1,4.0,2
15314189,Kings College Wimbledon II,Old Epsomians,1,1,4.0,2
15314203,Old Harrovians II,Old Sennockians,1,2,4.0,3
15315329,Old Chigwellians III,Old Stoics,3,1,3.0,4
15315357,Old Merchant Taylors,Old Harrovians III,6,0,0.0,6
15315427,Old Tonbridgians II,Old Rugbeians,5,2,2.0,7
15315435,Old Oundelians,Old Malvernians II,3,1,3.0,4
15381073,Somerville Old Boys,Old Bancroftians AFC,1,0,3.0,1
15381072,Old Aldenhamians,Old Pegasonians F.C.,3,2,4.0,5
15251440,Broomfield FC,Old Brentwoods III,5,5,6.0,10
15392433,Alleyn Old Boys,Old Cholmeleians III,1,2,4.0,3
15455197,Old Carthusians III,Old Owens,3,1,3.0,4
15392434,Old Aldenhamians II,Old Parmiterians,1,5,2.0,6
15251439,Egbertian FC,Old Westminsters II,0,1,3.0,1
15311965,Shene Old Grammarians,Old Eastbournians,4,1,2.0,5
15022399,Old Wykehamists,Winchester College 1st XI,4,2,3.0,6
15023804,Old Wykehamists II,Winchester College 2nd XI,3,1,3.0,4
15300017,Old Carthusians,Lancing Old Boys,2,1,4.0,3
15299987,KCS Old Boys,Old Chigwellians,4,4,6.0,8
15299962,Old Cholmeleians,Old Etonians,1,3,3.0,4
15304599,Old Reptonians,Old Haileyburians,1,0,3.0,1
15304601,Old Wellingtonians,Old Radleians,4,1,2.0,5
15312571,Old Foresters II,Old Chigwellians II,0,1,3.0,1
15312556,Old Berkhamstedians,Old Westminsters,3,6,3.0,9
15314206,Old Citizens,Old Epsomians,2,2,5.0,4
15314152,Old Harrovians II,Kings College Wimbledon II,1,2,4.0,3
15315308,Old Wykehamists II,Old Chigwellians III,1,1,4.0,2
15315342,Old Alleynians AFC,Old Millhillians,2,2,5.0,4
15315362,Old Bancroftians AFC,Old Cholmeleians IV,4,1,2.0,5
15315384,Old Brentwoods III,Old Harrovians III,1,2,4.0,3
15315448,Old Oundelians,Old Amplefordians,4,1,2.0,5
15315432,Old Westminsters II,Old Tonbridgians II,0,6,0.0,6
15160909,Albanian FC,Old Foresters,1,3,3.0,4
15160910,Old Salopians,Old Ignatians,2,2,5.0,4
15311157,Old Aldenhamians,Globe Rangers,3,1,3.0,4
15311932,Old Malvernians,Mickleham Old Boxhillians FC,4,4,6.0,8
15311933,Old Carthusians II,Enfield Old Grammarians,6,2,2.0,8
15311934,Old Cholmeleians II,Old Parmiterians,2,6,2.0,8
15311940,Heathrow Seniors,Old Carthusians III,0,5,0.0,5
15311958,Old Aldenhamians II,Old Challoners,2,0,2.0,2
15314153,Old Salopians II,Old Brentwoods II,2,2,5.0,4
15299940,Old Cholmeleians,Old Foresters,0,4,1.0,4
15299948,Old Etonians,Old Carthusians,2,2,5.0,4
15299951,Old Chigwellians,Old Tonbridgians,1,5,2.0,6
15299960,Lancing Old Boys,Old Marlburians,6,4,4.0,10
15304594,Old Harrovians,Old Aldenhamians,0,1,3.0,1
15304659,Old Radleians,Old Brentwoods,0,6,0.0,6
15304595,Old Reptonians,Old Bradfieldians,4,1,2.0,5
15304596,Old Malvernians,Old Haileyburians,1,2,4.0,3
15312550,Old Chigwellians II,Lancing Old Boys II,1,2,4.0,3
15312551,Old Etonians II,Old Berkhamstedians,1,1,4.0,2
15312553,Old Westminsters,Old Millfieldians,2,2,5.0,4
15314182,Old Haberdashers,Old Citizens,3,5,4.0,8
15314197,Old Epsomians,Old Harrovians II,2,4,3.0,6
15314151,Old Eastbournians,Kings College Wimbledon II,1,2,4.0,3
15315338,Old Wykehamists II,Old Aldenhamians II,4,1,2.0,5
15315319,Old Millhillians,Old Chigwellians III,6,4,4.0,10
15315309,Old Stoics,Old Cholmeleians III,1,3,3.0,4
15315361,Old Foresters III,Old Harrovians III,1,1,4.0,2
15315428,Old Malvernians II,Old Tonbridgians II,0,2,2.0,2
15249138,Old Amplefordians,Old Alleynians AFC,4,5,5.0,9
15249139,Old Bancroftians AFC,Old Merchant Taylors,1,2,4.0,3
15312700,Old Salopians,Shrewsbury School 1st XI,1,0,3.0,1
15312699,Old Salopians II,Shrewsbury School 2nd XI,3,4,4.0,7
15312582,Old Carthusians II,Old Cholmeleians II,0,1,3.0,1
15314205,Old Brentwoods II,Old Sennockians,1,2,4.0,3
15299947,Old Carthusians,Old Salopians,3,0,2.0,3
15299946,Old Chigwellians,Old Etonians,1,4,2.0,5
15299983,Old Marlburians,KCS Old Boys,1,2,4.0,3
15304589,Old Reptonians,Old Aldenhamians,4,2,3.0,6
15304592,Old Wykehamists,Old Malvernians,5,3,4.0,8
15304593,Old Bradfieldians,Old Radleians,0,1,3.0,1
15304591,Old Wellingtonians,Old Harrovians,0,3,2.0,3
15312547,Lancing Old Boys II,Old Carthusians II,0,3,2.0,3
15314186,Old Salopians II,Old Citizens,3,2,4.0,5
15314150,Old Eastbournians,Old Epsomians,1,1,4.0,2
15315307,Old Stoics,Old Chigwellians III,4,0,1.0,4
15315316,Old Wykehamists II,Old Alleynians AFC,0,5,0.0,5
15315359,Old Bancroftians AFC,Old Brentwoods III,2,0,2.0,2
15315379,Old Foresters III,Old Merchant Taylors,1,6,0.0,7
15315367,Old Harrovians III,Old Cholmeleians IV,5,1,2.0,6
15315431,Old Rugbeians,Old Oundelians,3,2,4.0,5
15315425,Old Westminsters II,Old Amplefordians,2,0,2.0,2
15345433,Old Foresters,Globe Rangers,8,3,0.0,11
15162920,Lancing Old Boys,Economicals,1,2,4.0,3
15251153,Old Foresters II,Old Garchonians,0,4,1.0,4
15163566,Old Actonians Association FC,Old Carthusians III,1,3,3.0,4
15341654,Old Cholmeleians,Oakhill Tigers,4,3,4.0,7
15311957,UCL Academicals IV,Old Millhillians,6,3,3.0,9
15054002,Old Millfieldians,Millfield School 1st XI,3,0,2.0,3
15314200,Old Harrovians II,Old Brentwoods II,0,4,1.0,4
15312549,Old Westminsters,Old Cholmeleians II,7,4,3.0,11
15396920,Old Tonbridgians II,Old Merchant Taylors II,6,2,2.0,8
15299966,Old Marlburians,Old Foresters,0,3,2.0,3
15299942,Old Chigwellians,Old Salopians,1,4,2.0,5
15299955,KCS Old Boys,Old Tonbridgians,1,3,3.0,4
15304604,Old Wykehamists,Old Bradfieldians,1,4,2.0,5
15304655,Old Malvernians,Old Brentwoods,2,4,3.0,6
15312544,Old Berkhamstedians,Old Chigwellians II,4,0,1.0,4
15312546,Old Etonians II,Old Foresters II,1,4,2.0,5
15314148,Old Salopians II,Kings College Wimbledon II,2,3,4.0,5
15314149,Old Eastbournians,Old Sennockians,1,3,3.0,4
15315306,Old Wykehamists II,Old Millhillians,1,2,4.0,3
15315318,Old Alleynians AFC,Old Cholmeleians III,7,1,0.0,8
15315372,Old Merchant Taylors,Old Brentwoods III,4,0,1.0,4
15315422,Old Amplefordians,Old Rugbeians,2,3,4.0,5
15250587,Old Millfieldians,London Welsh F.C.,1,2,4.0,3
15250588,Leyton County Old Boys,Old Bancroftians AFC,1,3,3.0,4
15162952,Royal Bank of Scotland,Old Haberdashers,6,4,4.0,10
15162951,Putney Ferrets,Old Haileyburians,1,3,3.0,4
15162953,Putney Saint-Germain,Old Westminsters,3,3,5.0,6
15251434,Old Foresters III,Old Parkonians,0,13,1.0,13
15020552,Old Carthusians,Charterhouse School 1st XI,2,1,4.0,3
15020551,Old Carthusians II,Charterhouse School 2nd XI,4,4,6.0,8
15020550,Old Carthusians III,Charterhouse School 3rd XI,2,1,4.0,3
15301535,Old Reptonians,Repton School 1st XI,0,0,4.0,0
15301109,Old Harrovians,Harrow School 1st XI,0,0,4.0,0
15301108,Old Harrovians II,Harrow School 2nd XI,0,0,4.0,0
15301107,Old Harrovians III,Harrow School 3rd XI,0,0,4.0,0
15314173,Old Epsomians,Old Brentwoods II,2,7,0.0,9
15312545,Lancing Old Boys II,Old Cholmeleians II,1,1,4.0,2
15378234,Old Radleians,Old Wellingtonians,5,1,2.0,6
15299954,Old Carthusians,Old Cholmeleians,3,1,3.0,4
15299938,Old Marlburians,Old Salopians,1,0,3.0,1
15299939,Old Foresters,Old Tonbridgians,4,5,5.0,9
15304657,Old Reptonians,Old Harrovians,0,3,2.0,3
15304611,Old Wellingtonians,Old Aldenhamians,1,1,4.0,2
15304612,Old Wykehamists,Old Haileyburians,1,2,4.0,3
15312540,Old Millfieldians,Old Berkhamstedians,1,1,4.0,2
15312542,Old Chigwellians II,Old Carthusians III,0,3,2.0,3
15312543,Old Foresters II,Old Westminsters,0,4,1.0,4
15314167,Old Salopians II,Old Epsomians,1,1,4.0,2
15314211,Old Harrovians II,Old Haberdashers,3,5,4.0,8
15314188,Old Citizens,Old Eastbournians,6,2,2.0,8
15315327,Old Alleynians AFC,Old Aldenhamians II,1,3,3.0,4
15315382,Old Merchant Taylors,Old Bancroftians AFC,1,1,4.0,2
15315423,Old Oundelians,Old Tonbridgians II,1,0,3.0,1
15315437,Old Rugbeians,Old Westminsters II,4,1,2.0,5
15162989,Old Minchendenians,Kings College Wimbledon II,4,3,4.0,7
14985354,Old Brentwoods,Brentwood School 1st XI,5,1,2.0,6
14985353,Old Brentwoods II,Brentwood School 2nd XI,4,1,2.0,5
14985357,Old Brentwoods III,Brentwood School 3rd XI,5,4,5.0,9
14985356,Old Etonians,Eton College 1st XI,0,0,4.0,0
14985355,Old Etonians II,Eton College 2nd XI,0,0,4.0,0
15311152,Lancing Old Boys,Lancing College 1st XI,8,0,0.0,8
15311151,Lancing Old Boys II,Lancing College 2nd XI,7,0,0.0,7
15367008,Old Foresters III,Old Cholmeleians IV,8,4,2.0,12
15054015,KCS Old Boys,Old Harrovians,0,2,2.0,2
15311150,Hornsey and Highgate FC,Old Cholmeleians III,2,4,3.0,6
15072572,Old Reptonians,Repton School 1st XI,2,1,4.0,3
15055938,KCS Old Boys,Old Bradfieldians,5,3,4.0,8
15117835,Old Chigwellians III,Old Brentwoods III,0,2,2.0,2
15143324,Old Etonians,Old Tonbridgians,1,1,4.0,2
15054014,Old Millfieldians,Old Harrovians II,3,2,4.0,5
15008829,Old Berkhamstedians,Old Epsomians,4,1,2.0,5
15046384,Old Wilsonians,Old Carthusians,0,1,3.0,1
15117806,Old Chigwellians III,Old Bancroftians AFC,1,2,4.0,3
15194629,Old Cholmeleians III,Old Merchant Taylors,0,3,2.0,3
15205404,Old Stoics,Old Harrovians,2,5,2.0,7
14985360,Old Westminsters II,Old Sennockians,2,2,5.0,4
15143325,PWC Select XI,Old Etonians,2,2,5.0,4
15130906,Old Wellingtonians Select XI,Old Wellingtonians,1,1,4.0,2
15142908,LM United,Old Alleynians AFC,0,5,0.0,5
15124933,Old Cholmeleians,Old Brentwoods,0,4,1.0,4
15011081,Old Foresters III,Old Cholmeleians III,2,2,5.0,4
15117805,Old Chigwellians III,Old Parkonians,0,4,1.0,4
15131098,Old Parkonians,Old Chigwellians,0,0,4.0,0
15072713,Old Harrovians II,Old Etonians II,4,6,4.0,10
14992638,Old Marlburians,Old Harrovians,0,3,2.0,3
15129626,Old Millfieldians,Old Barryians,5,3,4.0,8
15117872,Old Foresters,Chingford Athletic,3,5,4.0,8
15019201,St Lawrence,Old Sennockians,1,0,3.0,1
15053984,Old Aldenhamians,Old Cholmeleians,2,2,5.0,4
14985361,Old Alleynians AFC,Old Marlburians,4,3,4.0,7
15086776,Old Foresters,Old Brentwoods,0,4,1.0,4
15008830,Donnington Wanderers,Old Epsomians,4,4,6.0,8
16412535,Old Carthusians III,Old Berkhamstedians,3,3,5.0,6
16413451,Old Bancroftians AFC,Old Stoics,1,2,4.0,3
17057536,Old Columbans,Old Albanians SA,8,1,0.0,9
17071300,Old Johnians FC,Old Rugbeians,7,0,0.0,7
16393133,Old Salopians,Old Carthusians,2,3,4.0,5
16393121,Old Harrovians,Old Carthusians,2,8,0.0,10
16412494,Lancing Old Boys II,Old Westminsters,2,5,2.0,7
16412520,Old Carthusians III,Kings College Wimbledon II,2,3,4.0,5
16413497,Old Stoics,Old Tonbridgians II,3,4,4.0,7
16413500,Old Bancroftians AFC,Old Wykehamists II,2,1,4.0,3
17057540,Old Albanians SA,Old Epsomians II,2,6,2.0,8
17069715,Old Johnians FC,Old Merchant Taylors II,3,1,3.0,4
17069714,Old Chigwellians III,Old Rugbeians,3,5,4.0,8
17063147,Old Carthusians,Old Wokingians,0,2,2.0,2
16589184,Old Malvernians II,Old Rugbeians,0,0,4.0,0
16394068,Old Malvernians,Old Radleians,1,4,2.0,5
16413466,Old Haberdashers,Old Cholmeleians II,3,1,3.0,4
17057533,Old Foresters III,Old Brentwoods II,0,3,2.0,3
17057534,Old Brentwoods III,Old Chigwellians III,1,2,4.0,3
16589198,Old Harrovians III,Old Westminsters II,2,2,5.0,4
17059827,Old Carthusians,Old Reptonians,3,1,3.0,4
17062188,Old Carthusians III,Old Westminsters,4,3,4.0,7
17051057,Old Tonbridgians II,Old Rugbeians,1,1,4.0,2
16589208,Old Harrovians III,Old Rugbeians,1,2,4.0,3
17057535,Old Merchant Taylors II,Old Chigwellians III,0,5,0.0,5
16393062,Old Foresters,Old Carthusians,1,6,0.0,7
16393078,Lancing Old Boys,Old Tonbridgians,3,0,2.0,3
16394123,Old Bradfieldians,Old Cholmeleians,0,0,4.0,0
16412493,Old Foresters II,Old Carthusians II,0,3,2.0,3
16412542,Old Westminsters,Kings College Wimbledon II,0,4,1.0,4
16413557,Old Chigwellians II,Old Aldenhamians II,0,3,2.0,3
16413469,Old Merchant Taylors,Old Bancroftians AFC,2,1,4.0,3
16413484,Old Haberdashers,Old Tonbridgians II,4,6,4.0,10
16413492,Old Cholmeleians II,Old Wykehamists II,0,3,2.0,3
16987137,Old Brentwoods II,Old Brentwoods III,2,1,4.0,3
17044856,Old Foresters III,Old Merchant Taylors II,1,2,4.0,3
16434414,Old Rugbeians,Old Westminsters II,6,0,0.0,6
17036039,Old Carthusians III,Old Alleynians AFC,1,0,3.0,1
16394134,Old Chigwellians,Old Malvernians,5,2,2.0,7
17002787,Old Etonians,Old Carthusians,0,1,3.0,1
16394038,Arthurian League Representative Team,Southern Amateur League Rep XI,3,0,2.0,3
17013589,Old Foresters Vets,Old Harrovians Vets,4,1,2.0,5
17045769,Old Brentwoods Vets,Old Malvernians Vets,2,3,4.0,5
16393083,Old Etonians,Old Brentwoods,3,1,3.0,4
16393137,Old Salopians,Lancing Old Boys,4,1,2.0,5
16394101,Old Aldenhamians,Old Reptonians,3,3,5.0,6
16394120,Old Wykehamists,Old Malvernians,3,0,2.0,3
16394140,Old Cholmeleians,Old Bradfieldians,3,2,4.0,5
16412501,Old Foresters II,Old Carthusians III,0,2,2.0,2
16412526,Old Berkhamstedians,Old Sennockians,2,2,5.0,4
16413473,Old Cholmeleians II,Old Suttonians SV,3,5,4.0,8
16413464,Old Merchant Taylors,Old Wykehamists II,2,1,4.0,3
17044692,Old Chigwellians III,Old Brentwoods II,5,2,2.0,7
16589213,Old Westminsters II,Old Alleynians AFC II,5,7,4.0,12
17023615,Kings College Wimbledon II,Old Westminsters,3,4,4.0,7
17042808,Old Columbans,Old Rugbeians,3,3,5.0,6
17044393,Old Epsomians II,Old Tonbridgians II,0,2,2.0,2
17021281,Old Carthusians,Polytechnic,1,4,2.0,5
17013569,Old Tonbridgians Vets,Old Malvernians Vets,0,3,2.0,3
16393088,Old Brentwoods,Old Harrovians,1,2,4.0,3
16394107,Old Malvernians,Old Wellingtonians,1,6,0.0,7
16394084,Old Chigwellians,Old Radleians,3,1,3.0,4
16412536,Kings College Wimbledon II,Old Carthusians II,1,1,4.0,2
16412558,Lancing Old Boys II,Old Carthusians III,5,0,0.0,5
16413539,Old Alleynians AFC,Old Aldenhamians II,2,2,5.0,4
16413556,Old Chigwellians II,Old Salopians II,6,2,2.0,8
16413515,Old Harrovians II,Old Citizens,2,1,4.0,3
16413487,Old Cholmeleians II,Old Stoics,3,4,4.0,7
17035775,Old Brentwoods II,Old Merchant Taylors II,1,1,4.0,2
17035776,Old Chigwellians III,Old Foresters III,0,6,0.0,6
16589190,Old Alleynians AFC II,Old Amplefordians,5,5,6.0,10
16589202,Old Amplefordians,Old Alleynians AFC II,5,5,6.0,10
16434418,Old Rugbeians,Kings College Wimbledon III,1,3,3.0,4
17037397,Old Salopians,Old Reptonians,1,2,4.0,3
17036081,Old Bancroftians AFC,Old Tonbridgians II,0,1,3.0,1
16982087,Old Carthusians,Old Hamptonians,3,2,4.0,5
16393096,Old Brentwoods,Lancing Old Boys,1,4,2.0,5
16393080,Old Tonbridgians,Old Foresters,0,2,2.0,2
16393129,Old Carthusians,Old Marlburians,5,2,2.0,7
16394153,Old Millfieldians,Old Wykehamists,1,3,3.0,4
16412554,Old Berkhamstedians,Old Carthusians II,3,0,2.0,3
16412537,Old Westminsters,Old Etonians II,4,3,4.0,7
16412502,Kings College Wimbledon II,Old Sennockians,1,2,4.0,3
16413555,Old Citizens,Old Epsomians,4,1,2.0,5
16413546,Old Eastbournians,Old Salopians II,0,2,2.0,2
16413518,Old Alleynians AFC,Old Harrovians II,1,2,4.0,3
16413455,Old Merchant Taylors,Old Suttonians SV,4,0,1.0,4
17030367,Old Foresters III,Old Brentwoods III,2,1,4.0,3
16987138,Old Merchant Taylors II,Old Chigwellians III,1,2,4.0,3
16589223,Old Johnians FC,Old Malvernians II,3,1,3.0,4
16948962,Old Reptonians,Old Salopians,2,2,5.0,4
17014219,Old Carthusians III,Old Tonbridgians II,3,3,5.0,6
16996922,Old Bancroftians AFC,Old Alleynians AFC II,4,3,4.0,7
17012308,Old Haberdashers,Old Epsomians II,3,4,4.0,7
17023574,Old Albanians SA,Old Rugbeians,2,3,4.0,5
17002720,Old Aldenhamians II,Southgate Olympic,1,2,4.0,3
16552154,Old Radleians,Radley College 1st XI,5,3,4.0,8
16709884,Old Cholmeleians,Highgate School 1st XI,0,3,2.0,3
16709883,Old Cholmeleians II,Highgate School 2nd XI,0,0,4.0,0
16709882,Old Cholmeleians III,Highgate School 3rd XI,0,2,2.0,2
16393056,Old Etonians,Old Marlburians,3,3,5.0,6
16393125,Old Carthusians,Old Tonbridgians,6,1,0.0,7
16394122,Old Reptonians,Old Chigwellians,1,2,4.0,3
16394119,Old Millfieldians,Old Cholmeleians,1,1,4.0,2
16394146,Old Aldenhamians,Old Malvernians,2,0,2.0,2
16394141,Old Wykehamists,Old Wellingtonians,0,1,3.0,1
16412568,Old Etonians II,Old Sennockians,0,1,3.0,1
16413527,Old Epsomians,Old Eastbournians,1,4,2.0,5
16413491,Old Suttonians SV,Old Tonbridgians II,3,4,4.0,7
16434379,Old Brentwoods II,Old Chigwellians III,1,0,3.0,1
16589194,Old Johnians FC,Old Alleynians AFC II,3,2,4.0,5
16434433,Old Amplefordians,Kings College Wimbledon III,1,4,2.0,5
17012367,Old Harrovians II,Old Westminsters,0,4,1.0,4
17011924,Lancing Old Boys II,Old Alleynians AFC,0,5,0.0,5
17012184,Kings College Wimbledon II,Old Berkhamstedians,4,2,3.0,6
16987209,Old Suttonians SV,Old Tonbridgians II,3,4,4.0,7
16973438,Old Rugbeians,Old Merchant Taylors,3,2,4.0,5
16340723,Old Foresters,Forest School 1st XI,3,2,4.0,5
16340722,Old Foresters II,Forest School 2nd XI,2,2,5.0,4
17008102,Old Bancroftians AFC,Bancroft's School 1st XI,0,0,4.0,0
16576918,Old Haberdashers,Haberdashers Aske School 1st XI,2,3,4.0,5
16937422,Old Foresters Vets,Old Cholmeleians Vets,3,3,5.0,6
16958664,Old Haileyburians Vets,Old Brentwoods Vets,0,3,2.0,3
16952713,Old Reptonians Vets,Old Malvernians Vets,2,4,3.0,6
16393118,KCS Old Boys,Lancing Old Boys,4,0,1.0,4
16393064,Old Marlburians,Old Harrovians,5,3,4.0,8
16393116,Old Tonbridgians,Old Salopians,0,5,0.0,5
16393068,Old Brentwoods,Old Etonians,0,1,3.0,1
16394112,Old Wykehamists,Old Aldenhamians,2,4,3.0,6
16394095,Old Chigwellians,Old Reptonians,3,2,4.0,5
16412567,Lancing Old Boys II,Old Foresters II,4,0,1.0,4
16413505,Old Aldenhamians II,Old Alleynians AFC,1,5,2.0,6
16434396,Old Cholmeleians III,Old Foresters III,0,7,0.0,7
16434392,Old Brentwoods III,Old Brentwoods II,1,4,2.0,5
16968913,Old Alleynians AFC II,Old Harrovians II,1,2,4.0,3
16968911,Old Rugbeians,Old Carthusians III,1,4,2.0,5
16968923,Old Carthusians II,Old Tonbridgians II,0,1,3.0,1
16968919,Old Chigwellians II,Kings College Wimbledon II,3,3,5.0,6
16973434,Old Johnians FC,Old Albanians SA,5,5,6.0,10
16973435,Old Epsomians II,Old Wykehamists II,6,1,0.0,7
16973437,Old Stoics,Old Columbans,1,2,4.0,3
16973436,Old Amplefordians,Old Haberdashers,4,5,5.0,9
16941939,Old Carthusians,Nottsborough FC,2,0,2.0,2
16998007,Old Malvernians,Malvern College 1st XI,2,1,4.0,3
16998010,Old Malvernians II,Malvern College 2nd XI,1,0,3.0,1
16560517,Old Westminsters,Westminster School 1st XI,1,1,4.0,2
16560991,Old Westminsters II,Westminster School 2nd XI,3,2,4.0,5
16987222,Old Merchant Taylors,Merchant Taylors School 1st XI,0,2,2.0,2
16987223,Old Merchant Taylors II,Merchant Taylors School 2nd XI,5,0,0.0,5
16964731,Herts Senior County League,Arthurian League Representative Team,4,5,5.0,9
16969991,Lancing Old Boys Vets,Old Harrovians Vets,1,2,4.0,3
16393108,Old Etonians,Old Carthusians,1,1,4.0,2
16393115,Old Foresters,Old Harrovians,1,2,4.0,3
16393071,Old Brentwoods,Old Marlburians,3,7,2.0,10
16393065,Lancing Old Boys,Old Salopians,3,5,4.0,8
16393061,Old Tonbridgians,KCS Old Boys,3,2,4.0,5
16394111,Old Millfieldians,Old Wellingtonians,1,3,3.0,4
16394127,Old Chigwellians,Old Aldenhamians,2,0,2.0,2
16394155,Old Bradfieldians,Old Reptonians,3,1,3.0,4
16394131,Old Radleians,Old Malvernians,1,2,4.0,3
16412539,Old Carthusians III,Old Etonians II,3,1,3.0,4
16434382,Old Cholmeleians III,Old Brentwoods II,2,1,4.0,3
16589216,Kings College Wimbledon III,Old Rugbeians,0,2,2.0,2
16589210,Old Harrovians III,Old Alleynians AFC II,5,3,4.0,8
16951351,Old Carthusians,Old Etonians,1,1,4.0,2
16968921,Old Sennockians,Old Alleynians AFC,0,2,2.0,2
16968915,Old Westminsters,Old Eastbournians,4,1,2.0,5
16968925,Old Berkhamstedians,Old Merchant Taylors,4,0,1.0,4
16393110,Lancing Old Boys,Old Brentwoods,0,1,3.0,1
16393073,Old Tonbridgians,Old Etonians,1,4,2.0,5
16393104,KCS Old Boys,Old Carthusians,1,7,0.0,8
16394102,Old Cholmeleians,Old Wykehamists,1,5,2.0,6
16394066,Old Millfieldians,Old Reptonians,3,0,2.0,3
16394136,Old Wellingtonians,Old Chigwellians,1,2,4.0,3
16394125,Old Aldenhamians,Old Radleians,1,3,3.0,4
16412550,Old Carthusians II,Lancing Old Boys II,2,2,5.0,4
16412571,Old Westminsters,Old Carthusians III,3,3,5.0,6
16412555,Old Sennockians,Old Etonians II,0,2,2.0,2
16412510,Old Foresters II,Kings College Wimbledon II,2,2,5.0,4
16413516,Old Salopians II,Old Eastbournians,2,1,4.0,3
16413552,Old Chigwellians II,Old Epsomians,2,1,4.0,3
16413452,Old Merchant Taylors,Old Haberdashers,4,1,2.0,5
16434385,Old Brentwoods II,Old Foresters III,3,1,3.0,4
16434395,Old Brentwoods III,Old Chigwellians III,2,2,5.0,4
16589212,Old Rugbeians,Old Johnians FC,2,1,4.0,3
16589191,Old Malvernians II,Old Amplefordians,2,5,2.0,7
16589224,Old Alleynians AFC II,Old Westminsters II,2,0,2.0,2
16944386,Old Merchant Taylors II,Old Tonbridgians II,4,4,6.0,8
16951766,Old Bancroftians AFC,Old Finchleians,0,3,2.0,3
16412519,Old Berkhamstedians,Old Haileyburians,7,2,0.0,9
16911323,Arthurian League Representative Team,AFC Representative Team,1,1,4.0,2
16773139,Old Carthusians Vets,Old Harrovians Vets,2,4,3.0,6
16393052,Old Etonians,Old Foresters,1,1,4.0,2
16393067,Old Harrovians,Lancing Old Boys,0,5,0.0,5
16393092,Old Brentwoods,Old Salopians,1,7,0.0,8
16393126,Old Marlburians,KCS Old Boys,0,4,1.0,4
16394063,Old Wellingtonians,Old Aldenhamians,1,1,4.0,2
16394099,Old Bradfieldians,Old Chigwellians,0,2,2.0,2
16394110,Old Cholmeleians,Old Reptonians,1,2,4.0,3
16412525,Old Etonians II,Old Foresters II,0,1,3.0,1
16412512,Old Carthusians II,Old Carthusians III,1,3,3.0,4
16412541,Old Sennockians,Old Westminsters,1,3,3.0,4
16413526,Old Aldenhamians II,Old Harrovians II,2,4,3.0,6
16589199,Old Rugbeians,Old Alleynians AFC II,7,1,0.0,8
16915255,Old Bancroftians AFC,Old Berkhamstedians,2,4,3.0,6
16915260,Old Salopians II,Old Tonbridgians II,1,2,4.0,3
16944376,Old Suttonians SV,Old Ardinians,3,0,2.0,3
16944370,Old Johnians FC,Old Cholmeleians III,9,1,0.0,10
16944392,Old Foresters III,Old Haberdashers,0,1,3.0,1
16944366,Old Amplefordians,Old Chigwellians III,2,0,2.0,2
16944390,Kings College Wimbledon III,Old Columbans,1,3,3.0,4
16944378,Old Brentwoods II,Old Merchant Taylors,1,4,2.0,5
16944368,Old Albanians SA,Old Harrovians III,9,3,0.0,12
16944382,Old Epsomians II,Old Shirburnians,2,0,2.0,2
16944394,Old Malvernians II,Old Stoics,2,3,4.0,5
16944374,Old King's Scholars,Old Westminsters II,2,5,2.0,7
16951741,Old Malvernians,London Welsh F.C.,1,3,3.0,4
16858371,Clapham Old Xaverians,Old Carthusians,0,5,0.0,5
16873788,Old Salopians Vets,Old Brentwoods Vets,0,3,2.0,3
16774924,Old Wykehamists Vets,Old Malvernians Vets,0,4,1.0,4
16393077,Old Foresters,Old Brentwoods,2,3,4.0,5
16393123,Old Etonians,Old Salopians,0,1,3.0,1
16393132,Old Harrovians,KCS Old Boys,3,3,5.0,6
16394126,Old Chigwellians,Old Wykehamists,3,5,4.0,8
16394117,Old Malvernians,Old Reptonians,6,0,0.0,6
16394133,Old Wellingtonians,Old Bradfieldians,2,4,3.0,6
16434427,Kings College Wimbledon III,Old Johnians FC,0,1,3.0,1
16589207,Old Westminsters II,Old Malvernians II,2,2,5.0,4
16858376,Old Carthusians,Old Berkhamstedians,3,0,2.0,3
16915268,Old Wykehamists II,Old Eastbournians,3,5,4.0,8
16915263,Old Wellingburians,Lancing Old Boys II,2,3,4.0,5
16915247,Old Carthusians III,Old Aldenhamians II,2,1,4.0,3
16915272,Old Merchant Taylors II,Old Chigwellians II,0,2,2.0,2
16915253,Old Rugbeians,Old Etonians II,2,1,4.0,3
16915264,Old Brentwoods III,Old Harrovians II,1,7,0.0,8
16915275,Old Epsomians,Old Merchant Taylors,1,3,3.0,4
16915251,Old Shirburnians,Old Sennockians,2,5,2.0,7
16915267,Old Alleynians AFC,Old Stoics,3,2,4.0,5
16915259,Old Citizens,Old Westminsters,1,4,2.0,5
16915256,Old Foresters II,Old Columbans,1,2,4.0,3
16915276,Old Alleynians AFC II,Old Epsomians II,2,1,4.0,3
16803327,Lancing Old Boys Vets,Old Chigwellians Vets,0,0,4.0,0
16393047,Old Harrovians,Old Foresters,0,1,3.0,1
16393060,Old Etonians,Old Tonbridgians,1,0,3.0,1
16393119,Old Marlburians,Old Brentwoods,0,3,2.0,3
16393082,Lancing Old Boys,KCS Old Boys,4,2,3.0,6
16394129,Old Bradfieldians,Old Aldenhamians,1,1,4.0,2
16394156,Old Radleians,Old Wellingtonians,2,2,5.0,4
16412557,Old Foresters II,Old Berkhamstedians,0,6,0.0,6
16412517,Old Sennockians,Old Carthusians III,0,6,0.0,6
16413553,Old Eastbournians,Old Epsomians,2,2,5.0,4
16413519,Old Alleynians AFC,Old Chigwellians II,0,2,2.0,2
16413461,Old Bancroftians AFC,Old Suttonians SV,5,1,2.0,6
16413458,Old Tonbridgians II,Old Wykehamists II,6,3,3.0,9
16434403,Old Westminsters II,Old Amplefordians,6,3,3.0,9
16899517,Old Carthusians,Old Wilsonians,1,1,4.0,2
16412569,Old Haileyburians,Old Westminsters,2,6,2.0,8
16757216,Old Rugbeians,Rugby School,2,0,2.0,2
16802836,Old Westminsters Vets,Old Cholmeleians Vets,1,1,4.0,2
16393131,Old Foresters,Old Tonbridgians,1,0,3.0,1
16393114,Lancing Old Boys,Old Carthusians,3,6,3.0,9
16393130,KCS Old Boys,Old Salopians,1,4,2.0,5
16394115,Old Aldenhamians,Old Millfieldians,2,4,3.0,6
16394103,Old Wykehamists,Old Bradfieldians,2,3,4.0,5
16394118,Old Cholmeleians,Old Wellingtonians,8,3,0.0,11
16412564,Lancing Old Boys II,Old Sennockians,2,0,2.0,2
16412565,Old Carthusians II,Kings College Wimbledon II,1,2,4.0,3
16413549,Old Salopians II,Old Aldenhamians II,3,0,2.0,3
16413551,Old Harrovians II,Old Eastbournians,3,1,3.0,4
16413550,Old Alleynians AFC,Old Epsomians,4,1,2.0,5
16413514,Old Chigwellians II,Old Citizens,1,1,4.0,2
16413489,Old Stoics,Old Suttonians SV,2,6,2.0,8
16413478,Old Haberdashers,Old Wykehamists II,1,4,2.0,5
16413498,Old Tonbridgians II,Old Merchant Taylors,3,2,4.0,5
16434432,Old Amplefordians,Old Johnians FC,0,3,2.0,3
16589226,Old Alleynians AFC II,Old Malvernians II,2,5,2.0,7
16858375,Old Reptonians,Old Brentwoods,1,0,3.0,1
16859846,Old Etonians,Old Chigwellians,3,0,2.0,3
16788875,Alleyn Old Boys,Old Carthusians III,2,1,4.0,3
16861558,Old Suttonians,Old Bancroftians AFC,0,1,3.0,1
16899343,Old Parmiterians,Old Etonians II,2,0,2.0,2
16412561,Old Haileyburians,Old Berkhamstedians,0,15,1.0,15
16393112,Old Marlburians,Old Foresters,2,2,5.0,4
16393127,Old Tonbridgians,Old Brentwoods,2,1,4.0,3
16393093,Old Carthusians,Old Etonians,5,0,0.0,5
16394124,Old Cholmeleians,Old Malvernians,7,5,4.0,12
16394070,Old Bradfieldians,Old Millfieldians,6,0,0.0,6
16412530,Kings College Wimbledon II,Old Berkhamstedians,4,1,2.0,5
16412518,Old Westminsters,Old Foresters II,0,3,2.0,3
16413554,Old Alleynians AFC,Old Salopians II,5,2,2.0,7
16413472,Old Bancroftians AFC,Old Haberdashers,2,4,3.0,6
16413453,Old Suttonians SV,Old Wykehamists II,6,2,2.0,8
16589217,Old Malvernians II,Old Alleynians AFC II,1,7,0.0,8
16434429,Old Rugbeians,Old Amplefordians,1,1,4.0,2
16434438,Old Johnians FC,Kings College Wimbledon III,6,1,0.0,7
16434437,Old Westminsters II,Old Harrovians III,5,1,2.0,6
16857591,Lancing Old Boys,Old Salopians,1,2,4.0,3
16788876,Old Aldenhamians II,Old Vaughanians,3,0,2.0,3
16609284,Old Epsomians,Epsom College 1st XI,2,3,4.0,5
16891890,Old Epsomians II,Epsom College 2nd XI,0,0,4.0,0
16773138,Old Foresters Vets,Old Etonians Vets,3,1,3.0,4
16393124,Old Etonians,Lancing Old Boys,0,2,2.0,2
16393084,Old Tonbridgians,Old Carthusians,3,4,4.0,7
16393105,Old Salopians,KCS Old Boys,1,3,3.0,4
16394108,Old Reptonians,Old Wykehamists,0,5,0.0,5
16394085,Old Millfieldians,Old Radleians,8,2,0.0,10
16394145,Old Chigwellians,Old Bradfieldians,2,3,4.0,5
16412547,Old Carthusians II,Old Westminsters,4,0,1.0,4
16412543,Old Berkhamstedians,Old Etonians II,3,2,4.0,5
16413538,Old Aldenhamians II,Old Eastbournians,3,2,4.0,5
16413533,Old Citizens,Old Salopians II,4,2,3.0,6
16413457,Old Cholmeleians II,Old Haberdashers,4,1,2.0,5
16413467,Old Merchant Taylors,Old Stoics,2,2,5.0,4
16434389,Old Cholmeleians III,Old Merchant Taylors II,0,10,0.0,10
16434375,Old Brentwoods III,Old Foresters III,0,3,2.0,3
16589193,Old Westminsters II,Old Johnians FC,1,0,3.0,1
16589195,Old Rugbeians,Old Harrovians III,7,0,0.0,7
16434423,Kings College Wimbledon III,Old Malvernians II,3,2,4.0,5
16412532,Old Sennockians,Old Haileyburians,2,1,4.0,3
16757416,Old Haileyburians,Haileybury College,5,6,5.0,11
16393097,Old Salopians,Old Foresters,0,2,2.0,2
16393136,Lancing Old Boys,Old Harrovians,4,2,3.0,6
16393066,Old Marlburians,Old Etonians,0,4,1.0,4
16394086,Old Aldenhamians,Old Wykehamists,0,5,0.0,5
16394135,Old Cholmeleians,Old Radleians,7,2,0.0,9
16394091,Old Bradfieldians,Old Malvernians,5,2,2.0,7
16394092,Old Reptonians,Old Wellingtonians,2,2,5.0,4
16412556,Old Carthusians III,Old Foresters II,2,2,5.0,4
16412506,Old Carthusians II,Old Sennockians,1,0,3.0,1
16412545,Old Etonians II,Lancing Old Boys II,4,0,1.0,4
16413483,Old Suttonians SV,Old Cholmeleians II,6,3,3.0,9
16413470,Old Wykehamists II,Old Stoics,1,1,4.0,2
16434424,Old Westminsters II,Kings College Wimbledon III,2,1,4.0,3
16725816,Old Merchant Taylors,Old Chigwellians,0,5,0.0,5
16774982,Old Parkonians,Old Brentwoods,1,0,3.0,1
16774983,Old Hamptonians,Old Carthusians,1,5,2.0,6
16788877,Old Aldenhamians II,Old Thorntonians,0,5,0.0,5
16511722,Old Brentwoods,Brentwood School 1st XI,0,0,4.0,0
16511721,Old Brentwoods II,Brentwood School 2nd XI,2,7,0.0,9
16511720,Old Brentwoods III,Brentwood School 3rd XI,2,1,4.0,3
16760712,Dulwich College 1st XI,Old Alleynians AFC,0,6,0.0,6
16760713,Dulwich College 2nd XI,Old Alleynians AFC II,0,0,4.0,0
16380199,KCS Old Boys,"King's College School, Wimbledon 1st XI",0,1,3.0,1
16380198,Kings College Wimbledon II,"King's College School, Wimbledon 2nd XI",1,5,2.0,6
16679858,Old Etonians Vets,Old Wykehamists Vets,4,2,3.0,6
16730720,Old Haileyburians Vets,Old Chigwellians Vets,2,2,5.0,4
16565272,Old Westminsters Vets,Old Salopians Vets,6,3,3.0,9
16394093,Old Aldenhamians,Old Bradfieldians,1,3,3.0,4
16412553,Lancing Old Boys II,Kings College Wimbledon II,0,2,2.0,2
16413536,Old Aldenhamians II,Old Salopians II,2,4,3.0,6
16413494,Old Bancroftians AFC,Old Cholmeleians II,2,2,5.0,4
16413476,Old Stoics,Old Merchant Taylors,1,3,3.0,4
16725815,Old Harrovians,Lancing Old Boys,1,2,4.0,3
16725809,Old Malvernians,Old Berkhamstedians,3,4,4.0,7
16725813,Old Salopians,Old Marlburians,6,0,0.0,6
16743685,Old Carthusians,Park View,3,0,2.0,3
16305253,Old Wykehamists Select,Old Wykehamists,6,7,5.0,13
16772862,Old Wykehamists Select,Old Wykehamists II,5,7,4.0,12
16793677,Old Alleynians AFC II,Old Tonbridgians II,2,3,4.0,5
16412559,Old Haileyburians,Old Sennockians,0,6,0.0,6
16393081,Old Salopians,Old Harrovians,5,1,2.0,6
16393140,Old Marlburians,Old Tonbridgians,0,1,3.0,1
16394128,Old Radleians,Old Wykehamists,2,7,0.0,9
16394079,Old Chigwellians,Old Millfieldians,5,0,0.0,5
16412521,Old Etonians II,Old Berkhamstedians,6,3,3.0,9
16412505,Old Westminsters,Lancing Old Boys II,2,5,2.0,7
16412544,Old Sennockians,Kings College Wimbledon II,0,2,2.0,2
16413537,Old Harrovians II,Old Chigwellians II,2,2,5.0,4
16413540,Old Epsomians,Old Citizens,4,1,2.0,5
16413475,Old Suttonians SV,Old Bancroftians AFC,1,3,3.0,4
16413454,Old Wykehamists II,Old Cholmeleians II,2,2,5.0,4
16413481,Old Tonbridgians II,Old Stoics,2,2,5.0,4
16434373,Old Chigwellians III,Old Brentwoods III,1,1,4.0,2
16434409,Old Malvernians II,Old Harrovians III,1,4,2.0,5
16589205,Kings College Wimbledon III,Old Alleynians AFC II,1,3,3.0,4
16589181,Old Amplefordians,Old Westminsters II,2,2,5.0,4
16725818,KCS Old Boys,Old Reptonians,2,5,2.0,7
16725817,Old Carthusians,Old Bradfieldians,6,1,0.0,7
16725810,Old Cholmeleians,Old Brentwoods,2,4,3.0,6
16725808,Old Etonians,Old Foresters,3,1,3.0,4
16693763,Old Rugbeians,Old Foresters III,1,1,4.0,2
16697855,South Bank Cuaco,Old Salopians II,4,0,1.0,4
16743684,Old Malvernians,Wood Green Old Boys,6,0,0.0,6
16679216,Bealonians,Old Carthusians III,1,3,3.0,4
16759207,Old Eastbournians,Shene Old Grammarians,0,3,2.0,3
16743863,Old Aldenhamians,Aldenham School 1st XI,3,1,3.0,4
16743862,Old Aldenhamians II,Aldenham School 2nd XI,1,10,0.0,11
16565274,Old Carthusians Vets,Old Brentwoods Vets,3,2,4.0,5
16393138,KCS Old Boys,Old Etonians,1,1,4.0,2
16394104,Old Aldenhamians,Old Cholmeleians,0,9,0.0,9
16394151,Old Malvernians,Old Wykehamists,1,0,3.0,1
16394149,Old Reptonians,Old Millfieldians,2,1,4.0,3
16412511,Old Berkhamstedians,Lancing Old Boys II,1,3,3.0,4
16412563,Kings College Wimbledon II,Old Carthusians III,1,2,4.0,3
16413530,Old Chigwellians II,Old Eastbournians,3,1,3.0,4
16413524,Old Salopians II,Old Citizens,1,9,0.0,10
16693762,Old Brentwoods II,Old Epsomians II,0,4,1.0,4
16693754,Old Malvernians II,Old Merchant Taylors II,0,7,0.0,7
16693756,Old Haberdashers,Old Suttonians SV,7,5,4.0,12
16693752,Old Kimboltonians,Old Wellingburians,0,5,0.0,5
16693766,Old Alleynians AFC II,Old Amplefordians,3,2,4.0,5
16693772,Old Ardinians,Old Stoics,2,5,2.0,7
16693764,Old Foresters III,Old Rugbeians,0,8,0.0,8
16693748,Old Wykehamists II,Kings College Wimbledon III,2,1,4.0,3
16693768,Old Merchant Taylors,Old Johnians FC,3,1,3.0,4
16697857,Globe Rangers,Old Brentwoods,2,5,2.0,7
16697858,Old Carthusians,Old Thorntonians,4,1,2.0,5
16697856,NUFC Oilers,Old Salopians,1,0,3.0,1
16743866,Old Bancroftians AFC,Old King's Scholars,3,1,3.0,4
16717561,Somerville Old Boys,Old Sennockians,7,4,3.0,11
16412492,Old Westminsters,Old Haileyburians,8,1,0.0,9
16686009,Lancing Old Boys Vets,Old Tonbridgians Vets,5,1,2.0,6
16393074,KCS Old Boys,Old Foresters,2,0,2.0,2
16393072,Old Carthusians,Old Brentwoods,4,0,1.0,4
16393113,Old Harrovians,Old Tonbridgians,0,2,2.0,2
16393075,Old Marlburians,Old Salopians,4,3,4.0,7
16394089,Old Millfieldians,Old Aldenhamians,1,6,0.0,7
16394074,Old Reptonians,Old Malvernians,0,3,2.0,3
16394152,Old Bradfieldians,Old Radleians,1,0,3.0,1
16412496,Old Carthusians III,Old Westminsters,6,2,2.0,8
16412531,Old Carthusians II,Old Etonians II,1,1,4.0,2
16413535,Old Citizens,Old Harrovians II,0,3,2.0,3
16413508,Old Salopians II,Old Alleynians AFC,2,6,2.0,8
16413545,Old Aldenhamians II,Old Epsomians,3,5,4.0,8
16413468,Old Tonbridgians II,Old Suttonians SV,2,2,5.0,4
16413450,Old Cholmeleians II,Old Merchant Taylors,2,1,4.0,3
16434372,Old Chigwellians III,Old Cholmeleians III,5,0,0.0,5
16434381,Old Merchant Taylors II,Old Foresters III,1,6,0.0,7
16434383,Old Brentwoods II,Old Brentwoods III,3,0,2.0,3
16434416,Old Johnians FC,Old Amplefordians,8,3,0.0,11
16434428,Old Harrovians III,Kings College Wimbledon III,4,1,2.0,5
16693771,Old Stoics,Old Ardinians,0,0,4.0,0
16739537,Old King's Scholars,Old Bancroftians AFC,1,1,4.0,2
16391818,Old Meadonians,Old Eastbournians,1,2,4.0,3
16678849,Old Etonians,Old Minchendenians,2,3,4.0,5
16243551,Old Wykehamists,Winchester College 1st XI,1,0,3.0,1
16243550,Old Wykehamists II,Winchester College 2nd XI,1,3,3.0,4
16393048,Old Foresters,Lancing Old Boys,1,0,3.0,1
16393101,Old Salopians,Old Tonbridgians,5,2,2.0,7
16393134,KCS Old Boys,Old Brentwoods,2,1,4.0,3
16393085,Old Harrovians,Old Marlburians,0,0,4.0,0
16394132,Old Reptonians,Old Aldenhamians,2,1,4.0,3
16394142,Old Cholmeleians,Old Chigwellians,1,6,0.0,7
16394094,Old Malvernians,Old Millfieldians,0,5,0.0,5
16394064,Old Radleians,Old Bradfieldians,4,4,6.0,8
16412508,Old Carthusians II,Old Berkhamstedians,2,0,2.0,2
16412514,Old Westminsters,Old Sennockians,1,2,4.0,3
16413532,Old Eastbournians,Old Citizens,4,3,4.0,7
16413482,Old Stoics,Old Bancroftians AFC,0,2,2.0,2
16693765,Old Amplefordians,Old Alleynians AFC II,4,4,6.0,8
16693757,Old Chigwellians III,Old Brentwoods III,0,1,3.0,1
16693769,Old Tonbridgians II,Old Cholmeleians II,4,3,4.0,7
16693759,Old Shirburnians,Old Cholmeleians III,5,0,0.0,5
16693755,Old Suttonians SV,Old Haberdashers,1,2,4.0,3
16693751,Old Wellingburians,Old Kimboltonians,2,3,4.0,5
16693753,Old Merchant Taylors II,Old Malvernians II,3,2,4.0,5
16693767,Old Johnians FC,Old Merchant Taylors,3,3,5.0,6
16693747,Kings College Wimbledon III,Old Wykehamists II,2,5,2.0,7
16693749,Old Westminsters II,Old Columbans,0,5,0.0,5
16693761,Old Epsomians II,Old Brentwoods II,0,3,2.0,3
16678848,Old Carthusians,Old Aloysians,6,2,2.0,8
16412516,Old Foresters II,Old Haileyburians,5,4,5.0,9
16398290,Old Etonians,Eton College 1st XI,1,2,4.0,3
16398289,Old Etonians II,Eton College 2nd XI,2,2,5.0,4
16530670,Lloyds of London Representative Team,Arthurian League Representative Team,0,2,2.0,2
16565271,Old Foresters Vets,Old Malvernians Vets,8,1,0.0,9
16393122,Lancing Old Boys,Old Marlburians,1,7,0.0,8
16393095,Old Harrovians,Old Salopians,3,2,4.0,5
16394138,Old Radleians,Old Reptonians,6,4,4.0,10
16394098,Old Chigwellians,Old Wellingtonians,3,1,3.0,4
16394075,Old Cholmeleians,Old Millfieldians,2,0,2.0,2
16412500,Kings College Wimbledon II,Old Foresters II,3,4,4.0,7
16412515,Old Sennockians,Lancing Old Boys II,1,1,4.0,2
16412523,Old Westminsters,Old Carthusians II,8,0,0.0,8
16412509,Old Etonians II,Old Carthusians III,2,1,4.0,3
16413531,Old Salopians II,Old Chigwellians II,0,2,2.0,2
16413544,Old Citizens,Old Alleynians AFC,2,7,0.0,9
16413541,Old Epsomians,Old Harrovians II,2,4,3.0,6
16413463,Old Haberdashers,Old Bancroftians AFC,1,0,3.0,1
16434380,Old Brentwoods III,Old Cholmeleians III,5,0,0.0,5
16434377,Old Brentwoods II,Old Merchant Taylors II,2,7,0.0,9
16434388,Old Foresters III,Old Chigwellians III,2,4,3.0,6
16434440,Old Amplefordians,Old Harrovians III,5,2,2.0,7
16589229,Old Alleynians AFC II,Old Rugbeians,4,1,2.0,5
16434413,Old Malvernians II,Kings College Wimbledon III,2,4,3.0,6
16206120,Old Carthusians,Old Tonbridgians,4,0,1.0,4
16658953,Old Parmiterians,Old Aldenhamians II,4,7,3.0,11
16658954,Albanian FC,Old Cholmeleians II,7,1,0.0,8
16679234,University of Hertfordshire,Old Malvernians,3,5,4.0,8
16491295,Old Stoics,Old Wimbledonians,1,7,0.0,8
16662938,Old Etonians,Old Owens,2,3,4.0,5
16565273,Old Cholmeleians Vets,Old Reptonians Vets,4,2,3.0,6
16393091,Old Harrovians,Old Etonians,2,2,5.0,4
16394096,Old Malvernians,Old Aldenhamians,3,1,3.0,4
16394144,Old Wykehamists,Old Reptonians,2,2,5.0,4
16394100,Old Wellingtonians,Old Radleians,0,3,2.0,3
16412504,Old Carthusians III,Lancing Old Boys II,1,1,4.0,2
16412533,Old Foresters II,Old Westminsters,0,1,3.0,1
16412503,Old Etonians II,Kings College Wimbledon II,2,1,4.0,3
16413511,Old Eastbournians,Old Aldenhamians II,2,2,5.0,4
16413548,Old Harrovians II,Old Salopians II,3,2,4.0,5
16413471,Old Wykehamists II,Old Suttonians SV,4,4,6.0,8
16413462,Old Merchant Taylors,Old Tonbridgians II,2,1,4.0,3
16434390,Old Chigwellians III,Old Brentwoods II,1,1,4.0,2
16434376,Old Foresters III,Old Cholmeleians III,4,4,6.0,8
16589186,Old Westminsters II,Old Rugbeians,1,5,2.0,6
16434419,Old Harrovians III,Old Malvernians II,1,1,4.0,2
16206107,Old Amplefordians,Lancing Old Boys,1,12,1.0,13
16206108,Old Alleynians AFC,Old Brentwoods,0,4,1.0,4
16206110,Old Epsomians,Old Cholmeleians,2,4,3.0,6
16206116,KCS Old Boys,Old Kimboltonians,6,3,3.0,9
16206114,Old Chigwellians,Old Sennockians,3,2,4.0,5
16211297,Old Salopians,Ibis Eagles,2,1,4.0,3
16211295,Old Foresters,NUFC Oilers,0,4,1.0,4
16211296,Merton,Old Carthusians,1,4,2.0,5
16578183,Old Bancroftians AFC,Old Merchant Taylors II,4,1,2.0,5
16412522,Old Carthusians II,Old Haileyburians,4,1,2.0,5
16565269,Old Etonians Vets,Old Bradfieldians Vets,3,1,3.0,4
16393135,Old Carthusians,Old Foresters,2,3,4.0,5
16393102,Old Tonbridgians,Lancing Old Boys,7,3,2.0,10
16394105,Old Wellingtonians,Old Millfieldians,4,3,4.0,7
16412538,Old Sennockians,Old Foresters II,3,0,2.0,3
16412485,Lancing Old Boys II,Old Carthusians II,3,2,4.0,5
16413513,Old Chigwellians II,Old Harrovians II,2,7,0.0,9
16413558,Old Salopians II,Old Epsomians,1,1,4.0,2
16413477,Old Cholmeleians II,Old Tonbridgians II,0,3,2.0,3
16413503,Old Haberdashers,Old Merchant Taylors,4,5,5.0,9
16413460,Old Suttonians SV,Old Stoics,5,5,6.0,10
16589183,Old Johnians FC,Old Harrovians III,9,1,0.0,10
16206109,Old Westminsters,Old Bradfieldians,0,2,2.0,2
16206112,Old Aldenhamians,Old Reptonians,0,5,0.0,5
16206119,Old Eastbournians,Old Salopians,0,5,0.0,5
16206105,Old Etonians,Old Wykehamists,3,1,3.0,4
16206106,Old Bancroftians AFC,Old Marlburians,1,2,4.0,3
16206113,Old Malvernians,Old Radleians,4,3,4.0,7
16211286,Dorkinians,KCS Old Boys,1,0,3.0,1
16211285,Old Chigwellians,Old Lyonians,2,3,4.0,5
16658511,Old Brentwoods,Old Sedcopians,4,2,3.0,6
16598522,UCL Academicals III,Old Brentwoods II,4,3,4.0,7
16672865,Old Alleynians AFC,Kings College Wimbledon II,6,2,2.0,8
16412513,Old Haileyburians,Old Etonians II,1,9,0.0,10
16393063,Lancing Old Boys,Old Etonians,0,2,2.0,2
16393098,KCS Old Boys,Old Tonbridgians,4,2,3.0,6
16393106,Old Harrovians,Old Brentwoods,1,1,4.0,2
16393089,Old Foresters,Old Marlburians,5,0,0.0,5
16393120,Old Carthusians,Old Salopians,7,1,0.0,8
16394121,Old Wellingtonians,Old Reptonians,0,2,2.0,2
16394139,Old Bradfieldians,Old Wykehamists,0,3,2.0,3
16394147,Old Radleians,Old Millfieldians,4,4,6.0,8
16394081,Old Malvernians,Old Cholmeleians,2,3,4.0,5
16412488,Old Berkhamstedians,Kings College Wimbledon II,5,1,2.0,6
16413547,Old Alleynians AFC,Old Eastbournians,5,3,4.0,8
16413528,Old Salopians II,Old Harrovians II,0,3,2.0,3
16413465,Old Tonbridgians II,Old Bancroftians AFC,0,1,3.0,1
16413474,Old Stoics,Old Wykehamists II,3,2,4.0,5
16434387,Old Brentwoods II,Old Cholmeleians III,1,4,2.0,5
16434384,Old Chigwellians III,Old Merchant Taylors II,2,4,3.0,6
16434415,Old Malvernians II,Old Johnians FC,4,3,4.0,7
16589192,Old Alleynians AFC II,Old Harrovians III,1,1,4.0,2
16434430,Kings College Wimbledon III,Old Westminsters II,2,0,2.0,2
16211306,Old Strand Academicals,Old Suttonians SV,7,6,5.0,13
16539143,London Welsh F.C.,Old Aldenhamians,3,0,2.0,3
16539154,TBC,Old Sennockians,1,2,4.0,3
16357840,Old Carthusians II,Hale End Athletic,0,5,0.0,5
16635429,Old Wokingians,Old Carthusians III,0,2,2.0,2
16382912,Old Manorians,Old Aldenhamians II,2,3,4.0,5
16578184,Old Foresters III,Bealonians,3,5,4.0,8
16341284,Glynn Old Boys II,Old Etonians II,0,1,3.0,1
16412534,Old Haileyburians,Lancing Old Boys II,0,0,4.0,0
16393094,Old Brentwoods,Old Foresters,0,2,2.0,2
16393055,Old Carthusians,Lancing Old Boys,3,0,2.0,3
16393059,Old Salopians,Old Marlburians,1,3,3.0,4
16393053,KCS Old Boys,Old Harrovians,2,0,2.0,2
16394130,Old Wellingtonians,Old Cholmeleians,2,1,4.0,3
16394148,Old Radleians,Old Chigwellians,0,4,1.0,4
16394137,Old Millfieldians,Old Malvernians,1,1,4.0,2
16412491,Old Sennockians,Old Berkhamstedians,1,3,3.0,4
16412560,Old Etonians II,Old Westminsters,2,3,4.0,5
16412489,Old Carthusians III,Old Carthusians II,1,1,4.0,2
16413529,Old Harrovians II,Old Alleynians AFC,1,2,4.0,3
16413559,Old Epsomians,Old Chigwellians II,0,2,2.0,2
16413486,Old Stoics,Old Haberdashers,3,2,4.0,5
16434386,Old Merchant Taylors II,Old Brentwoods III,4,2,3.0,6
16434394,Old Foresters III,Old Brentwoods II,3,3,5.0,6
16589182,Old Alleynians AFC II,Kings College Wimbledon III,2,1,4.0,3
16223442,Civil Service II,Kings College Wimbledon II,8,1,0.0,9
16223459,Old Tiffinians,Old Aldenhamians II,3,7,2.0,10
16578112,Old Cholmeleians II,Old Ignatians,1,0,3.0,1
16271827,Old Salopians II,Economicals,2,1,4.0,3
16357847,Old Reptonians,Old Uffingtonians FC,2,3,4.0,5
16357841,New-Magdalen AFC,Old Aldenhamians,1,0,3.0,1
16382911,Old Chigwellians III,Old Aloysians,2,5,2.0,7
16341285,Old Rugbeians,Old Esthameians,1,4,2.0,5
16341295,Old Merchant Taylors,Old Parkonians,1,6,0.0,7
16533141,Old Etonians,Old Wilsonians,1,0,3.0,1
16535131,Old Shirburnians,Old Columbans,4,1,2.0,5
16412490,Old Haileyburians,Old Foresters II,0,5,0.0,5
16393087,Old Salopians,Old Etonians,1,1,4.0,2
16393070,Old Tonbridgians,Old Harrovians,3,1,3.0,4
16393058,Old Brentwoods,KCS Old Boys,2,3,4.0,5
16393090,Old Marlburians,Old Carthusians,0,2,2.0,2
16394078,Old Reptonians,Old Cholmeleians,4,0,1.0,4
16394106,Old Millfieldians,Old Chigwellians,1,1,4.0,2
16394116,Old Wykehamists,Old Radleians,1,0,3.0,1
16394109,Old Malvernians,Old Bradfieldians,2,6,2.0,8
16394150,Old Aldenhamians,Old Wellingtonians,6,1,0.0,7
16412527,Old Westminsters,Old Berkhamstedians,4,5,5.0,9
16412507,Old Foresters II,Lancing Old Boys II,2,3,4.0,5
16412551,Old Carthusians III,Old Sennockians,5,1,2.0,6
16413523,Old Epsomians,Old Aldenhamians II,6,1,0.0,7
16413485,Old Cholmeleians II,Old Bancroftians AFC,0,6,0.0,6
16413456,Old Suttonians SV,Old Haberdashers,4,3,4.0,7
16413502,Old Wykehamists II,Old Tonbridgians II,0,6,0.0,6
16434368,Old Cholmeleians III,Old Brentwoods III,1,2,4.0,3
16589178,Old Alleynians AFC II,Old Johnians FC,3,3,5.0,6
16434426,Old Harrovians III,Old Amplefordians,2,5,2.0,7
16223428,Old Salopians II,AFC Oldsmiths,2,1,4.0,3
16223430,Economicals,Old Carthusians II,2,2,5.0,4
16223429,Old Brentwoods II,Royal Bank of Scotland,0,4,1.0,4
16271782,Lancing Old Boys,Sinjun Grammarians,2,3,4.0,5
16340732,Toby Football Club,Old Foresters,4,1,2.0,5
16412540,Kings College Wimbledon II,Old Haileyburians,4,3,4.0,7
16393139,Old Carthusians,Old Harrovians,4,0,1.0,4
16393057,Old Brentwoods,Old Tonbridgians,1,5,2.0,6
16393100,KCS Old Boys,Old Marlburians,1,1,4.0,2
16393099,Old Foresters,Old Etonians,4,2,3.0,6
16394073,Old Radleians,Old Aldenhamians,1,4,2.0,5
16394090,Old Chigwellians,Old Cholmeleians,1,3,3.0,4
16394082,Old Wykehamists,Old Millfieldians,4,3,4.0,7
16394076,Old Bradfieldians,Old Wellingtonians,4,2,3.0,6
16412486,Old Berkhamstedians,Old Foresters II,1,3,3.0,4
16412498,Kings College Wimbledon II,Lancing Old Boys II,1,2,4.0,3
16412562,Old Etonians II,Old Carthusians II,3,3,5.0,6
16413542,Old Harrovians II,Old Aldenhamians II,4,0,1.0,4
16413543,Old Chigwellians II,Old Alleynians AFC,2,4,3.0,6
16413560,Old Citizens,Old Eastbournians,2,0,2.0,2
16413501,Old Stoics,Old Cholmeleians II,3,2,4.0,5
16413449,Old Tonbridgians II,Old Haberdashers,2,3,4.0,5
16413490,Old Bancroftians AFC,Old Merchant Taylors,2,2,5.0,4
16434371,Old Brentwoods III,Old Merchant Taylors II,1,4,2.0,5
16434369,Old Chigwellians III,Old Foresters III,1,1,4.0,2
16434408,Old Amplefordians,Old Rugbeians,1,2,4.0,3
16357852,Hale End Athletic,Old Brentwoods II,3,4,4.0,7
16412524,Old Haileyburians,Old Carthusians III,0,11,0.0,11
16239425,Old Salopians,Shrewsbury School 1st XI,1,2,4.0,3
16243221,Old Salopians II,Shrewsbury School 2nd XI,4,0,1.0,4
16393128,Old Etonians,Old Harrovians,3,1,3.0,4
16393079,Old Marlburians,Lancing Old Boys,0,2,2.0,2
16393051,Old Salopians,Old Brentwoods,1,1,4.0,2
16393054,Old Foresters,KCS Old Boys,2,1,4.0,3
16394069,Old Cholmeleians,Old Aldenhamians,4,2,3.0,6
16394113,Old Millfieldians,Old Bradfieldians,7,0,0.0,7
16394071,Old Wellingtonians,Old Wykehamists,1,3,3.0,4
16394114,Old Malvernians,Old Chigwellians,0,3,2.0,3
16394087,Old Reptonians,Old Radleians,3,1,3.0,4
16412528,Lancing Old Boys II,Old Etonians II,3,1,3.0,4
16412487,Old Foresters II,Old Sennockians,2,4,3.0,6
16412552,Old Berkhamstedians,Old Westminsters,1,1,4.0,2
16413521,Old Eastbournians,Old Harrovians II,2,6,2.0,8
16413509,Old Aldenhamians II,Old Chigwellians II,0,2,2.0,2
16413510,Old Epsomians,Old Salopians II,3,0,2.0,3
16413512,Old Alleynians AFC,Old Citizens,3,1,3.0,4
16413496,Old Wykehamists II,Old Haberdashers,1,4,2.0,5
16413480,Old Suttonians SV,Old Merchant Taylors,1,1,4.0,2
16434370,Old Merchant Taylors II,Old Cholmeleians III,1,2,4.0,3
16434421,Old Harrovians III,Old Johnians FC,0,3,2.0,3
16434410,Kings College Wimbledon III,Old Amplefordians,2,2,5.0,4
16434442,Old Rugbeians,Old Malvernians II,4,2,3.0,6
16223465,Old Westminsters II,Civil Service III,0,7,0.0,7
16223445,Old Challoners,Old Cholmeleians II,0,1,3.0,1
16561178,Old Brentwoods II,Old Alleynians AFC,2,4,3.0,6
16252206,Old Carthusians,Charterhouse School 1st XI,3,2,4.0,5
16252204,Old Carthusians II,Charterhouse School 2nd XI,4,1,2.0,5
16252203,Old Carthusians III,Charterhouse School 3rd XI,3,0,2.0,3
16399019,Old Tonbridgians,Tonbridge School 1st XI,3,1,3.0,4
16399018,Old Tonbridgians II,Tonbridge School 2nd XI,5,0,0.0,5
16552781,Old Brentwoods II,Old Barryians,0,5,0.0,5
16393069,Lancing Old Boys,Old Foresters,4,4,6.0,8
16393049,Old Brentwoods,Old Carthusians,0,3,2.0,3
16393050,Old Tonbridgians,Old Marlburians,3,0,2.0,3
16393076,Old Etonians,KCS Old Boys,0,4,1.0,4
16394067,Old Reptonians,Old Bradfieldians,1,2,4.0,3
16394097,Old Radleians,Old Cholmeleians,2,2,5.0,4
16394088,Old Wykehamists,Old Chigwellians,2,0,2.0,2
16394143,Old Wellingtonians,Old Malvernians,0,1,3.0,1
16412570,Lancing Old Boys II,Old Berkhamstedians,0,1,3.0,1
16412495,Kings College Wimbledon II,Old Etonians II,1,1,4.0,2
16412529,Old Carthusians II,Old Foresters II,0,2,2.0,2
16413507,Old Citizens,Old Aldenhamians II,2,1,4.0,3
16413525,Old Epsomians,Old Alleynians AFC,2,3,4.0,5
16413517,Old Eastbournians,Old Chigwellians II,4,2,3.0,6
16413479,Old Wykehamists II,Old Bancroftians AFC,4,3,4.0,7
16413459,Old Merchant Taylors,Old Cholmeleians II,3,2,4.0,5
16413499,Old Haberdashers,Old Stoics,2,1,4.0,3
16434367,Old Merchant Taylors II,Old Brentwoods II,0,0,4.0,0
16434391,Old Foresters III,Old Brentwoods III,1,7,0.0,8
16434412,Old Johnians FC,Old Rugbeians,3,4,4.0,7
16434439,Old Malvernians II,Old Westminsters II,2,2,5.0,4
16211312,Old Millfieldians,Hale End Athletic,1,2,4.0,3
16211303,Old Pegasonians F.C.,Old Aldenhamians,1,3,3.0,4
16211304,Old Westminsters,Old Tollingtonians,1,2,4.0,3
16211302,Old Boilers FC,Old Haileyburians,5,0,0.0,5
16211305,Old Challoners,Old Sennockians,0,0,4.0,0
16223446,Old Carthusians III,Carshalton,2,3,4.0,5
16240769,Old Harrovians,Harrow School 1st XI,0,0,4.0,0
16240768,Old Harrovians II,Harrow School 2nd XI,0,0,4.0,0
16240767,Old Harrovians III,Harrow School 3rd XI,0,0,4.0,0
16393086,Old Foresters,Old Salopians,5,1,2.0,6
16393046,Old Carthusians,KCS Old Boys,3,1,3.0,4
16394154,Old Aldenhamians,Old Chigwellians,0,3,2.0,3
16394065,Old Wykehamists,Old Cholmeleians,2,1,4.0,3
16412482,Old Sennockians,Old Carthusians II,1,4,2.0,5
16412566,Old Berkhamstedians,Old Carthusians III,1,3,3.0,4
16412484,Kings College Wimbledon II,Old Westminsters,0,7,0.0,7
16412483,Old Foresters II,Old Etonians II,0,2,2.0,2
16413534,Old Eastbournians,Old Alleynians AFC,1,2,4.0,3
16413522,Old Citizens,Old Chigwellians II,0,1,3.0,1
16413506,Old Harrovians II,Old Epsomians,1,4,2.0,5
16413493,Old Haberdashers,Old Suttonians SV,6,2,2.0,8
16413504,Old Bancroftians AFC,Old Tonbridgians II,1,4,2.0,5
16413495,Old Wykehamists II,Old Merchant Taylors,1,4,2.0,5
16434393,Old Foresters III,Old Merchant Taylors II,1,4,2.0,5
16434366,Old Cholmeleians III,Old Chigwellians III,0,6,0.0,6
16434407,Old Amplefordians,Old Malvernians II,5,1,2.0,6
16434404,Kings College Wimbledon III,Old Harrovians III,4,0,1.0,4
16434405,Old Johnians FC,Old Westminsters II,4,1,2.0,5
16311080,Old Brentwoods,Brentwood School 1st XI,5,1,2.0,6
16311079,Old Brentwoods II,Brentwood School 2nd XI,4,0,1.0,4
16173509,Lancing Old Boys,Lancing College 1st XI,0,3,2.0,3
16424346,Old Marlburians,Marlborough College 1st XI,9,0,0.0,9
16153999,KCS Old Boys,Old Harrovians,2,1,4.0,3
16443351,Old Amplefordians,Old Sennockians,2,6,2.0,8
16341177,Old Tonbridgians,Old Parmiterians,1,6,0.0,7
16173508,Old Suttonians SV,Old Rugbeians,5,5,6.0,10
16434328,Old Suttonians,Old Carthusians,0,0,4.0,0
16173522,Old Brentwoods,Old Chigwellians,3,2,4.0,5
16173521,Old Alleynians AFC,Old Harrovians II,0,1,3.0,1
16195968,Lancing Old Boys,Old Salopians,4,1,2.0,5
16196067,Worcester College Old Boys,Kings College Wimbledon II,1,3,3.0,4
16434329,Old Marlburians,Old Carthusians II,2,1,4.0,3
16205461,Old Reptonians,Repton School 1st XI,2,1,4.0,3
16154161,Old Etonians,Eton College 1st XI,3,3,5.0,6
16195967,Old Hamptonians,Lancing Old Boys,5,2,2.0,7
16196079,Kings College Wimbledon II,Kings College Wimbledon III,0,0,4.0,0
16196078,Kings College Wimbledon III,KCS Old Boys,0,0,4.0,0
16196080,Kings College Wimbledon II,KCS Old Boys,0,0,4.0,0
16380131,Old Garchonians,Old Cholmeleians,3,0,2.0,3
16154000,Old Foresters,Old Brentwoods,2,0,2.0,2
16195966,Corinthian-Casuals,Lancing Old Boys,3,3,5.0,6
16303007,Old Reptonians,Old Salopians,0,2,2.0,2
16154706,Old Marlburians,Old Harrovians,5,5,6.0,10
16271790,Old Alleynians AFC,Old Harrovians II,4,6,4.0,10
16154159,PWC Select XI,Old Etonians,2,3,4.0,5
16196019,Old Salopians,KCS Old Boys,1,4,2.0,5
16154747,Old Stoics,Old Harrovians,1,8,0.0,9
16154176,Harold Wood FC,Old Brentwoods,1,7,0.0,8
16154158,Honourable Artillery Company,Old Etonians,4,1,2.0,5
18021103,Arthurian League Representative Team,Herts Senior County League,1,3,3.0,4
17517339,Old Foresters,Old Carthusians,3,4,4.0,7
18230300,Albanian FC,Old Chigwellians Vets,1,2,4.0,3
17517410,Old Carthusians,Old Salopians,4,4,6.0,8
17517347,Old Carthusians,Old Wykehamists,2,2,5.0,4
17517352,Old Foresters,KCS Old Boys,3,0,2.0,3
17507341,Old Wellingtonians,Old Aldenhamians,1,2,4.0,3
17507344,Old Berkhamstedians,Old Reptonians,3,2,4.0,5
17507314,Old Aldenhamians,Old Wellingtonians,1,0,3.0,1
17519463,Old Harrovians II,Old Foresters II,1,3,3.0,4
17519475,Old Etonians II,Old Westminsters,1,4,2.0,5
18222743,Old Harrovians III,Old Columbans,1,2,4.0,3
17517380,Old Carthusians,Old Tonbridgians,3,3,5.0,6
17517387,Old Salopians,Old Foresters,1,1,4.0,2
17519446,Kings College Wimbledon II,Old Westminsters,3,3,5.0,6
17519477,Old Foresters II,Lancing Old Boys II,0,2,2.0,2
17508783,Old Sennockians,Old Aldenhamians II,0,1,3.0,1
17508759,Old Salopians II,Old Tonbridgians II,0,0,4.0,0
17508765,Old Haberdashers,Old Citizens,0,10,0.0,10
17524132,Old Foresters III,Old Cholmeleians II,0,5,0.0,5
18161843,Old Carthusians,Old Tonbridgians,3,3,5.0,6
18191691,Old Kimboltonians,Old Alleynians AFC,1,2,4.0,3
18186744,Old Rugbeians,Old Johnians FC,1,2,4.0,3
18214415,Old Shirburnians,Old Columbans,0,3,2.0,3
18214416,Old Brentwoods III,Old Harrovians III,1,6,0.0,7
18116557,Old Etonians II,Old Suttonians,1,0,3.0,1
17517354,Old Carthusians,Old Marlburians,6,2,2.0,8
18208034,Old Foresters Vets,Old Malvernians Vets,2,4,3.0,6
18207979,Old Bradfieldians Vets,Old Haileyburians Vets,1,0,3.0,1
17517393,Old Wykehamists,Old Foresters,0,3,2.0,3
17517366,Old Salopians,Old Carthusians,0,0,4.0,0
17517399,Lancing Old Boys,Old Marlburians,2,2,5.0,4
17507327,Old Reptonians,Old Bradfieldians,1,3,3.0,4
17507359,Old Berkhamstedians,Old Malvernians,0,1,3.0,1
17519483,Old Radleians,Old Harrovians II,5,3,4.0,8
17519484,Old Foresters II,Old Westminsters,4,4,6.0,8
17519438,Kings College Wimbledon II,Lancing Old Boys II,3,0,2.0,3
17519468,Old Etonians II,Old Alleynians AFC,1,3,3.0,4
17508787,Old Chigwellians II,Old Aldenhamians II,2,0,2.0,2
17508779,Old Sennockians,Old Eastbournians,2,1,4.0,3
17508748,Old Tonbridgians II,Old Merchant Taylors,2,5,2.0,7
17526757,Old Stoics,Old Rugbeians,1,7,0.0,8
17526763,Old Merchant Taylors II,Old Suttonians SV,1,4,2.0,5
17524125,Old Columbans,Old Brentwoods III,3,1,3.0,4
17524126,Old Cholmeleians II,Old Chigwellians III,3,1,3.0,4
17527241,Old Harrovians III,Old Westminsters II,4,1,2.0,5
17527215,Old Amplefordians,Kings College Wimbledon III,2,2,5.0,4
18098816,Old Foresters Vets,Old Brentwoods Vets,2,1,4.0,3
18188179,Old Bradfieldians Vets,Old Carthusians Vets,3,0,2.0,3
18181342,Old Haileyburians Vets,Old Westminsters Vets,5,3,4.0,8
17517364,Old Tonbridgians,Old Chigwellians,1,1,4.0,2
17517382,KCS Old Boys,Old Foresters,1,4,2.0,5
17507358,Old Cholmeleians,Old Harrovians,0,3,2.0,3
17507324,Old Reptonians,Old Brentwoods,0,4,1.0,4
17507357,Old Aldenhamians,Old Bradfieldians,1,7,0.0,8
17519488,Old Etonians II,Old Carthusians II,0,1,3.0,1
17519435,Old Carthusians II,Old Etonians II,0,1,3.0,1
17519465,Old Alleynians AFC,Old Westminsters,3,2,4.0,5
17519428,Old Carthusians III,Old Radleians,0,8,0.0,8
17519456,Old Foresters II,Kings College Wimbledon II,2,2,5.0,4
17508763,Old Merchant Taylors,Old Salopians II,3,3,5.0,6
17508737,Old Tonbridgians II,Old Citizens,0,9,0.0,9
17526745,Old Rugbeians,Old Suttonians SV,1,1,4.0,2
17526765,Old Bancroftians AFC,Old Johnians FC,1,1,4.0,2
17526741,Old Merchant Taylors II,Old Stoics,0,3,2.0,3
17526755,Old Alleynians AFC II,Old Wykehamists II,6,1,0.0,7
17524123,Old Columbans,Old Foresters III,4,0,1.0,4
17524121,Old Brentwoods III,Old Chigwellians III,2,0,2.0,2
17527234,Old Amplefordians,Old Harrovians III,1,2,4.0,3
17527242,Old Westminsters II,Old Epsomians II,1,2,4.0,3
18072064,Old Carthusians,Old Hamptonians,1,0,3.0,1
17517404,Old Etonians,Old Carthusians,1,2,4.0,3
18180527,Old Harrovians Vets,Old Malvernians Vets,4,6,4.0,10
18091583,Old Carthusians Vets,Old Berkhamstedians Vets,2,0,2.0,2
17517368,KCS Old Boys,Lancing Old Boys,3,3,5.0,6
17517356,Old Etonians,Old Tonbridgians,1,7,0.0,8
17517348,Old Carthusians,Old Chigwellians,1,0,3.0,1
17517325,Old Salopians,Old Wykehamists,3,4,4.0,7
17507372,Old Cholmeleians,Old Berkhamstedians,5,0,0.0,5
17507382,Old Brentwoods,Old Reptonians,3,2,4.0,5
17507339,Old Bradfieldians,Old Malvernians,4,1,2.0,5
17519447,Old Carthusians II,Lancing Old Boys II,0,1,3.0,1
17519482,Old Etonians II,Old Carthusians III,1,0,3.0,1
17519423,Old Radleians,Kings College Wimbledon II,2,2,5.0,4
17508709,Old Epsomians,Old Salopians II,6,0,0.0,6
17508713,Old Citizens,Old Sennockians,6,3,3.0,9
17526762,Old Stoics,Old Alleynians AFC II,8,5,3.0,13
17527240,Old Amplefordians,Old King's Scholars,2,1,4.0,3
18138971,Old Kimboltonians,Old Harrovians II,2,0,2.0,2
18160886,Old Alleynians AFC,Old Foresters II,2,1,4.0,3
18173874,Old Johnians FC,Old Harrovians III,6,1,0.0,7
18176093,Old Columbans,Old Rugbeians,2,4,3.0,6
18116070,Worcester College Old Boys,Old Foresters,1,4,2.0,5
18141331,Old Bancroftians AFC,Bancroft's School 1st XI,6,1,0.0,7
18139878,Old Westminsters,Westminster School 1st XI,2,3,4.0,5
18139879,Old Westminsters II,Westminster School 2nd XI,1,2,4.0,3
17517333,Old Carthusians,Lancing Old Boys,3,0,2.0,3
17517377,Old Tonbridgians,Old Foresters,1,5,2.0,6
17517362,KCS Old Boys,Old Wykehamists,2,5,2.0,7
17519416,Old Westminsters,Old Carthusians III,3,3,5.0,6
17519480,Kings College Wimbledon II,Old Alleynians AFC,1,3,3.0,4
17508766,Old Sennockians,Old Epsomians,1,2,4.0,3
17527221,Old Westminsters II,Old Harrovians III,4,2,3.0,6
18133107,Old Johnians FC,Old Alleynians AFC II,3,1,3.0,4
17834414,Old Amplefordians,Ampleforth College 1st XI,0,1,3.0,1
18152378,Old Bradfieldians,Bradfield College,3,2,4.0,5
18141496,Old Rugbeians,Rugby School,2,0,2.0,2
17930304,AFC Representative Team,Arthurian League Representative Team,5,5,6.0,10
17517340,Old Salopians,Old Etonians,2,2,5.0,4
17517409,Old Chigwellians,Old Marlburians,5,0,0.0,5
17507345,Old Harrovians,Old Aldenhamians,1,2,4.0,3
17519436,Old Westminsters,Old Foresters II,1,1,4.0,2
17519405,Old Carthusians III,Lancing Old Boys II,1,5,2.0,6
17519406,Old Carthusians II,Old Alleynians AFC,1,2,4.0,3
17519412,Old Harrovians II,Old Etonians II,3,0,2.0,3
17508702,Old Tonbridgians II,Old Haberdashers,0,4,1.0,4
17508715,Old Chigwellians II,Old Citizens,3,2,4.0,5
17508784,Old Eastbournians,Old Epsomians,2,3,4.0,5
17508772,Old Salopians II,Old Sennockians,1,0,3.0,1
17508752,Old Aldenhamians II,Old Merchant Taylors,2,7,0.0,9
17526756,Old Alleynians AFC II,Old Bancroftians AFC,1,3,3.0,4
17526769,Old Suttonians SV,Old Wykehamists II,6,2,2.0,8
17526729,Old Johnians FC,Old Stoics,4,0,1.0,4
17527230,Kings College Wimbledon III,Old Epsomians II,1,0,3.0,1
17527244,Old King's Scholars,Old Shirburnians,4,1,2.0,5
17527207,Old Epsomians II,Kings College Wimbledon III,0,1,3.0,1
18122410,Old Carthusians,Old Foresters,2,1,4.0,3
18133111,Old Reptonians,Old Tonbridgians,1,2,4.0,3
18097367,Old Westminsters,Old Foresters II,1,2,4.0,3
18115441,Old Brentwoods III,Old Harrovians III,1,3,3.0,4
18115121,Old Cholmeleians II,Old Rugbeians,0,2,2.0,2
18101143,Old Malvernians,Malvern College 1st XI,2,1,4.0,3
17526770,Old Rugbeians,Old Wykehamists II,2,3,4.0,5
17517403,Old Etonians,Old Foresters,1,3,3.0,4
17517381,Old Marlburians,Old Carthusians,2,5,2.0,7
17517338,Lancing Old Boys,KCS Old Boys,1,3,3.0,4
17507349,Old Cholmeleians,Old Reptonians,1,1,4.0,2
17507369,Old Brentwoods,Old Malvernians,4,2,3.0,6
17519487,Old Carthusians II,Old Westminsters,2,3,4.0,5
17519464,Kings College Wimbledon II,Old Radleians,0,1,3.0,1
17519449,Old Foresters II,Old Carthusians III,2,0,2.0,2
17508720,Old Tonbridgians II,Old Chigwellians II,1,1,4.0,2
17508767,Old Eastbournians,Old Salopians II,3,4,4.0,7
17508769,Old Epsomians,Old Aldenhamians II,1,4,2.0,5
17526736,Old Johnians FC,Old Bancroftians AFC,4,2,3.0,6
17526747,Old Stoics,Old Wykehamists II,2,3,4.0,5
17526728,Old Rugbeians,Old Merchant Taylors II,2,2,5.0,4
17524118,Old Columbans,Old Brentwoods II,5,0,0.0,5
17524135,Old Brentwoods III,Old Foresters III,6,1,0.0,7
17524103,Old Cholmeleians II,Old Albanians SA,3,3,5.0,6
17527199,Old Shirburnians,Old Amplefordians,1,0,3.0,1
17988379,Old Salopians,Old Tonbridgians,0,1,3.0,1
18083283,Old Alleynians AFC,Lancing Old Boys II,9,0,0.0,9
18083131,Old Etonians II,Old Kimboltonians,2,3,4.0,5
18097639,Old Harrovians II,Old Citizens,6,1,0.0,7
18115149,Old Suttonians SV,Old Alleynians AFC II,3,7,2.0,10
18031867,Old Tonbridgians Vets,Old Westminsters Vets,2,7,0.0,9
17517384,Old Carthusians,Old Etonians,3,0,2.0,3
17517335,Old Wykehamists,Old Tonbridgians,3,2,4.0,5
17517400,Old Chigwellians,Old Salopians,1,4,2.0,5
17507352,Old Wellingtonians,Old Reptonians,2,3,4.0,5
17507328,Old Brentwoods,Old Cholmeleians,2,1,4.0,3
17507304,Old Berkhamstedians,Old Bradfieldians,1,3,3.0,4
17519472,Kings College Wimbledon II,Old Foresters II,2,3,4.0,5
17519461,Old Etonians II,Lancing Old Boys II,1,2,4.0,3
17519448,Old Radleians,Old Alleynians AFC,1,3,3.0,4
17519458,Old Westminsters,Old Carthusians II,1,4,2.0,5
17519485,Old Harrovians II,Old Carthusians III,1,1,4.0,2
17508771,Old Merchant Taylors,Old Eastbournians,3,2,4.0,5
17508712,Old Haberdashers,Old Epsomians,1,2,4.0,3
17508758,Old Aldenhamians II,Old Sennockians,3,2,4.0,5
17526766,Old Merchant Taylors II,Old Wykehamists II,8,2,0.0,10
17526730,Old Bancroftians AFC,Old Alleynians AFC II,2,1,4.0,3
17524111,Old Albanians SA,Old Columbans,3,5,4.0,8
18069253,Old Foresters III,Old Harrovians III,2,2,5.0,4
18069431,Old Stoics,Kings College Wimbledon III,2,1,4.0,3
18052653,Old Amplefordians,Old Cholmeleians II,0,2,2.0,2
18038753,Old Suttonians SV,Old Chigwellians III,4,3,4.0,7
18083215,Old Johnians FC,Old Westminsters II,5,1,2.0,6
18074725,Old Foresters,Altis,2,2,5.0,4
18031182,Lancing Old Boys Vets,Old Foresters Vets,3,4,4.0,7
17517408,Old Etonians,Old Chigwellians,5,4,5.0,9
17517401,Old Marlburians,KCS Old Boys,2,3,4.0,5
17507384,Old Harrovians,Old Malvernians,7,4,3.0,11
17519466,Old Carthusians III,Kings College Wimbledon II,2,1,4.0,3
17508770,Old Haberdashers,Old Chigwellians II,0,1,3.0,1
17508742,Old Merchant Taylors,Old Citizens,0,2,2.0,2
17526768,Old Johnians FC,Old Suttonians SV,2,1,4.0,3
17988377,Old Foresters,Lancing Old Boys,2,0,2.0,2
17988378,Old Alleynians AFC,Old Carthusians,1,4,2.0,5
18009459,Old Reptonians,Old Westminsters,3,0,2.0,3
18083958,Old Sennockians,Old Harrovians II,2,3,4.0,5
18083208,Old Foresters II,Old Tonbridgians II,2,1,4.0,3
18069206,Old Columbans,Old King's Scholars,5,0,0.0,5
18052651,Old Epsomians II,Old Rugbeians,1,4,2.0,5
18052652,Old Brentwoods III,Old Merchant Taylors II,3,2,4.0,5
18031866,Old Salopians Vets,Old Bradfieldians Vets,1,2,4.0,3
18038665,Old King's Scholars,"The King's School, Canterbury",1,4,2.0,5
17517391,Old Tonbridgians,Lancing Old Boys,4,3,4.0,7
17517365,Old Carthusians,Old Foresters,1,1,4.0,2
17517383,Old Etonians,Old Salopians,3,2,4.0,5
17517392,Old Marlburians,Old Chigwellians,0,3,2.0,3
17507376,Old Brentwoods,Old Aldenhamians,7,3,2.0,10
17507325,Old Wellingtonians,Old Harrovians,1,8,0.0,9
17507379,Old Reptonians,Old Cholmeleians,4,0,1.0,4
17507320,Old Malvernians,Old Bradfieldians,2,6,2.0,8
17519424,Old Harrovians II,Old Carthusians II,2,2,5.0,4
17508757,Old Epsomians,Old Haberdashers,2,5,2.0,7
17508768,Old Merchant Taylors,Old Tonbridgians II,0,1,3.0,1
17508788,Old Salopians II,Old Eastbournians,2,2,5.0,4
17526743,Old Stoics,Old Bancroftians AFC,4,0,1.0,4
17526758,Old Johnians FC,Old Wykehamists II,7,0,0.0,7
17524124,Old Albanians SA,Old Brentwoods II,2,0,2.0,2
17524120,Old Chigwellians III,Old Foresters III,1,0,3.0,1
17527200,Old Harrovians III,Old Epsomians II,1,0,3.0,1
18020272,Old Sennockians,Old Columbans,4,3,4.0,7
18052222,Old Alleynians AFC,Old Merchant Taylors II,7,1,0.0,8
18051946,Old Rugbeians,Old Westminsters,1,2,4.0,3
18069130,Kings College Wimbledon II,Old Etonians II,1,6,0.0,7
18052221,Lancing Old Boys II,Old Alleynians AFC II,3,1,3.0,4
18051949,Old Citizens,Old Radleians,7,2,0.0,9
18020266,Old Suttonians SV,Old Foresters II,2,2,5.0,4
18038662,Old Kingstonians KGS,Old Westminsters II,1,3,3.0,4
18035775,Old Actonians Association FC,KCS Old Boys,4,3,4.0,7
17930313,Old Brentwoods Vets,Old Wykehamists Vets,2,0,2.0,2
17966212,Old Etonians Vets,Old Malvernians Vets,2,3,4.0,5
17517372,KCS Old Boys,Old Chigwellians,1,0,3.0,1
17517411,Old Etonians,Old Wykehamists,1,4,2.0,5
17517361,Old Foresters,Old Tonbridgians,2,1,4.0,3
17507332,Old Brentwoods,Old Harrovians,4,1,2.0,5
17507340,Old Aldenhamians,Old Reptonians,1,6,0.0,7
17507356,Old Berkhamstedians,Old Wellingtonians,4,2,3.0,6
17507318,Old Cholmeleians,Old Malvernians,1,1,4.0,2
17519445,Old Foresters II,Old Radleians,3,1,3.0,4
17519478,Old Carthusians III,Old Alleynians AFC,1,4,2.0,5
17519481,Lancing Old Boys II,Old Carthusians II,2,2,5.0,4
17519470,Old Westminsters,Old Harrovians II,0,1,3.0,1
17508738,Old Chigwellians II,Old Merchant Taylors,0,1,3.0,1
17508754,Old Tonbridgians II,Old Sennockians,0,1,3.0,1
17508728,Old Epsomians,Old Citizens,0,2,2.0,2
17526746,Old Merchant Taylors II,Old Rugbeians,0,3,2.0,3
18020273,Old Aldenhamians II,Kings College Wimbledon II,2,3,4.0,5
18038751,Old Stoics,Old Albanians SA,3,2,4.0,5
18038661,Old Harrovians III,Old Bancroftians AFC,3,1,3.0,4
18038752,Old Johnians FC,Old Brentwoods II,3,2,4.0,5
18038755,Old Wykehamists II,Old King's Scholars,1,5,2.0,6
18038754,Old Shirburnians,Old Alleynians AFC II,3,4,4.0,7
18010962,Old Carthusians,Clapham Old Xaverians,4,1,2.0,5
17987962,Bealonians,Old Etonians II,0,2,2.0,2
17517385,Old Chigwellians,Old Wykehamists,1,4,2.0,5
17517373,Lancing Old Boys,Old Tonbridgians,1,3,3.0,4
17517359,Old Foresters,Old Marlburians,2,1,4.0,3
17517407,Old Salopians,KCS Old Boys,2,1,4.0,3
17507367,Old Harrovians,Old Berkhamstedians,5,3,4.0,8
17507385,Old Reptonians,Old Wellingtonians,6,2,2.0,8
17507323,Old Bradfieldians,Old Aldenhamians,8,2,0.0,10
17524130,Old Brentwoods III,Old Albanians SA,1,3,3.0,4
17524122,Old Brentwoods II,Old Cholmeleians II,3,3,5.0,6
17527239,Old Westminsters II,Old Shirburnians,2,4,3.0,6
17527231,Old King's Scholars,Old Harrovians III,1,1,4.0,2
18020267,Old Haberdashers,Old Merchant Taylors II,1,6,0.0,7
18020290,Old Tonbridgians II,Old Bancroftians AFC,6,1,0.0,7
18020268,Old Kimboltonians,Old Chigwellians II,3,1,3.0,4
18020270,Old Stoics,Old Westminsters,1,6,0.0,7
18020262,Old Foresters III,Old Alleynians AFC,1,5,2.0,6
18020263,Old Alleynians AFC II,Old Carthusians II,2,1,4.0,3
18020271,Old Etonians II,Old Eastbournians,2,0,2.0,2
18020275,Old Epsomians,Old Rugbeians,2,5,2.0,7
18020274,Old Carthusians III,Old Salopians II,4,2,3.0,6
18020265,Old Wykehamists II,Old Citizens,2,4,3.0,6
18020260,Old Radleians,Old Merchant Taylors,3,2,4.0,5
17668164,Old Haileyburians Vets,Old Foresters Vets,2,4,3.0,6
17872838,Old Reptonians Vets,Old Harrovians Vets,2,5,2.0,7
17517386,Old Chigwellians,Lancing Old Boys,2,0,2.0,2
17517379,Old Foresters,Old Etonians,4,0,1.0,4
17517414,Old Wykehamists,Old Salopians,2,1,4.0,3
17507346,Old Bradfieldians,Old Berkhamstedians,4,2,3.0,6
17507306,Old Harrovians,Old Reptonians,5,2,2.0,7
17507383,Old Cholmeleians,Old Wellingtonians,2,2,5.0,4
17507333,Old Aldenhamians,Old Malvernians,2,2,5.0,4
17519479,Old Etonians II,Old Radleians,2,5,2.0,7
17519430,Old Foresters II,Old Alleynians AFC,3,4,4.0,7
17519462,Old Carthusians II,Old Carthusians III,0,1,3.0,1
17519476,Old Westminsters,Kings College Wimbledon II,3,1,3.0,4
17508778,Old Citizens,Old Chigwellians II,1,5,2.0,6
17508707,Old Eastbournians,Old Tonbridgians II,1,2,4.0,3
17508760,Old Haberdashers,Old Aldenhamians II,1,3,3.0,4
17508780,Old Merchant Taylors,Old Epsomians,2,3,4.0,5
17526748,Old Suttonians SV,Old Johnians FC,0,0,4.0,0
17526740,Old Bancroftians AFC,Old Rugbeians,0,8,0.0,8
17526744,Old Alleynians AFC II,Old Merchant Taylors II,1,0,3.0,1
17524119,Old Cholmeleians II,Old Brentwoods III,1,3,3.0,4
17524102,Old Foresters III,Old Columbans,1,2,4.0,3
17527228,Old Epsomians II,Old Harrovians III,0,1,3.0,1
17527235,Kings College Wimbledon III,Old King's Scholars,2,4,3.0,6
17527233,Old Amplefordians,Old Westminsters II,1,2,4.0,3
17953163,KCS Old Boys,Queen Mary College Old Boys,3,3,5.0,6
17896317,Old Parkonians,Old Carthusians,4,3,4.0,7
17517397,Lancing Old Boys,Old Wykehamists,1,0,3.0,1
17517390,Old Chigwellians,Old Tonbridgians,1,3,3.0,4
17517336,Old Marlburians,Old Etonians,2,3,4.0,5
17507368,Old Aldenhamians,Old Cholmeleians,0,5,0.0,5
17519425,Old Alleynians AFC,Old Etonians II,4,0,1.0,4
17519426,Old Carthusians II,Old Foresters II,1,2,4.0,3
17519429,Lancing Old Boys II,Old Westminsters,1,6,0.0,7
17519459,Old Radleians,Old Carthusians III,4,2,3.0,6
17508764,Old Aldenhamians II,Old Chigwellians II,2,2,5.0,4
17508725,Old Citizens,Old Merchant Taylors,1,2,4.0,3
17508739,Old Haberdashers,Old Salopians II,1,4,2.0,5
17508762,Old Tonbridgians II,Old Eastbournians,1,1,4.0,2
17526727,Old Suttonians SV,Old Alleynians AFC II,2,3,4.0,5
17526760,Old Stoics,Old Merchant Taylors II,5,1,2.0,6
17524128,Old Cholmeleians II,Old Columbans,1,4,2.0,5
17527198,Old Westminsters II,Kings College Wimbledon III,6,2,2.0,8
17844623,Old Sennockians,Old Reptonians,1,9,0.0,10
17953155,Icarus,Old Foresters,1,3,3.0,4
17964665,Old Carthusians,Old Minchendenians,2,0,2.0,2
17553453,KCS Old Boys,"King's College School, Wimbledon 1st XI",6,0,0.0,6
17553454,Kings College Wimbledon II,"King's College School, Wimbledon 2nd XI",3,1,3.0,4
17793104,Old Johnians FC,St. John's School,0,0,4.0,0
17551072,Brentwood School 1st XI,Old Brentwoods,1,2,4.0,3
17551073,Brentwood School 2nd XI,Old Brentwoods II,2,4,3.0,6
17551074,Brentwood School 3rd XI,Old Brentwoods III,0,6,0.0,6
17551075,Brentwood School 4th XI,Old Brentwoods IV,0,0,4.0,0
17551076,Brentwood School 5th XI,Old Brentwoods Vets,0,0,4.0,0
17984659,Old Epsomians II,Old Epsomians,2,2,5.0,4
17668168,Old Etonians Vets,Old Tonbridgians Vets,4,2,3.0,6
17668167,Old Chigwellians Vets,Old Salopians Vets,6,2,2.0,8
17517363,Old Etonians,KCS Old Boys,3,3,5.0,6
17519474,Old Alleynians AFC,Old Radleians,0,1,3.0,1
17519420,Old Carthusians III,Old Carthusians II,1,7,0.0,8
17508719,Old Citizens,Old Aldenhamians II,2,2,5.0,4
17524109,Old Foresters III,Old Brentwoods II,1,2,4.0,3
17527226,Old Shirburnians,Old Westminsters II,5,2,2.0,7
17854117,Old Merchant Taylors,Lancing Old Boys,0,5,0.0,5
17844626,Old Westminsters,Old Suttonians SV,7,3,2.0,10
17844622,Old Berkhamstedians,Old Salopians,0,6,0.0,6
17844624,Old Aldenhamians,Old Tonbridgians,2,8,0.0,10
17901822,Old Kimboltonians,Old Albanians SA,5,2,2.0,7
17881842,Winchester College 1st XI,Old Wykehamists,1,1,4.0,2
17517345,Old Salopians,Old Chigwellians,2,3,4.0,5
17517376,Old Wykehamists,Lancing Old Boys,2,4,3.0,6
17517367,KCS Old Boys,Old Tonbridgians,2,0,2.0,2
17507312,Old Berkhamstedians,Old Brentwoods,2,3,4.0,5
17507351,Old Malvernians,Old Harrovians,2,6,2.0,8
17519453,Lancing Old Boys II,Old Foresters II,0,2,2.0,2
17519454,Old Carthusians III,Old Harrovians II,2,1,4.0,3
17519455,Old Carthusians II,Old Radleians,7,5,4.0,12
17519450,Kings College Wimbledon II,Old Etonians II,3,0,2.0,3
17508736,Old Eastbournians,Old Aldenhamians II,3,4,4.0,7
17508722,Old Epsomians,Old Merchant Taylors,1,0,3.0,1
17508710,Old Chigwellians II,Old Sennockians,2,0,2.0,2
17526759,Old Rugbeians,Old Johnians FC,1,3,3.0,4
17526761,Old Bancroftians AFC,Old Wykehamists II,2,2,5.0,4
17844627,Old Bradfieldians,Old Carthusians,0,1,3.0,1
17854211,Old Etonians,Old Alleynians AFC,0,2,2.0,2
17792841,Old Cholmeleians II,Old Suttonians SV,4,6,4.0,10
17925484,Old Ardinians,Old Amplefordians,1,1,4.0,2
17787567,Worcester College Old Boys,Old Aldenhamians,2,0,2.0,2
17780304,Old Westminsters,Putney Saint-Germain,0,6,0.0,6
17787579,Old Kingsburians,Old Foresters,1,7,0.0,8
17877649,Old Reptonians,Spaniards,0,1,3.0,1
17517370,Old Chigwellians,Old Foresters,0,1,3.0,1
17517371,Old Tonbridgians,Old Salopians,2,2,5.0,4
17517406,Old Marlburians,Old Wykehamists,2,5,2.0,7
17507371,Old Bradfieldians,Old Reptonians,3,1,3.0,4
17507319,Old Berkhamstedians,Old Aldenhamians,3,4,4.0,7
17507347,Old Wellingtonians,Old Malvernians,2,4,3.0,6
17519451,Old Harrovians II,Old Westminsters,0,5,0.0,5
17519467,Old Radleians,Lancing Old Boys II,4,0,1.0,4
17519439,Old Alleynians AFC,Old Carthusians II,1,1,4.0,2
17508755,Old Merchant Taylors,Old Chigwellians II,0,4,1.0,4
17508751,Old Eastbournians,Old Haberdashers,1,4,2.0,5
17508726,Old Sennockians,Old Tonbridgians II,1,3,3.0,4
17508750,Old Citizens,Old Epsomians,6,3,3.0,9
17508781,Old Aldenhamians II,Old Salopians II,1,1,4.0,2
17526767,Old Rugbeians,Old Bancroftians AFC,2,0,2.0,2
17526742,Old Alleynians AFC II,Old Suttonians SV,2,4,3.0,6
17524131,Old Brentwoods II,Old Chigwellians III,1,1,4.0,2
17524099,Old Brentwoods III,Old Columbans,5,1,2.0,6
17527206,Old Epsomians II,Old Westminsters II,0,5,0.0,5
17801978,Old Foresters III,Kings College Wimbledon III,4,2,3.0,6
17834402,Polytechnic,Old Carthusians,3,0,2.0,3
17834403,Old Etonians,Old Thorntonians,0,2,2.0,2
17862264,Old Brentwoods,Winchmore Hill,0,1,3.0,1
17834404,UCL Academicals,KCS Old Boys,1,5,2.0,6
17817305,Old Tenisonians,Old Etonians II,0,1,3.0,1
17909283,Southern Amateur League Rep XI,Arthurian League Representative Team,1,1,4.0,2
17925483,Old Ardinians,Old Kingstonians KGS,0,0,4.0,0
17792768,Old Ardinians,Old Kingstonians KGS,3,2,4.0,5
17517349,Lancing Old Boys,Old Foresters,1,4,2.0,5
17517350,Old Marlburians,Old Salopians,2,2,5.0,4
17517375,Old Carthusians,KCS Old Boys,1,1,4.0,2
17517351,Old Tonbridgians,Old Wykehamists,3,0,2.0,3
17507296,Old Cholmeleians,Old Aldenhamians,4,2,3.0,6
17507374,Old Malvernians,Old Reptonians,1,3,3.0,4
17507307,Old Brentwoods,Old Bradfieldians,1,2,4.0,3
17507338,Old Berkhamstedians,Old Harrovians,5,1,2.0,6
17519489,Old Carthusians III,Old Foresters II,1,3,3.0,4
17519444,Lancing Old Boys II,Old Harrovians II,1,2,4.0,3
17519422,Old Westminsters,Old Radleians,3,1,3.0,4
17508723,Old Salopians II,Old Chigwellians II,0,4,1.0,4
17508773,Old Citizens,Old Tonbridgians II,2,1,4.0,3
17508747,Old Aldenhamians II,Old Epsomians,1,1,4.0,2
17508749,Old Eastbournians,Old Sennockians,2,4,3.0,6
17508718,Old Haberdashers,Old Merchant Taylors,1,7,0.0,8
17526753,Old Stoics,Old Johnians FC,0,1,3.0,1
17526750,Old Merchant Taylors II,Old Alleynians AFC II,2,4,3.0,6
17526733,Old Wykehamists II,Old Rugbeians,0,2,2.0,2
17524127,Old Brentwoods II,Old Brentwoods III,1,2,4.0,3
17524110,Old Chigwellians III,Old Cholmeleians II,4,2,3.0,6
17527224,Kings College Wimbledon III,Old Westminsters II,1,1,4.0,2
17497894,Old Etonians,Eton College 1st XI,3,0,2.0,3
17497895,Old Etonians II,Eton College 2nd XI,3,0,2.0,3
17517342,Old Foresters,Old Salopians,3,1,3.0,4
17517358,Old Etonians,Lancing Old Boys,1,1,4.0,2
17517344,Old Tonbridgians,KCS Old Boys,1,1,4.0,2
17507300,Old Aldenhamians,Old Berkhamstedians,0,3,2.0,3
17507361,Old Brentwoods,Old Wellingtonians,6,2,2.0,8
17507342,Old Bradfieldians,Old Harrovians,2,1,4.0,3
17519442,Old Radleians,Old Westminsters,4,2,3.0,6
17519443,Old Alleynians AFC,Old Carthusians III,5,1,2.0,6
17519432,Lancing Old Boys II,Old Etonians II,2,4,3.0,6
17519441,Old Foresters II,Old Harrovians II,1,5,2.0,6
17508744,Old Sennockians,Old Haberdashers,8,2,0.0,10
17508745,Old Epsomians,Old Tonbridgians II,0,1,3.0,1
17508743,Old Chigwellians II,Old Eastbournians,4,1,2.0,5
17508741,Old Salopians II,Old Aldenhamians II,3,1,3.0,4
17526764,Old Rugbeians,Old Alleynians AFC II,4,2,3.0,6
17526720,Old Bancroftians AFC,Old Suttonians SV,0,7,0.0,7
17527196,Old Harrovians III,Old King's Scholars,7,1,0.0,8
17527223,Old Amplefordians,Old Shirburnians,2,6,2.0,8
17792840,Old Johnians FC,Old Columbans,3,2,4.0,5
17792824,Kings College Wimbledon III,Old Foresters III,0,0,4.0,0
17792769,Old Kimboltonians,Old Wellingburians,6,0,0.0,6
17787638,Old Brentwoods II,Kings Old Boys,0,2,2.0,2
17787624,Old Carthusians II,Old Manorians,2,3,4.0,5
17802497,Old Carthusians,Old Wilsonians,2,0,2.0,2
17446568,Old Wykehamists,Winchester College 1st XI,3,2,4.0,5
17446569,Old Wykehamists II,Winchester College 2nd XI,0,1,3.0,1
17668169,Old Bradfieldians Vets,Old Malvernians Vets,4,5,5.0,9
17517343,Old Marlburians,Old Tonbridgians,0,4,1.0,4
17517405,Lancing Old Boys,Old Salopians,5,3,4.0,8
17517326,Old Wykehamists,Old Carthusians,0,0,4.0,0
17517360,Old Chigwellians,Old Etonians,0,1,3.0,1
17507381,Old Malvernians,Old Berkhamstedians,1,3,3.0,4
17507311,Old Cholmeleians,Old Bradfieldians,1,4,2.0,5
17507354,Old Harrovians,Old Brentwoods,3,2,4.0,5
17519440,Old Carthusians III,Old Etonians II,1,1,4.0,2
17519437,Old Harrovians II,Old Radleians,2,3,4.0,5
17519457,Old Alleynians AFC,Lancing Old Boys II,8,2,0.0,10
17519400,Old Carthusians II,Kings College Wimbledon II,5,0,0.0,5
17508756,Old Eastbournians,Old Citizens,1,4,2.0,5
17508785,Old Salopians II,Old Merchant Taylors,1,0,3.0,1
17508740,Old Epsomians,Old Sennockians,3,2,4.0,5
17526751,Old Bancroftians AFC,Old Stoics,3,1,3.0,4
17527216,Old Shirburnians,Old Epsomians II,7,1,0.0,8
17527218,Old King's Scholars,Old Westminsters II,2,3,4.0,5
17792844,Old Brentwoods III,Old Alleynians AFC II,2,2,5.0,4
17816220,Albanian FC,Old Cholmeleians II,4,2,3.0,6
17861520,Old Foresters II,Old Manorians,3,5,4.0,8
17854817,Old Aldenhamians,Heathrow Seniors,2,3,4.0,5
17854986,Old Reptonians,Old Tollingtonians,3,2,4.0,5
17851093,Old Tonbridgians II,UCL Academicals IV,1,11,0.0,12
17834447,Old Foresters,Waltham Abbey,0,3,2.0,3
17685554,KCS Old Boys Vets,Old Westminsters Vets,2,5,2.0,7
17517374,Old Foresters,Old Wykehamists,4,0,1.0,4
17517346,Old Etonians,Old Marlburians,2,1,4.0,3
17517396,Old Salopians,Old Tonbridgians,1,6,0.0,7
17517357,Old Chigwellians,KCS Old Boys,0,2,2.0,2
17507353,Old Malvernians,Old Aldenhamians,1,3,3.0,4
17507350,Old Brentwoods,Old Berkhamstedians,2,3,4.0,5
17507375,Old Bradfieldians,Old Wellingtonians,4,3,4.0,7
17519452,Old Westminsters,Old Etonians II,1,1,4.0,2
17519427,Kings College Wimbledon II,Old Harrovians II,1,2,4.0,3
17519469,Old Foresters II,Old Carthusians II,0,3,2.0,3
17519471,Lancing Old Boys II,Old Carthusians III,0,2,2.0,2
17508733,Old Aldenhamians II,Old Haberdashers,2,4,3.0,6
17508735,Old Tonbridgians II,Old Salopians II,6,2,2.0,8
17508731,Old Citizens,Old Eastbournians,3,0,2.0,3
17508732,Old Chigwellians II,Old Epsomians,3,2,4.0,5
17508734,Old Sennockians,Old Merchant Taylors,1,1,4.0,2
17524097,Old Foresters III,Old Albanians SA,1,2,4.0,3
17527250,Old Harrovians III,Old Amplefordians,4,1,2.0,5
17811591,Old Kimboltonians,Lancing Old Boys,0,3,2.0,3
17811587,Old Harrovians,Old Alleynians AFC,3,4,4.0,7
17792817,Old Stoics,Old Brentwoods II,4,0,1.0,4
17792822,Old Alleynians AFC II,Old Brentwoods III,2,0,2.0,2
17792819,Old Suttonians SV,Old Cholmeleians II,3,4,4.0,7
17792818,Old Columbans,Old Johnians FC,4,2,3.0,6
17792815,Old Wykehamists II,Old King's Scholars,3,0,2.0,3
17792842,Old Shirburnians,Old Rugbeians,0,1,3.0,1
17758597,Old Carthusians,Old Tenisonians,2,1,4.0,3
17700027,Globe Rangers,Old Reptonians,1,3,3.0,4
17517337,Old Marlburians,Lancing Old Boys,1,2,4.0,3
17507321,Old Reptonians,Old Harrovians,0,3,2.0,3
17519433,Lancing Old Boys II,Old Alleynians AFC,1,4,2.0,5
17508727,Old Tonbridgians II,Old Aldenhamians II,9,1,0.0,10
17508729,Old Chigwellians II,Old Haberdashers,4,0,1.0,4
17508730,Old Eastbournians,Old Merchant Taylors,0,2,2.0,2
17508746,Old Salopians II,Old Citizens,0,4,1.0,4
17526732,Old Johnians FC,Old Merchant Taylors II,5,3,4.0,8
17526725,Old Suttonians SV,Old Stoics,3,2,4.0,5
17524115,Old Chigwellians III,Old Albanians SA,2,2,5.0,4
17524116,Old Brentwoods III,Old Brentwoods II,3,3,5.0,6
17524117,Old Cholmeleians II,Old Foresters III,2,4,3.0,6
17527211,Old Shirburnians,Old Harrovians III,1,3,3.0,4
17527209,Old Westminsters II,Old Amplefordians,1,3,3.0,4
17527219,Old King's Scholars,Kings College Wimbledon III,3,2,4.0,5
17493089,Old Epsomians,Old Westminsters,1,9,0.0,10
17493100,Old Cholmeleians,Old Sennockians,1,2,4.0,3
17427144,Old Etonians,Bank of England,2,0,2.0,2
17427145,Old Salopians,Old Brentwoods,0,3,2.0,3
17427146,Winchmore Hill,Old Chigwellians,1,0,3.0,1
17427143,Old Woodhouseians,Old Carthusians,1,9,0.0,10
17427218,Old Bromleians,KCS Old Boys,1,2,4.0,3
17736411,Old Berkhamstedians,Old Sedcopians,0,4,1.0,4
17708068,Old Aldenhamians,Old Strand Academicals,5,3,4.0,8
17700026,Old Malvernians,Old Tollingtonians,2,5,2.0,7
17516164,Hedinghams United,Old Foresters,1,6,0.0,7
17713334,Royal Navy Development XI,Arthurian League Representative Team,1,1,4.0,2
17507377,Old Wellingtonians,Old Berkhamstedians,0,4,1.0,4
17507331,Old Bradfieldians,Old Cholmeleians,5,1,2.0,6
17519473,Old Carthusians II,Old Harrovians II,2,1,4.0,3
17519434,Kings College Wimbledon II,Old Carthusians III,2,0,2.0,2
17508753,Old Chigwellians II,Old Salopians II,4,2,3.0,6
17508724,Old Haberdashers,Old Eastbournians,3,4,4.0,7
17508761,Old Sennockians,Old Citizens,3,4,4.0,7
17526716,Old Suttonians SV,Old Merchant Taylors II,3,1,3.0,4
17524112,Old Brentwoods II,Old Albanians SA,2,2,5.0,4
17524113,Old Foresters III,Old Brentwoods III,1,4,2.0,5
17524134,Old Chigwellians III,Old Columbans,0,8,0.0,8
17527236,Old Epsomians II,Old Shirburnians,3,0,2.0,3
17527203,Old Harrovians III,Kings College Wimbledon III,4,2,3.0,6
17493098,Old Rugbeians,Old Aldenhamians,3,5,4.0,8
17493090,Old Reptonians,Old Bancroftians AFC,4,1,2.0,5
17493096,Old Salopians,Old Brentwoods,4,0,1.0,4
17493093,Old Wykehamists,Old Foresters,0,2,2.0,2
17493095,Lancing Old Boys,Old Kimboltonians,1,1,4.0,2
17493099,Old Alleynians AFC,Old Harrovians,1,1,4.0,2
17493097,Old Merchant Taylors,Old Chigwellians,3,2,4.0,5
17493094,Old Carthusians,Old Radleians,9,1,0.0,10
17493102,Old Malvernians,Old Tonbridgians,1,2,4.0,3
17493091,KCS Old Boys,Old Etonians,2,3,4.0,5
17484020,Old Foresters II,Mill Hill Village,3,0,2.0,3
17427445,Alleyn Old Boys,Old Aldenhamians II,6,2,2.0,8
17736469,Old Tonbridgians II,Old Meadonians,5,4,5.0,9
17430489,Enfield Old Grammarians,Old Etonians II,2,5,2.0,7
17493101,Old Eastbournians,Old Bradfieldians,0,2,2.0,2
17517402,Lancing Old Boys,Old Chigwellians,0,2,2.0,2
17517355,KCS Old Boys,Old Salopians,1,2,4.0,3
17517369,Old Wykehamists,Old Etonians,2,1,4.0,3
17517334,Old Tonbridgians,Old Marlburians,3,2,4.0,5
17507298,Old Malvernians,Old Brentwoods,1,3,3.0,4
17507366,Old Harrovians,Old Wellingtonians,3,0,2.0,3
17507335,Old Berkhamstedians,Old Cholmeleians,3,1,3.0,4
17519419,Old Harrovians II,Lancing Old Boys II,1,2,4.0,3
17519421,Old Etonians II,Old Foresters II,2,1,4.0,3
17519418,Old Alleynians AFC,Kings College Wimbledon II,3,1,3.0,4
17508721,Old Salopians II,Old Haberdashers,1,3,3.0,4
17508786,Old Chigwellians II,Old Tonbridgians II,3,0,2.0,3
17508775,Old Aldenhamians II,Old Citizens,1,3,3.0,4
17526718,Old Johnians FC,Old Alleynians AFC II,2,1,4.0,3
17526726,Old Wykehamists II,Old Stoics,3,4,4.0,7
17524096,Old Brentwoods II,Old Foresters III,4,0,1.0,4
17527213,Old Epsomians II,Old King's Scholars,3,0,2.0,3
17493092,Old Suttonians SV,Old Amplefordians,4,1,2.0,5
17667365,Old Westminsters,Forest Green,7,4,3.0,11
17708065,Egbertian FC,Old Aldenhamians,4,7,3.0,11
17483993,Old Foresters,Spaniards,6,0,0.0,6
17667367,Old Sennockians,The Warren First,3,4,4.0,7
17430482,Old Owens,Old Carthusians,1,2,4.0,3
17517395,Old Foresters,Old Chigwellians,0,0,4.0,0
17517353,Old Salopians,Lancing Old Boys,2,2,5.0,4
17517388,Old Wykehamists,Old Marlburians,1,0,3.0,1
17517341,KCS Old Boys,Old Etonians,2,2,5.0,4
17507364,Old Bradfieldians,Old Brentwoods,2,1,4.0,3
17507317,Old Aldenhamians,Old Harrovians,0,7,0.0,7
17507308,Old Wellingtonians,Old Cholmeleians,1,6,0.0,7
17507309,Old Reptonians,Old Malvernians,2,3,4.0,5
17519403,Old Carthusians III,Old Westminsters,4,0,1.0,4
17519417,Old Radleians,Old Etonians II,3,2,4.0,5
17519415,Old Harrovians II,Old Alleynians AFC,2,3,4.0,5
17519414,Lancing Old Boys II,Kings College Wimbledon II,1,3,3.0,4
17508717,Old Tonbridgians II,Old Epsomians,3,2,4.0,5
17508777,Old Merchant Taylors,Old Haberdashers,5,2,2.0,7
17508716,Old Aldenhamians II,Old Eastbournians,1,4,2.0,5
17526723,Old Merchant Taylors II,Old Bancroftians AFC,2,1,4.0,3
17526724,Old Alleynians AFC II,Old Rugbeians,1,2,4.0,3
17526739,Old Wykehamists II,Old Johnians FC,2,5,2.0,7
17524106,Old Albanians SA,Old Brentwoods III,1,5,2.0,6
17524107,Old Foresters III,Old Chigwellians III,1,1,4.0,2
17524108,Old Columbans,Old Cholmeleians II,3,2,4.0,5
17527229,Kings College Wimbledon III,Old Shirburnians,1,7,0.0,8
17527245,Old Westminsters II,Old King's Scholars,4,0,1.0,4
17427353,Old Aloysians,Old Brentwoods II,2,3,4.0,5
17427355,Old Minchendenians,Old Salopians II,9,2,0.0,11
17427354,Old Wokingians,Old Carthusians II,1,1,4.0,2
17552887,Old Carthusians,Economicals,3,0,2.0,3
17497889,Old Ignatians,Old Tonbridgians,6,1,0.0,7
17517332,Old Marlburians,Old Foresters,0,2,2.0,2
17517412,Old Chigwellians,Old Carthusians,1,5,2.0,6
17517413,Lancing Old Boys,Old Etonians,1,2,4.0,3
17517331,Old Wykehamists,KCS Old Boys,0,1,3.0,1
17507315,Old Reptonians,Old Berkhamstedians,2,4,3.0,6
17507305,Old Cholmeleians,Old Brentwoods,1,5,2.0,6
17507330,Old Malvernians,Old Wellingtonians,1,2,4.0,3
17507378,Old Harrovians,Old Bradfieldians,3,5,4.0,8
17519413,Old Alleynians AFC,Old Foresters II,0,0,4.0,0
17519410,Old Westminsters,Lancing Old Boys II,3,2,4.0,5
17519411,Old Radleians,Old Carthusians II,2,2,5.0,4
17519460,Old Etonians II,Old Harrovians II,5,2,2.0,7
17508711,Old Eastbournians,Old Chigwellians II,3,1,3.0,4
17508714,Old Aldenhamians II,Old Tonbridgians II,3,3,5.0,6
17508789,Old Merchant Taylors,Old Sennockians,1,2,4.0,3
17526734,Old Wykehamists II,Old Bancroftians AFC,1,5,2.0,6
17526754,Old Suttonians SV,Old Rugbeians,0,3,2.0,3
17526721,Old Merchant Taylors II,Old Johnians FC,2,1,4.0,3
17526722,Old Alleynians AFC II,Old Stoics,4,4,6.0,8
17524104,Old Chigwellians III,Old Brentwoods III,1,3,3.0,4
17524105,Old Brentwoods II,Old Columbans,1,1,4.0,2
17524133,Old Albanians SA,Old Cholmeleians II,2,1,4.0,3
17527202,Old Epsomians II,Old Amplefordians,0,3,2.0,3
17527212,Kings College Wimbledon III,Old Harrovians III,1,4,2.0,5
17527205,Old Shirburnians,Old King's Scholars,2,2,5.0,4
17427669,Old Foresters III,UCL Academicals IV,1,9,0.0,10
17427159,Old Salopians,Shrewsbury School 1st XI,5,0,0.0,5
17427160,Old Salopians II,Shrewsbury School 2nd XI,1,1,4.0,2
17517329,Old Foresters,Lancing Old Boys,3,0,2.0,3
17517330,KCS Old Boys,Old Marlburians,0,1,3.0,1
17507334,Old Aldenhamians,Old Brentwoods,0,5,0.0,5
17507301,Old Harrovians,Old Cholmeleians,2,2,5.0,4
17519409,Old Westminsters,Old Alleynians AFC,1,1,4.0,2
17519486,Old Foresters II,Old Etonians II,1,1,4.0,2
17519408,Old Harrovians II,Kings College Wimbledon II,1,2,4.0,3
17508774,Old Sennockians,Old Chigwellians II,2,0,2.0,2
17508776,Old Salopians II,Old Epsomians,2,1,4.0,3
17508708,Old Citizens,Old Haberdashers,2,2,5.0,4
17526737,Old Wykehamists II,Old Merchant Taylors II,1,3,3.0,4
17526738,Old Stoics,Old Suttonians SV,6,0,0.0,6
17524100,Old Cholmeleians II,Old Brentwoods II,2,2,5.0,4
17524101,Old Albanians SA,Old Chigwellians III,4,2,3.0,6
17527246,Old Harrovians III,Old Shirburnians,3,0,2.0,3
17527237,Kings College Wimbledon III,Old Amplefordians,1,3,3.0,4
17429937,Old Malvernians,Old Uffingtonians FC,3,2,4.0,5
17429938,Old Berkhamstedians,Witan,3,2,4.0,5
17429936,Old Magdalenians,Old Reptonians,0,8,0.0,8
17430011,Old Dorkinians,Old Tonbridgians II,1,5,2.0,6
17430017,Enfield Old Grammarians,Old Aldenhamians II,7,0,0.0,7
17430018,Old Eastbournians,Old Hamptonians,1,2,4.0,3
17430481,Bealonians,Old Etonians,3,1,3.0,4
17473446,Old Carthusians,Charterhouse School 1st XI,5,0,0.0,5
17473447,Old Carthusians II,Charterhouse School 2nd XI,0,1,3.0,1
17473448,Old Carthusians III,Charterhouse School 3rd XI,3,5,4.0,8
17517327,Old Wykehamists,Old Chigwellians,0,5,0.0,5
17517394,KCS Old Boys,Old Carthusians,0,4,1.0,4
17517328,Old Tonbridgians,Old Etonians,3,2,4.0,5
17517378,Old Salopians,Old Marlburians,1,1,4.0,2
17507365,Old Malvernians,Old Cholmeleians,1,1,4.0,2
17507297,Old Wellingtonians,Old Bradfieldians,3,6,3.0,9
17519407,Old Radleians,Old Foresters II,1,3,3.0,4
17519404,Old Etonians II,Kings College Wimbledon II,3,1,3.0,4
17508704,Old Epsomians,Old Chigwellians II,0,5,0.0,5
17508705,Old Citizens,Old Salopians II,4,3,4.0,7
17508706,Old Haberdashers,Old Sennockians,2,3,4.0,5
17526749,Old Bancroftians AFC,Old Merchant Taylors II,3,3,5.0,6
17526719,Old Rugbeians,Old Stoics,3,1,3.0,4
17526752,Old Wykehamists II,Old Suttonians SV,0,6,0.0,6
17526735,Old Alleynians AFC II,Old Johnians FC,3,3,5.0,6
17524129,Old Albanians SA,Old Foresters III,4,2,3.0,6
17524114,Old Columbans,Old Chigwellians III,6,1,0.0,7
17527227,Old King's Scholars,Old Amplefordians,2,3,4.0,5
17427302,University of Hertfordshire,Old Aldenhamians,1,7,0.0,8
17427304,Royal Bank of Scotland,Old Westminsters,2,3,4.0,5
17427303,Lancing Old Boys,Worcester College Old Boys,2,4,3.0,6
17427443,South Bank Cuaco,Old Westminsters II,6,2,2.0,8
17429943,NUFC Oilers,Old Carthusians II,3,2,4.0,5
17551077,Old Brentwoods,Brentwood School 1st XI,1,1,4.0,2
17551078,Old Brentwoods II,Brentwood School 2nd XI,0,2,2.0,2
17551079,Old Brentwoods III,Brentwood School 3rd XI,4,3,4.0,7
17551080,Old Brentwoods IV,Brentwood School 4th XI,6,1,0.0,7
17551081,Old Brentwoods Vets,Brentwood School 5th XI,5,6,5.0,11
17431845,Harrow School 1st XI,Old Harrovians,5,5,6.0,10
17431846,Harrow School 2nd XI,Old Harrovians II,6,6,6.0,12
17431847,Harrow School 3rd XI,Old Harrovians III,7,7,6.0,14
17517389,Lancing Old Boys,Old Carthusians,0,6,0.0,6
17507362,Old Reptonians,Old Aldenhamians,1,4,2.0,5
17507337,Old Wellingtonians,Old Brentwoods,2,4,3.0,6
17519431,Kings College Wimbledon II,Old Carthusians II,3,4,4.0,7
17519401,Old Alleynians AFC,Old Harrovians II,6,0,0.0,6
17519402,Lancing Old Boys II,Old Radleians,0,6,0.0,6
17508700,Old Merchant Taylors,Old Aldenhamians II,3,1,3.0,4
17508782,Old Haberdashers,Old Tonbridgians II,0,3,2.0,3
17508701,Old Epsomians,Old Eastbournians,1,1,4.0,2
17508703,Old Sennockians,Old Salopians II,0,2,2.0,2
17526715,Old Wykehamists II,Old Alleynians AFC II,4,1,2.0,5
17526731,Old Suttonians SV,Old Bancroftians AFC,3,2,4.0,5
17526717,Old Johnians FC,Old Rugbeians,1,0,3.0,1
17524094,Old Columbans,Old Albanians SA,3,1,3.0,4
17524098,Old Chigwellians III,Old Brentwoods II,1,5,2.0,6
17524095,Old Brentwoods III,Old Cholmeleians II,3,4,4.0,7
17527220,Old Amplefordians,Old Epsomians II,2,0,2.0,2
17527195,Old Shirburnians,Kings College Wimbledon III,4,1,2.0,5
17480715,Old Malvernians,Malvern College 1st XI,0,1,3.0,1
17480716,Old Malvernians II,Malvern College 2nd XI,2,3,4.0,5
17516026,Old Marlburians,Marlborough College 1st XI,3,1,3.0,4
17446566,Lancing Old Boys,Lancing College 1st XI,7,4,3.0,11
17446567,Lancing Old Boys II,Lancing College 2nd XI,0,0,4.0,0
17580207,Old Carthusians,Old Owens,7,1,0.0,8
18580144,KCS Old Boys,Old Carthusians,2,1,4.0,3
18682710,Old Carthusians II,Old Westminsters,2,3,4.0,5
19399380,Old Shirburnians,Old Kimboltonians,3,0,2.0,3
18914064,Lancing Old Boys Vets,Old Tonbridgians Vets,6,1,0.0,7
18580285,Old Carthusians,Old Bradfieldians,2,2,5.0,4
18682887,Old Harrovians,Old Cholmeleians,2,1,4.0,3
18682655,Kings College Wimbledon II,Old Westminsters,1,1,4.0,2
19335286,Old Johnians FC,Old Wokingians,2,1,4.0,3
19335281,Alexandra Park FC,Old Alleynians AFC,0,7,0.0,7
18914053,Old Harrovians Vets,Old Etonians Vets,1,12,1.0,13
18682862,Old Cholmeleians,Old Reptonians,2,1,4.0,3
18638431,Old Sennockians,Old Wellingtonians,0,6,0.0,6
19364282,Old Carthusians,Old Etonians,3,0,2.0,3
19363994,Old Westminsters,Old Etonians II,3,1,3.0,4
19398505,Old Alleynians AFC II,Old Kimboltonians,3,2,4.0,5
19323643,Old Bradfieldians,Old Aloysians,0,3,2.0,3
19335289,London Welsh F.C.,Old Johnians FC,4,5,5.0,9
19323621,Old Kingstonians KGS,Old Westminsters II,5,1,2.0,6
18580296,Old Chigwellians,Old Carthusians,0,0,4.0,0
19323622,Old Pauline,Old Kingstonians KGS,0,5,0.0,5
18970250,Arthurian League Representative Team,Southern Amateur League Rep XI,1,3,3.0,4
19355480,Old Brentwoods Vets,Old Malvernians Vets,1,2,4.0,3
19380521,Old Carthusians Vets,Old Wellingtonians Vets,1,4,2.0,5
18580292,Old Wykehamists,Old Tonbridgians,3,0,2.0,3
18682891,Old Cholmeleians,Old Radleians,3,3,5.0,6
18682730,Kings College Wimbledon II,Old Merchant Taylors,3,1,3.0,4
18682684,Lancing Old Boys II,Old Harrovians II,5,4,5.0,9
18682669,Old Citizens,Old Westminsters,1,2,4.0,3
18638444,Old Tonbridgians II,Old Sennockians,1,2,4.0,3
18682802,Old Harrovians III,Old Columbans,1,1,4.0,2
18580206,Old Cholmeleians II,Old Brentwoods III,2,7,0.0,9
18580142,Old Chigwellians III,Old Merchant Taylors II,3,2,4.0,5
19377158,Old Shirburnians,Old Alleynians AFC II,0,5,0.0,5
19354084,Old Carthusians,Old Meadonians,3,1,3.0,4
19323640,Old Bradfieldians,Alexandra Park FC,1,0,3.0,1
19018395,Arthurian League Representative Team,AFC Representative Team,0,4,1.0,4
18580170,Old Wykehamists,Old Brentwoods,1,3,3.0,4
18580249,Old Etonians,Old Salopians,1,0,3.0,1
18682882,Old Aldenhamians,Lancing Old Boys,2,7,0.0,9
18682878,Old Berkhamstedians,Old Malvernians,0,3,2.0,3
18682662,Lancing Old Boys II,Old Merchant Taylors,1,2,4.0,3
18682658,Old Chigwellians II,Old Westminsters,1,4,2.0,5
18638463,Old Salopians II,Old Rugbeians,1,6,0.0,7
18682770,Old Haberdashers,Old Alleynians AFC II,2,9,0.0,11
18682799,Old Stoics,Old Columbans,1,5,2.0,6
18682801,Old Bancroftians AFC,Old Harrovians III,0,4,1.0,4
18580098,Old Brentwoods III,Old Merchant Taylors II,3,3,5.0,6
18580237,Old Cholmeleians II,Old Foresters III,1,1,4.0,2
19387028,Old King's Scholars,Old Kimboltonians,0,3,2.0,3
19387029,Old Albanians SA,Old Shirburnians,1,3,3.0,4
19341639,Old Cholmeleians,New Magdalen,0,1,3.0,1
19335287,Old Dorkinians,Old Johnians FC,2,3,4.0,5
19390810,South Bank Cuaco,Old Kingstonians KGS,2,2,5.0,4
19323633,Old Westminsters II,Old Wokingians,2,7,0.0,9
18580284,Old Wykehamists,Old Carthusians,1,2,4.0,3
18580166,Old Bradfieldians,Old Foresters,1,1,4.0,2
18682679,Old Chigwellians II,Old Carthusians II,1,6,0.0,7
18682654,Old Foresters II,Old Merchant Taylors,1,4,2.0,5
18682697,Old Harrovians II,Old Westminsters,2,2,5.0,4
18682647,Old Etonians II,Old Citizens,2,0,2.0,2
18638429,Old Rugbeians,Old Tonbridgians II,2,2,5.0,4
18638439,Old Salopians II,Old Sennockians,1,6,0.0,7
18638401,Old Johnians FC,Old Wellingtonians,1,2,4.0,3
18682762,Old Harrovians III,Old Eastbournians,1,1,4.0,2
18682794,Old Haberdashers,Old Columbans,0,5,0.0,5
18580187,Old Foresters III,Old Kimboltonians,0,4,1.0,4
18647624,Old Wykehamists II,Old Shirburnians,0,1,3.0,1
19305744,Old Brentwoods,Brentwood School 1st XI,0,3,2.0,3
19305745,Old Brentwoods II,Brentwood School 2nd XI,9,0,0.0,9
19305746,Old Brentwoods III,Brentwood School 3rd XI,3,0,2.0,3
19335222,Old Albanians SA,St Albans School 1st XI,4,3,4.0,7
19301958,Old Cholmeleians,Highgate School 1st XI,3,1,3.0,4
19301959,Old Cholmeleians II,Highgate School 2nd XI,2,1,4.0,3
19226475,Old Carthusians,Old Parkonians,4,1,2.0,5
19335279,Weirside Rangers,Old Alleynians AFC,2,3,4.0,5
18914062,Old Wykehamists Vets,Old Harrovians Vets,3,4,4.0,7
19277683,Old Berkhamstedians Vets,Old Wellingtonians Vets,0,2,2.0,2
18580301,Old Wykehamists,Old Chigwellians,0,1,3.0,1
18580180,Old Brentwoods,Old Tonbridgians,3,3,5.0,6
18580162,Old Etonians,Old Carthusians,1,1,4.0,2
18682836,Old Harrovians,Lancing Old Boys,0,2,2.0,2
18682853,Old Aldenhamians,Old Berkhamstedians,0,8,0.0,8
18682833,Old Reptonians,Old Malvernians,0,2,2.0,2
18682866,Old Cholmeleians,Old Marlburians,2,0,2.0,2
18682693,Old Etonians II,Old Westminsters,1,5,2.0,6
18682682,Old Carthusians II,Kings College Wimbledon II,3,0,2.0,3
18682707,Old Harrovians II,Old Citizens,1,6,0.0,7
18638424,Old Tonbridgians II,Old Carthusians III,5,4,5.0,9
18638403,Old Wellingtonians,Old Epsomians,4,1,2.0,5
18638426,Old Johnians FC,Old Sennockians,0,1,3.0,1
18682796,Old Bancroftians AFC,Old Columbans,2,4,3.0,6
18682800,Old Eastbournians,Old Haberdashers,3,4,4.0,7
18580149,Old Albanians SA,Old Merchant Taylors II,1,2,4.0,3
18647647,Old Wykehamists II,Old Westminsters II,2,3,4.0,5
19340161,Old Harrovians III,Old Shirburnians,1,1,4.0,2
19247624,Old Bradfieldians,Bradfield College,0,0,4.0,0
19052202,Old Radleians,Radley College 1st XI,0,0,4.0,0
19261529,Old Foresters,Forest School 1st XI,0,0,4.0,0
19261530,Old Foresters II,Forest School 2nd XI,0,0,4.0,0
19261531,Old Foresters III,Forest School 3rd XI,5,1,2.0,6
19175549,TBC,Old Wykehamists II,2,3,4.0,5
19323620,Old Dorkinians,Old Kingstonians KGS,0,6,0.0,6
18647642,Old King's Scholars,Old Shirburnians,0,3,2.0,3
18580235,Old Carthusians,Old Foresters,2,0,2.0,2
18580108,Old Chigwellians,Old Brentwoods,2,5,2.0,7
18682803,Old Alleynians AFC,Old Aldenhamians,0,1,3.0,1
18682849,Old Cholmeleians,Old Harrovians,2,2,5.0,4
18682667,Old Foresters II,Old Carthusians II,0,2,2.0,2
18682692,Old Harrovians II,Old Chigwellians II,1,0,3.0,1
18682711,Lancing Old Boys II,Kings College Wimbledon II,1,0,3.0,1
18682701,Old Merchant Taylors,Old Westminsters,1,5,2.0,6
18638417,Old Rugbeians,Old Johnians FC,1,1,4.0,2
18638453,Old Wellingtonians,Old Sennockians,2,5,2.0,7
18682743,Old Bancroftians AFC,Old Brentwoods II,1,1,4.0,2
18682748,Old Suttonians SV,Old Harrovians III,4,1,2.0,5
18647614,Old King's Scholars,Old Kingstonians KGS,3,0,2.0,3
19325506,Old Foresters,Old Carthusians,0,2,2.0,2
19325450,Old Etonians,Old Tonbridgians,1,0,3.0,1
19306462,Old Shirburnians,Old Etonians II,2,4,3.0,6
19340121,Old Kimboltonians,Old Wykehamists II,6,0,0.0,6
19258862,Old Chigwellians Vets,Old Malvernians Vets,1,3,3.0,4
19099145,Old Shirburnians,Sherborne School 1st XI,2,0,2.0,2
18580209,Old Foresters,Old Chigwellians,2,2,5.0,4
18580304,KCS Old Boys,Old Tonbridgians,2,2,5.0,4
18580299,Old Wykehamists,Old Salopians,4,0,1.0,4
18580272,Old Brentwoods,Old Etonians,3,2,4.0,5
18682872,Old Radleians,Old Berkhamstedians,2,1,4.0,3
18682852,Old Alleynians AFC,Lancing Old Boys,2,0,2.0,2
18682690,Old Chigwellians II,Old Foresters II,0,1,3.0,1
18682696,Old Citizens,Old Etonians II,0,4,1.0,4
18638462,Old Aldenhamians II,Old Epsomians,3,4,4.0,7
18638428,Old Wellingtonians,Old Johnians FC,1,3,3.0,4
18682736,Old Eastbournians,Old Alleynians AFC II,1,7,0.0,8
18682751,Old Suttonians SV,Old Columbans,2,1,4.0,3
18682798,Old Harrovians III,Old Haberdashers,5,2,2.0,7
18682738,Old Brentwoods II,Old Stoics,2,4,3.0,6
18580145,Old Cholmeleians II,Old Chigwellians III,1,1,4.0,2
18580229,Old Brentwoods III,Old Kimboltonians,0,0,4.0,0
18647628,Old Kingstonians KGS,Old Amplefordians,4,2,3.0,6
18647630,Old Westminsters II,Old Berkhamstedians II,1,3,3.0,4
19306271,Old Carthusians II,Old Westminsters,2,2,5.0,4
19308063,West Wickham,Old Carthusians,0,0,4.0,0
19257606,Old Cholmeleians,Spaniards,2,1,4.0,3
19321273,Old King's Scholars,Old Minchendenians,0,1,3.0,1
19340128,Old Rugbeians,Rugby School,3,1,3.0,4
19242034,Old Bancroftians AFC,Bancroft's School 1st XI,6,0,0.0,6
19310826,Old Malvernians,Malvern College 1st XI,0,0,4.0,0
19118841,Arthurian League Representative Team,Lloyds of London Representative Team,9,1,0.0,10
18914052,Lancing Old Boys Vets,Old Carthusians Vets,2,0,2.0,2
18914056,Old Tonbridgians Vets,Old Harrovians Vets,1,2,4.0,3
19218744,Old Brentwoods Vets,Old Foresters Vets,2,1,4.0,3
18580244,KCS Old Boys,Old Bradfieldians,3,3,5.0,6
18580185,Old Tonbridgians,Old Foresters,1,0,3.0,1
18580267,Old Carthusians,Old Salopians,7,1,0.0,8
18682860,Old Alleynians AFC,Old Malvernians,4,1,2.0,5
18682885,Old Marlburians,Old Reptonians,2,0,2.0,2
18682673,Old Westminsters,Old Foresters II,3,3,5.0,6
18682687,Old Merchant Taylors,Lancing Old Boys II,2,3,4.0,5
18682675,Old Citizens,Old Carthusians II,2,4,3.0,6
18682656,Old Etonians II,Kings College Wimbledon II,3,1,3.0,4
18638454,Old Epsomians,Old Tonbridgians II,2,1,4.0,3
18682756,Old Brentwoods II,Old Suttonians SV,1,5,2.0,6
18580089,Old Chigwellians III,Old Foresters III,6,3,3.0,9
19305160,Old Kimboltonians,Old Amplefordians,5,1,2.0,6
19236325,Old King's Scholars,Old Shirburnians,0,1,3.0,1
19306363,Old Stoics,Old Alleynians AFC II,1,2,4.0,3
19306267,Old Wykehamists II,Old Merchant Taylors II,4,2,3.0,6
19236570,Old Cholmeleians,Putney Saint-Germain,2,0,2.0,2
19323619,Old Wokingians,Old Kingstonians KGS,0,5,0.0,5
18914063,Old Carthusians Vets,Old Tonbridgians Vets,3,1,3.0,4
19123061,Old Tonbridgians Vets,Old Carthusians Vets,1,3,3.0,4
19329120,Albanian FC,Old Chigwellians Vets,1,4,2.0,5
18580183,Old Brentwoods,Old Chigwellians,1,5,2.0,6
18580258,Old Carthusians,Old Tonbridgians,1,1,4.0,2
18580269,Old Salopians,KCS Old Boys,1,2,4.0,3
18682848,Old Radleians,Old Aldenhamians,2,2,5.0,4
18682883,Old Cholmeleians,Old Berkhamstedians,5,4,5.0,9
18682874,Old Malvernians,Old Marlburians,1,3,3.0,4
18682695,Kings College Wimbledon II,Old Chigwellians II,0,1,3.0,1
18682728,Old Foresters II,Lancing Old Boys II,0,2,2.0,2
18682659,Old Merchant Taylors,Old Citizens,2,4,3.0,6
18682689,Old Harrovians II,Old Etonians II,1,2,4.0,3
18638409,Old Carthusians III,Old Rugbeians,1,4,2.0,5
18638408,Old Salopians II,Old Epsomians,0,5,0.0,5
18682783,Old Haberdashers,Old Brentwoods II,0,5,0.0,5
18682739,Old Bancroftians AFC,Old Alleynians AFC II,0,2,2.0,2
18682780,Old Columbans,Old Suttonians SV,7,4,3.0,11
18682795,Old Eastbournians,Old Harrovians III,1,5,2.0,6
18580161,Old Merchant Taylors II,Old Brentwoods III,0,0,4.0,0
18580219,Old Cholmeleians II,Old Kimboltonians,1,3,3.0,4
18647652,Old Westminsters II,Old Shirburnians,3,10,1.0,13
18647638,Old Wykehamists II,Old Amplefordians,3,3,5.0,6
19134795,Old Reptonians,Old Foresters,0,1,3.0,1
19158114,Old Etonians,Old Westminsters,3,2,4.0,5
19237300,Old King's Scholars,Old Finchleians,1,3,3.0,4
19118842,Herts Senior County League,Arthurian League Representative Team,0,3,2.0,3
18914059,Old Wykehamists Vets,Old Carthusians Vets,0,5,0.0,5
18580255,Old Salopians,Old Foresters,2,1,4.0,3
18580151,Old Chigwellians,KCS Old Boys,0,1,3.0,1
18682892,Old Malvernians,Lancing Old Boys,2,2,5.0,4
18682876,Old Reptonians,Old Cholmeleians,1,3,3.0,4
18682842,Old Berkhamstedians,Old Harrovians,1,2,4.0,3
18682714,Old Harrovians II,Old Merchant Taylors,0,2,2.0,2
18638412,Old Wellingtonians,Old Aldenhamians II,1,3,3.0,4
18638451,Old Salopians II,Old Carthusians III,0,1,3.0,1
18647622,Old Amplefordians,Old King's Scholars,1,3,3.0,4
19139533,Old Tonbridgians,Old Alleynians AFC,3,2,4.0,5
19256648,Old Epsomians,Old Shirburnians,2,2,5.0,4
19277057,Old Rugbeians,Old Westminsters,1,3,3.0,4
19291446,Old Carthusians II,Old Foresters II,3,1,3.0,4
19256512,Old Bancroftians AFC,Old Merchant Taylors II,2,3,4.0,5
19256717,Old Alleynians AFC II,Old Foresters III,6,0,0.0,6
19236710,Old Haberdashers,Old Harrovians III,1,5,2.0,6
19231270,Old Berkhamstedians II,Old Stoics,1,2,4.0,3
19216981,Old Carthusians,Old Actonians Association FC,2,0,2.0,2
18914058,Old Harrovians Vets,Lancing Old Boys Vets,3,4,4.0,7
18580224,Old Etonians,Old Brentwoods,6,0,0.0,6
18580275,Old Foresters,Old Tonbridgians,0,0,4.0,0
18580271,Old Chigwellians,Old Bradfieldians,2,1,4.0,3
18682844,Old Reptonians,Lancing Old Boys,0,2,2.0,2
18682880,Old Cholmeleians,Old Aldenhamians,2,1,4.0,3
18682834,Old Berkhamstedians,Old Marlburians,3,0,2.0,3
18682873,Old Alleynians AFC,Old Harrovians,1,3,3.0,4
18682727,Lancing Old Boys II,Old Westminsters,0,4,1.0,4
18682723,Old Chigwellians II,Old Merchant Taylors,2,1,4.0,3
18682702,Old Harrovians II,Kings College Wimbledon II,2,2,5.0,4
18682665,Old Foresters II,Old Citizens,3,5,4.0,8
18638423,Old Rugbeians,Old Aldenhamians II,3,1,3.0,4
18638435,Old Tonbridgians II,Old Epsomians,0,1,3.0,1
18682774,Old Brentwoods II,Old Columbans,0,4,1.0,4
18682740,Old Suttonians SV,Old Eastbournians,7,1,0.0,8
18682752,Old Alleynians AFC II,Old Stoics,2,2,5.0,4
18580178,Old Merchant Taylors II,Old Kimboltonians,0,2,2.0,2
18647653,Old Westminsters II,Old King's Scholars,2,4,3.0,6
18647634,Old Berkhamstedians II,Old Shirburnians,0,3,2.0,3
19158182,Old Carthusians,Old Wykehamists,4,1,2.0,5
19197956,Old Carthusians III,Old Carthusians II,1,2,4.0,3
19256882,Old Wykehamists II,Old Albanians SA,6,1,0.0,7
19218971,Old Chigwellians Vets,Albanian FC,1,1,4.0,2
18580175,Old Wykehamists,Old Etonians,2,1,4.0,3
18580212,Old Carthusians,KCS Old Boys,1,1,4.0,2
18682845,Old Cholmeleians,Old Alleynians AFC,1,4,2.0,5
18682879,Old Aldenhamians,Old Radleians,2,4,3.0,6
18682846,Old Malvernians,Old Berkhamstedians,0,2,2.0,2
18638443,Old Salopians II,Old Johnians FC,3,2,4.0,5
18682755,Old Eastbournians,Old Stoics,2,4,3.0,6
18647636,Old Berkhamstedians II,Old King's Scholars,0,2,2.0,2
18647645,Old King's Scholars,Old Berkhamstedians II,1,1,4.0,2
19236453,Old Westminsters,Old Harrovians III,2,2,5.0,4
19197888,Old Cholmeleians II,Old Foresters II,1,4,2.0,5
19256649,Old Amplefordians,Old Suttonians SV,7,4,3.0,11
19092141,Old Chigwellians Vets,Old Etonians Vets,2,1,4.0,3
18580217,Old Etonians,Old Bradfieldians,2,1,4.0,3
18580129,Old Brentwoods,Old Carthusians,1,4,2.0,5
18580158,Old Foresters,Old Salopians,2,1,4.0,3
18682823,Old Berkhamstedians,Old Aldenhamians,1,0,3.0,1
18682886,Old Radleians,Old Alleynians AFC,4,6,4.0,10
18682869,Lancing Old Boys,Old Malvernians,3,0,2.0,3
18682821,Old Harrovians,Old Marlburians,5,0,0.0,5
18682681,Old Citizens,Old Merchant Taylors,3,2,4.0,5
18682688,Old Westminsters,Old Carthusians II,1,1,4.0,2
18682767,Old Stoics,Old Alleynians AFC II,2,1,4.0,3
18682768,Old Suttonians SV,Old Brentwoods II,2,0,2.0,2
18682754,Old Bancroftians AFC,Old Haberdashers,2,3,4.0,5
18682786,Old Columbans,Old Harrovians III,0,3,2.0,3
18580165,Old Albanians SA,Old Chigwellians III,1,0,3.0,1
18647626,Old Kingstonians KGS,Old King's Scholars,7,5,4.0,12
19197858,Old Johnians FC,Old Chigwellians II,1,3,3.0,4
19236306,Old Harrovians II,Old Epsomians,1,3,3.0,4
19197656,Old Rugbeians,Old Tonbridgians II,5,2,2.0,7
19236077,Old Shirburnians,Kings College Wimbledon II,1,0,3.0,1
19197714,Old Sennockians,Old Etonians II,1,2,4.0,3
19071978,Old Cholmeleians II,Old Wykehamists II,0,3,2.0,3
19236711,Old Amplefordians,Old Harrovians IV,3,1,3.0,4
19071976,Old Foresters III,Old Westminsters II,1,0,3.0,1
19071973,Old Eastbournians,Old Merchant Taylors II,2,4,3.0,6
19198516,Old Cholmeleians,Old Sedcopians,5,3,4.0,8
19123164,Old Wellingtonians Vets,Old Salopians Vets,3,3,5.0,6
18580290,Old Brentwoods,Old Foresters,0,0,4.0,0
18580264,Old Chigwellians,Old Etonians,0,6,0.0,6
18580189,KCS Old Boys,Old Wykehamists,4,0,1.0,4
18580221,Old Salopians,Old Tonbridgians,1,4,2.0,5
18580182,Old Bradfieldians,Old Carthusians,2,2,5.0,4
18682890,Lancing Old Boys,Old Berkhamstedians,5,2,2.0,7
18682841,Old Radleians,Old Reptonians,1,3,3.0,4
18682856,Old Harrovians,Old Aldenhamians,6,0,0.0,6
18682858,Old Alleynians AFC,Old Marlburians,4,1,2.0,5
18682671,Old Citizens,Lancing Old Boys II,2,1,4.0,3
18682672,Old Etonians II,Old Carthusians II,0,1,3.0,1
18682653,Old Chigwellians II,Old Harrovians II,1,2,4.0,3
18638406,Old Sennockians,Old Aldenhamians II,3,0,2.0,3
18638425,Old Wellingtonians,Old Salopians II,6,3,3.0,9
18682782,Old Columbans,Old Bancroftians AFC,4,2,3.0,6
18682776,Old Suttonians SV,Old Stoics,3,2,4.0,5
18647621,Old King's Scholars,Old Wykehamists II,5,2,2.0,7
19121964,Old Eastbournians,Old Westminsters,0,8,0.0,8
19045361,Old Merchant Taylors,Old Epsomians,1,2,4.0,3
19106968,Old Albanians SA,Kings College Wimbledon II,2,4,3.0,6
19071975,Old Kimboltonians,Old Brentwoods II,3,0,2.0,3
19071979,Old Shirburnians,Old Chigwellians III,4,1,2.0,5
19102347,Old Kingstonians KGS,Old Harrovians III,2,4,3.0,6
19138011,Old Sedcopians,Old Cholmeleians,1,1,4.0,2
18914054,Old Wykehamists Vets,Old Tonbridgians Vets,4,7,3.0,11
19092140,Old Haileyburians Vets,Old Brentwoods Vets,3,4,4.0,7
19123088,Lancing Old Boys Vets,Old Foresters Vets,0,3,2.0,3
19123029,Old Malvernians Vets,Old Harrovians Vets,5,2,2.0,7
19092153,Old Reptonians Vets,Old Bradfieldians Vets,0,2,2.0,2
19176199,Old Pauline,Old Carthusians Vets,2,0,2.0,2
18580262,Old Foresters,Old Bradfieldians,3,3,5.0,6
18580232,Old Wykehamists,KCS Old Boys,0,2,2.0,2
18580288,Old Salopians,Old Etonians,3,2,4.0,5
18682864,Old Aldenhamians,Old Alleynians AFC,0,8,0.0,8
18682855,Old Harrovians,Old Radleians,1,2,4.0,3
18682859,Old Berkhamstedians,Old Reptonians,3,1,3.0,4
18682871,Old Cholmeleians,Lancing Old Boys,1,1,4.0,2
18682722,Old Foresters II,Old Harrovians II,0,0,4.0,0
18682717,Lancing Old Boys II,Old Etonians II,0,3,2.0,3
18682641,Old Merchant Taylors,Old Carthusians II,0,3,2.0,3
18682716,Kings College Wimbledon II,Old Citizens,0,2,2.0,2
18638421,Old Aldenhamians II,Old Wellingtonians,0,12,0.0,12
18638434,Old Rugbeians,Old Carthusians III,1,1,4.0,2
18638405,Old Sennockians,Old Salopians II,4,0,1.0,4
18682791,Old Alleynians AFC II,Old Haberdashers,8,2,0.0,10
18682787,Old Stoics,Old Suttonians SV,2,4,3.0,6
18682790,Old Columbans,Old Eastbournians,3,0,2.0,3
18682764,Old Brentwoods II,Old Harrovians III,2,2,5.0,4
18580157,Old Cholmeleians II,Old Merchant Taylors II,0,1,3.0,1
18580214,Old Brentwoods III,Old Albanians SA,2,6,2.0,8
18647632,Old Shirburnians,Old Kingstonians KGS,4,3,4.0,7
19200992,Old Carthusians,Old Thorntonians,4,1,2.0,5
19160558,Old Lyonians,Old Chigwellians Vets,0,4,1.0,4
19046311,Old Epsomians,Epsom College 1st XI,0,0,4.0,0
18993523,Old Westminsters,Westminster School 1st XI,2,1,4.0,3
18993524,Old Westminsters II,Westminster School 2nd XI,5,1,2.0,6
19050630,Old Suttonians,Old King's Scholars,2,3,4.0,5
19092143,Old Berkhamstedians Vets,Old Westminsters Vets,2,1,4.0,3
18580133,Old Wykehamists,Old Foresters,2,3,4.0,5
18580179,Old Salopians,Old Chigwellians,1,0,3.0,1
18580100,Old Bradfieldians,Old Brentwoods,1,4,2.0,5
18682888,Lancing Old Boys,Old Reptonians,5,2,2.0,7
18682840,Old Marlburians,Old Malvernians,0,2,2.0,2
18580239,Old Chigwellians III,Old Kimboltonians,0,3,2.0,3
18647648,Old Amplefordians,Old Berkhamstedians II,3,7,2.0,10
19042876,Old Carthusians II,Old Wellingtonians,4,0,1.0,4
19042875,Old Columbans,Old Foresters II,1,2,4.0,3
19106837,Old Chigwellians II,Old Merchant Taylors II,3,2,4.0,5
19090051,Old Westminsters II,Old Harrovians II,2,4,3.0,6
19090416,Old Bancroftians AFC,Old Etonians II,0,6,0.0,6
19042833,Lancing Old Boys II,Old Johnians FC,0,1,3.0,1
19106951,Old Stoics,Old Rugbeians,0,5,0.0,5
19106981,Old Harrovians III,Old Salopians II,6,2,2.0,8
19106949,Old Brentwoods II,Old Tonbridgians II,2,3,4.0,5
19106990,Old Shirburnians,Old Citizens,4,2,3.0,6
19033545,Old Cholmeleians,City of London,6,0,0.0,6
19090693,Old Meadonians,Old Sennockians,6,5,5.0,11
19102433,Wood Green Old Boys,Old King's Scholars,0,1,3.0,1
18337473,Old Alleynians AFC,Dulwich College 1st XI,3,2,4.0,5
18337839,Old Alleynians AFC II,Dulwich College 2nd XI,3,0,2.0,3
19110117,KCS Old Boys,"King's College School, Wimbledon 1st XI",0,7,0.0,7
19110118,Kings College Wimbledon II,"King's College School, Wimbledon 2nd XI",0,0,4.0,0
19088062,Old Carthusians,Old Suttonians,4,0,1.0,4
18682729,Old Carthusians II,Old Harrovians II,3,1,3.0,4
19002205,Old Merchant Taylors,Old Carthusians,0,7,0.0,7
19002215,Old Berkhamstedians,Old Wykehamists,2,4,3.0,6
19002264,Old Etonians,Old Brentwoods,3,1,3.0,4
19137090,Old Chigwellians Vets,Wormley Rovers Vets FC,3,1,3.0,4
18580194,Old Carthusians,Old Wykehamists,4,0,1.0,4
18580279,Old Brentwoods,Old Bradfieldians,3,6,3.0,9
18580102,Old Chigwellians,Old Salopians,3,1,3.0,4
18580297,KCS Old Boys,Old Etonians,1,1,4.0,2
18682837,Old Malvernians,Old Radleians,2,0,2.0,2
18682700,Old Carthusians II,Old Foresters II,2,1,4.0,3
18682686,Old Citizens,Kings College Wimbledon II,5,0,0.0,5
18638450,Old Aldenhamians II,Old Sennockians,2,3,4.0,5
18682750,Old Eastbournians,Old Bancroftians AFC,0,3,2.0,3
18580116,Old Kimboltonians,Old Foresters III,6,0,0.0,6
19002340,Lancing Old Boys,Old Foresters,0,2,2.0,2
19002456,Old Alleynians AFC,Old Rugbeians,2,1,4.0,3
18992915,Old Shirburnians,Old Westminsters,2,3,4.0,5
19090678,Old Columbans,Albanian FC,4,7,3.0,11
18976671,Old Parkonians,Old Harrovians II,2,1,4.0,3
18682818,Old Marlburians,Old Berkhamstedians,1,1,4.0,2
18914065,Old Harrovians Vets,Old Carthusians Vets,5,3,4.0,8
18974096,Old Carthusians Vets,Old Harrovians Vets,3,5,4.0,8
18974097,Old Wellingtonians Vets,Lancing Old Boys Vets,1,1,4.0,2
19026613,Old Wellingtonians Vets,Lancing Old Boys Vets,1,1,4.0,2
19026610,Old Carthusians Vets,Old Harrovians Vets,5,3,4.0,8
19120591,Old Chigwellians Vets,Old Aloysians,2,1,4.0,3
18580246,Old Chigwellians,Old Foresters,1,2,4.0,3
18580211,Old Bradfieldians,Old Wykehamists,0,2,2.0,2
18580203,Old Salopians,Old Carthusians,2,3,4.0,5
18580207,Old Tonbridgians,Old Etonians,3,1,3.0,4
18580252,Old Brentwoods,KCS Old Boys,2,6,2.0,8
18682816,Old Berkhamstedians,Old Alleynians AFC,1,4,2.0,5
18682839,Old Aldenhamians,Old Harrovians,1,6,0.0,7
18682854,Old Cholmeleians,Old Malvernians,1,1,4.0,2
18682850,Lancing Old Boys,Old Marlburians,3,1,3.0,4
18682680,Old Harrovians II,Old Foresters II,1,2,4.0,3
18682678,Kings College Wimbledon II,Lancing Old Boys II,2,4,3.0,6
18682712,Old Carthusians II,Old Citizens,1,0,3.0,1
18682646,Old Merchant Taylors,Old Chigwellians II,4,1,2.0,5
18682705,Old Westminsters,Old Etonians II,5,4,5.0,9
18638446,Old Tonbridgians II,Old Salopians II,2,2,5.0,4
18638455,Old Sennockians,Old Carthusians III,5,3,4.0,8
18638438,Old Johnians FC,Old Epsomians,1,0,3.0,1
18682773,Old Harrovians III,Old Suttonians SV,1,4,2.0,5
18682792,Old Stoics,Old Bancroftians AFC,3,1,3.0,4
18580118,Old Brentwoods III,Old Cholmeleians II,0,7,0.0,7
18647650,Old Shirburnians,Old King's Scholars,2,1,4.0,3
19002272,Old Reptonians,Old Kimboltonians,2,1,4.0,3
18953753,Old Eastbournians,Old Harrovians IV,2,1,4.0,3
18337803,Old Haberdashers,Haberdashers Aske School 1st XI,1,8,0.0,9
18580192,Old Foresters,Old Brentwoods,3,0,2.0,3
18580251,Old Tonbridgians,Old Wykehamists,0,2,2.0,2
18580196,Old Etonians,Old Chigwellians,2,1,4.0,3
18682835,Old Marlburians,Old Alleynians AFC,1,2,4.0,3
18682861,Lancing Old Boys,Old Radleians,6,0,0.0,6
18682851,Old Malvernians,Old Reptonians,1,5,2.0,6
18682668,Lancing Old Boys II,Old Chigwellians II,1,3,3.0,4
18682691,Old Foresters II,Kings College Wimbledon II,3,1,3.0,4
18682708,Old Merchant Taylors,Old Etonians II,0,4,1.0,4
18638464,Old Sennockians,Old Tonbridgians II,1,1,4.0,2
18638419,Old Rugbeians,Old Epsomians,3,0,2.0,3
18638461,Old Carthusians III,Old Wellingtonians,2,1,4.0,3
18682744,Old Columbans,Old Haberdashers,7,4,3.0,11
18580184,Old Chigwellians III,Old Cholmeleians II,2,5,2.0,7
18647629,Old Westminsters II,Old Wykehamists II,1,2,4.0,3
18768237,Old Kimboltonians,Old Shirburnians,1,3,3.0,4
18768236,Old Harrovians III,Old Suttonians SV,3,0,2.0,3
18768238,Old Alleynians AFC II,Old Albanians SA,1,6,0.0,7
18768311,Old King's Scholars,Old Brentwoods II,3,6,3.0,9
18768242,Old Stoics,Old Kingstonians KGS,6,0,0.0,6
18992931,Old Minchendenians,Old Carthusians,0,3,2.0,3
18974093,Old Tonbridgians Vets,Old Brentwoods Vets,1,3,3.0,4
18974098,Old Bradfieldians Vets,Old Chigwellians Vets,1,5,2.0,6
19026598,Old Berkhamstedians Vets,Old Aldenhamians Vets,4,2,3.0,6
19026608,Old Tonbridgians Vets,Old Brentwoods Vets,3,1,3.0,4
19026615,Old Bradfieldians Vets,Old Chigwellians Vets,5,1,2.0,6
19026597,Old Wykehamists Vets,Old Westminsters Vets,1,5,2.0,6
18580226,Old Carthusians,Old Chigwellians,3,1,3.0,4
18580231,Old Salopians,Old Wykehamists,3,1,3.0,4
18580295,Old Tonbridgians,Old Bradfieldians,2,5,2.0,7
18580202,KCS Old Boys,Old Brentwoods,2,0,2.0,2
18682815,Lancing Old Boys,Old Aldenhamians,4,0,1.0,4
18682868,Old Harrovians,Old Berkhamstedians,4,2,3.0,6
18682881,Old Alleynians AFC,Old Reptonians,8,3,0.0,11
18682884,Old Radleians,Old Malvernians,3,4,4.0,7
18682657,Old Harrovians II,Lancing Old Boys II,3,2,4.0,5
18682718,Old Merchant Taylors,Old Foresters II,1,2,4.0,3
18682664,Kings College Wimbledon II,Old Carthusians II,2,3,4.0,5
18638413,Old Johnians FC,Old Salopians II,4,1,2.0,5
18638415,Old Wellingtonians,Old Tonbridgians II,1,2,4.0,3
18638430,Old Carthusians III,Old Epsomians,3,2,4.0,5
18638416,Old Sennockians,Old Rugbeians,1,2,4.0,3
18682734,Old Brentwoods II,Old Eastbournians,1,6,0.0,7
18647635,Old Kingstonians KGS,Old Wykehamists II,1,2,4.0,3
18647612,Old Shirburnians,Old Berkhamstedians II,2,4,3.0,6
18768233,Old Bancroftians AFC,Old Amplefordians,3,3,5.0,6
18768235,Old Chigwellians III,Old Cholmeleians II,2,4,3.0,6
18768241,Old Haberdashers,Old Westminsters II,0,3,2.0,3
18930105,Old Foresters,Old Manorians,2,3,4.0,5
19008385,Old Tiffinians,Old Cholmeleians,1,2,4.0,3
19042966,Old Columbans,Old Kingsburians,3,0,2.0,3
19062184,Old King's Scholars,Southgate County,6,1,0.0,7
18255538,Old Etonians,Eton College 1st XI,4,3,4.0,7
18255539,Old Etonians II,Eton College 2nd XI,0,1,3.0,1
18580171,KCS Old Boys,Old Foresters,2,0,2.0,2
18580260,Old Etonians,Old Wykehamists,4,3,4.0,7
18580131,Old Bradfieldians,Old Chigwellians,1,3,3.0,4
18580282,Old Tonbridgians,Old Salopians,1,4,2.0,5
18682820,Old Reptonians,Old Aldenhamians,9,0,0.0,9
18682829,Old Berkhamstedians,Old Cholmeleians,1,1,4.0,2
18682843,Old Alleynians AFC,Old Radleians,2,2,5.0,4
18682830,Old Malvernians,Old Harrovians,2,1,4.0,3
18682715,Old Carthusians II,Old Chigwellians II,1,2,4.0,3
18682677,Kings College Wimbledon II,Old Harrovians II,1,2,4.0,3
18682676,Old Foresters II,Old Etonians II,1,1,4.0,2
18638411,Old Epsomians,Old Rugbeians,2,5,2.0,7
18638433,Old Salopians II,Old Tonbridgians II,3,4,4.0,7
18682777,Old Eastbournians,Old Brentwoods II,3,2,4.0,5
18682766,Old Bancroftians AFC,Old Suttonians SV,3,4,4.0,7
18682760,Old Columbans,Old Alleynians AFC II,2,0,2.0,2
18682784,Old Harrovians III,Old Stoics,5,3,4.0,8
18580172,Old Albanians SA,Old Brentwoods III,4,2,3.0,6
18580205,Old Foresters III,Old Chigwellians III,2,1,4.0,3
18580124,Old Kimboltonians,Old Merchant Taylors II,7,2,0.0,9
18647643,Old Westminsters II,Old Kingstonians KGS,2,2,5.0,4
18647646,Old Amplefordians,Old Shirburnians,1,3,3.0,4
18647633,Old Wykehamists II,Old Berkhamstedians II,5,2,2.0,7
19045414,Old Sennockians,National Westminster Bank,3,0,2.0,3
18254318,Lancing Old Boys,Lancing College 1st XI,5,0,0.0,5
18697339,Lancing Old Boys II,Lancing College 2nd XI,3,2,4.0,5
19050859,Old Suttonians,Old Brentwoods,5,1,2.0,6
18974100,Old Haileyburians Vets,Old Cholmeleians Vets,4,4,6.0,8
18974094,Old Etonians Vets,Old Reptonians Vets,5,0,0.0,5
18974099,Old Foresters Vets,Old Salopians Vets,4,0,1.0,4
19026632,Old Haileyburians Vets,Old Cholmeleians Vets,4,4,6.0,8
19026609,Old Etonians Vets,Old Reptonians Vets,0,5,0.0,5
19026616,Old Foresters Vets,Old Salopians Vets,0,4,1.0,4
18355829,Queen Mary College Old Boys,Old Etonians Vets,5,0,0.0,5
18580263,Old Brentwoods,Old Wykehamists,4,5,5.0,9
18580164,Old Tonbridgians,Old Chigwellians,3,1,3.0,4
18580169,KCS Old Boys,Old Salopians,0,2,2.0,2
18580281,Old Foresters,Old Etonians,1,3,3.0,4
18682826,Old Reptonians,Old Berkhamstedians,3,3,5.0,6
18682825,Old Harrovians,Old Alleynians AFC,1,5,2.0,6
18682819,Old Malvernians,Old Cholmeleians,1,1,4.0,2
18682828,Old Radleians,Old Marlburians,0,2,2.0,2
18682650,Old Etonians II,Lancing Old Boys II,2,0,2.0,2
18682674,Old Merchant Taylors,Old Harrovians II,1,2,4.0,3
18682698,Old Chigwellians II,Old Citizens,1,1,4.0,2
18638427,Old Epsomians,Old Aldenhamians II,4,4,6.0,8
18638452,Old Johnians FC,Old Rugbeians,2,1,4.0,3
18638440,Old Wellingtonians,Old Carthusians III,2,2,5.0,4
18682763,Old Suttonians SV,Old Haberdashers,6,4,4.0,10
18682746,Old Alleynians AFC II,Old Brentwoods II,2,1,4.0,3
18682749,Old Bancroftians AFC,Old Stoics,2,6,2.0,8
18647631,Old Berkhamstedians II,Old Amplefordians,1,1,4.0,2
18647616,Old Kingstonians KGS,Old Shirburnians,5,5,6.0,10
18929500,Old Carthusians II,Honourable Artillery Company,0,6,0.0,6
19005335,Old Foresters II,Albanian FC,1,6,0.0,7
19006172,Enfield Old Grammarians,Old Carthusians,1,4,2.0,5
18311133,Old Merchant Taylors II,East Barnet Old Grammarians,1,1,4.0,2
19002881,Old Parkonians,Old King's Scholars,2,6,2.0,8
18580286,KCS Old Boys,Old Chigwellians,0,1,3.0,1
18580159,Old Etonians,Old Tonbridgians,1,2,4.0,3
18580300,Old Foresters,Old Carthusians,0,4,1.0,4
18580233,Old Salopians,Old Brentwoods,0,3,2.0,3
18682822,Old Marlburians,Lancing Old Boys,2,1,4.0,3
18682824,Old Harrovians,Old Reptonians,1,5,2.0,6
18682827,Old Aldenhamians,Old Malvernians,1,2,4.0,3
18682724,Old Chigwellians II,Kings College Wimbledon II,0,0,4.0,0
18682670,Old Etonians II,Old Merchant Taylors,2,0,2.0,2
18682685,Old Westminsters,Old Citizens,3,3,5.0,6
18638459,Old Sennockians,Old Epsomians,1,2,4.0,3
18638436,Old Carthusians III,Old Johnians FC,1,1,4.0,2
18638449,Old Tonbridgians II,Old Rugbeians,6,3,3.0,9
18638437,Old Aldenhamians II,Old Salopians II,4,2,3.0,6
18682757,Old Alleynians AFC II,Old Bancroftians AFC,0,3,2.0,3
18682759,Old Eastbournians,Old Suttonians SV,2,5,2.0,7
18682758,Old Columbans,Old Brentwoods II,1,0,3.0,1
18580198,Old Kimboltonians,Old Chigwellians III,5,2,2.0,7
18647641,Old Kingstonians KGS,Old Berkhamstedians II,4,3,4.0,7
18962598,Old Cholmeleians II,Old Salvatorians,1,5,2.0,6
18882948,Old Cholmeleians,London Lawyers,4,2,3.0,6
18882947,Clissold Park Rangers,Old Alleynians AFC,2,2,5.0,4
18883154,Spaniards,Old Berkhamstedians,4,4,6.0,8
18252990,Old Harrovians II,Harrow School 2nd XI,3,1,3.0,4
18252991,Old Harrovians III,Harrow School 3rd XI,2,1,4.0,3
18266153,Old Wykehamists,Winchester College 1st XI,1,2,4.0,3
18266154,Old Wykehamists II,Winchester College 2nd XI,1,1,4.0,2
18682867,Old Marlburians,Old Aldenhamians,2,2,5.0,4
18682870,Old Reptonians,Old Radleians,2,5,2.0,7
18682725,Old Etonians II,Old Foresters II,5,1,2.0,6
18682706,Old Chigwellians II,Lancing Old Boys II,2,0,2.0,2
18682660,Old Harrovians II,Old Carthusians II,2,2,5.0,4
18682720,Old Westminsters,Kings College Wimbledon II,1,3,3.0,4
18638410,Old Tonbridgians II,Old Johnians FC,1,3,3.0,4
18638457,Old Epsomians,Old Salopians II,2,1,4.0,3
18638407,Old Rugbeians,Old Wellingtonians,3,3,5.0,6
18682761,Old Brentwoods II,Old Bancroftians AFC,4,3,4.0,7
18682781,Old Suttonians SV,Old Alleynians AFC II,2,2,5.0,4
18682797,Old Stoics,Old Eastbournians,6,3,3.0,9
18682737,Old Haberdashers,Old Harrovians III,0,8,0.0,8
18580191,Old Merchant Taylors II,Old Albanians SA,4,4,6.0,8
18580173,Old Foresters III,Old Cholmeleians II,1,2,4.0,3
18647651,Old Wykehamists II,Old King's Scholars,1,0,3.0,1
18647627,Old Amplefordians,Old Westminsters II,1,3,3.0,4
18329340,Old Sennockians,Old Brentwoods,0,5,0.0,5
18329337,Old Kimboltonians,Old Chigwellians,2,0,2.0,2
18329214,Old Bradfieldians,Old Foresters,0,2,2.0,2
18974275,KCS Old Boys,Old Wykehamists,0,2,2.0,2
18974429,Old Malvernians,Old Alleynians AFC,3,4,4.0,7
18329339,Old Harrovians,Old Carthusians,1,3,3.0,4
18329341,Old Salopians,Old Tonbridgians,0,1,3.0,1
18569202,Lancing Old Boys,Old Sedcopians,1,4,2.0,5
18576916,Old Cholmeleians,Somerville Old Boys,4,1,2.0,5
18907136,Old Columbans,Bealonians,3,1,3.0,4
18310949,Old Minchendenians,Old Aldenhamians II,6,1,0.0,7
18311124,Old Brentwoods III,Old Parkonians,0,3,2.0,3
18580138,Old Tonbridgians,Old Brentwoods,2,6,2.0,8
18580137,Old Salopians,Old Bradfieldians,2,1,4.0,3
18682877,Old Marlburians,Old Harrovians,7,2,0.0,9
18682703,Old Foresters II,Old Chigwellians II,1,1,4.0,2
18682721,Old Carthusians II,Lancing Old Boys II,2,1,4.0,3
18638432,Old Carthusians III,Old Aldenhamians II,5,3,4.0,8
18638448,Old Epsomians,Old Johnians FC,4,2,3.0,6
18638456,Old Rugbeians,Old Salopians II,5,1,2.0,6
18682771,Old Stoics,Old Brentwoods II,1,3,3.0,4
18682753,Old Harrovians III,Old Alleynians AFC II,3,1,3.0,4
18580122,Old Albanians SA,Old Foresters III,0,2,2.0,2
18647649,Old Wykehamists II,Old Kingstonians KGS,5,3,4.0,8
18329216,Old Eastbournians,Old Berkhamstedians,1,5,2.0,6
18329344,Old Alleynians AFC,Old Malvernians,0,0,4.0,0
18329215,Old Etonians,Old Radleians,1,0,3.0,1
18329343,Old Amplefordians,Old Reptonians,0,4,1.0,4
18329335,Old Westminsters,Old Columbans,4,2,3.0,6
18329338,Old Cholmeleians,Old Bancroftians AFC,5,3,4.0,8
18568661,Old Carthusians,Old Aloysians,5,1,2.0,6
18962502,Old Finchleians,Old Chigwellians,4,0,1.0,4
18906642,Shene Old Grammarians,Old Sennockians,2,6,2.0,8
18954773,Old Chigwellians III,Old Minchendenians IV,0,6,0.0,6
18894443,Old King's Scholars,UCL Academicals V,4,0,1.0,4
18310940,Old Tenisonians,Old Merchant Taylors,2,1,4.0,3
18683193,Old Aldenhamians,Old Owens,1,4,2.0,5
18953918,Old Etonians II,Old Wilsonians,1,4,2.0,5
18310941,East Barnet Old Grammarians,Old Harrovians II,0,3,2.0,3
18311125,Old Merchant Taylors II,Old Minchendenians,4,2,3.0,6
18260215,Old Wellingtonians Vets,Old Berkhamstedians Vets,5,1,2.0,6
18355826,Old Finchleians,Old Brentwoods Vets,0,3,2.0,3
18355828,Old Lyonians,Old Haileyburians Vets,1,3,3.0,4
18580222,Old Foresters,Old Wykehamists,1,5,2.0,6
18580240,Old Bradfieldians,Old Tonbridgians,1,1,4.0,2
18682838,Old Alleynians AFC,Old Berkhamstedians,1,2,4.0,3
18682832,Old Radleians,Old Harrovians,2,3,4.0,5
18682817,Old Reptonians,Old Marlburians,1,3,3.0,4
18682683,Old Etonians II,Old Chigwellians II,2,3,4.0,5
18682663,Old Westminsters,Lancing Old Boys II,2,1,4.0,3
18682644,Old Citizens,Old Harrovians II,4,2,3.0,6
18682726,Old Carthusians II,Old Merchant Taylors,3,0,2.0,3
18638418,Old Tonbridgians II,Old Aldenhamians II,6,1,0.0,7
18638420,Old Carthusians III,Old Sennockians,2,3,4.0,5
18638447,Old Epsomians,Old Wellingtonians,2,1,4.0,3
18682788,Old Suttonians SV,Old Bancroftians AFC,0,0,4.0,0
18682789,Old Harrovians III,Old Brentwoods II,1,1,4.0,2
18682747,Old Haberdashers,Old Eastbournians,0,3,2.0,3
18682765,Old Columbans,Old Stoics,2,4,3.0,6
18580155,Old Brentwoods III,Old Chigwellians III,1,0,3.0,1
18580135,Old Merchant Taylors II,Old Foresters III,4,3,4.0,7
18580136,Old Albanians SA,Old Kimboltonians,3,2,4.0,5
18647640,Old King's Scholars,Old Amplefordians,2,1,4.0,3
18647644,Old Berkhamstedians II,Old Wykehamists II,3,3,5.0,6
18647639,Old Shirburnians,Old Westminsters II,3,1,3.0,4
18329336,Lancing Old Boys,Old Aldenhamians,3,2,4.0,5
18780043,Kings College Wimbledon II,Old Parkonians,1,3,3.0,4
18569309,Old Cholmeleians II,Southgate County,5,0,0.0,5
18854846,Hale End Athletic,Old Foresters II,2,3,4.0,5
18310912,Old Stationers,Old Carthusians,1,2,4.0,3
18355194,Old Etonians,Old Brentwoods,2,3,4.0,5
18580125,Old Brentwoods,Old Salopians,0,1,3.0,1
18580126,Old Chigwellians,Old Tonbridgians,2,3,4.0,5
18580120,Old Carthusians,Old Etonians,1,1,4.0,2
18580117,Old Bradfieldians,KCS Old Boys,4,2,3.0,6
18682812,Old Radleians,Lancing Old Boys,2,1,4.0,3
18682814,Old Alleynians AFC,Old Cholmeleians,2,3,4.0,5
18682813,Old Malvernians,Old Aldenhamians,3,0,2.0,3
18682865,Old Reptonians,Old Harrovians,3,1,3.0,4
18682709,Kings College Wimbledon II,Old Foresters II,1,7,0.0,8
18682652,Old Carthusians II,Old Etonians II,3,5,4.0,8
18682719,Old Westminsters,Old Harrovians II,5,1,2.0,6
18682704,Lancing Old Boys II,Old Citizens,1,3,3.0,4
18638441,Old Sennockians,Old Johnians FC,1,2,4.0,3
18638460,Old Tonbridgians II,Old Wellingtonians,3,3,5.0,6
18638442,Old Epsomians,Old Carthusians III,1,1,4.0,2
18682785,Old Haberdashers,Old Bancroftians AFC,1,4,2.0,5
18682793,Old Brentwoods II,Old Alleynians AFC II,3,3,5.0,6
18580193,Old Foresters III,Old Brentwoods III,3,1,3.0,4
18580103,Old Albanians SA,Old Cholmeleians II,3,2,4.0,5
18647623,Old Kingstonians KGS,Old Westminsters II,0,6,0.0,6
18329334,Old Shirburnians,Old Suttonians SV,4,1,2.0,5
18329342,Old Wykehamists,KCS Old Boys,1,1,4.0,2
18571499,Southgate County,Old Foresters,0,1,3.0,1
18854816,Old Chigwellians II,Albanian FC,3,4,4.0,7
18907192,Old Salopians II,Shene Old Grammarians,0,1,3.0,1
18260211,Old Westminsters Vets,Old Bradfieldians Vets,1,4,2.0,5
18260210,Old Carthusians Vets,Old Wykehamists Vets,2,1,4.0,3
18580114,Old Etonians,Old Foresters,0,1,3.0,1
18580107,Old Wykehamists,Old Bradfieldians,3,7,2.0,10
18580110,Old Tonbridgians,Old Carthusians,2,3,4.0,5
18682809,Old Reptonians,Old Alleynians AFC,3,1,3.0,4
18682863,Old Berkhamstedians,Lancing Old Boys,3,1,3.0,4
18682857,Old Radleians,Old Cholmeleians,2,1,4.0,3
18682811,Old Harrovians,Old Malvernians,6,0,0.0,6
18682847,Old Aldenhamians,Old Marlburians,3,2,4.0,5
18682651,Old Citizens,Old Foresters II,3,1,3.0,4
18682666,Old Etonians II,Old Harrovians II,1,3,3.0,4
18682649,Old Merchant Taylors,Kings College Wimbledon II,3,1,3.0,4
18638445,Old Johnians FC,Old Aldenhamians II,9,0,0.0,9
18638399,Old Wellingtonians,Old Rugbeians,1,2,4.0,3
18638393,Old Carthusians III,Old Tonbridgians II,1,2,4.0,3
18682741,Old Brentwoods II,Old Haberdashers,5,5,6.0,10
18682745,Old Alleynians AFC II,Old Suttonians SV,1,2,4.0,3
18682742,Old Stoics,Old Harrovians III,1,5,2.0,6
18682769,Old Bancroftians AFC,Old Eastbournians,3,1,3.0,4
18580243,Old Kimboltonians,Old Albanians SA,7,1,0.0,8
18580109,Old Chigwellians III,Old Brentwoods III,2,2,5.0,4
18580112,Old Merchant Taylors II,Old Cholmeleians II,2,3,4.0,5
18647619,Old Shirburnians,Old Amplefordians,1,1,4.0,2
18647620,Old Berkhamstedians II,Old Kingstonians KGS,0,2,2.0,2
18647625,Old King's Scholars,Old Westminsters II,3,1,3.0,4
18571170,Old Bromleians,Old Carthusians II,0,8,0.0,8
18350506,Old Chigwellians,Altis,1,4,2.0,5
18350514,Old Columbans,Old Parmiterians,6,1,0.0,7
18887303,Old Epsomians,Clapham Old Xaverians,0,1,3.0,1
18350515,Old Sennockians,Old Hamptonians,3,1,3.0,4
18266290,Old Salopians,Shrewsbury School 1st XI,2,0,2.0,2
18266291,Old Salopians II,Shrewsbury School 2nd XI,0,0,4.0,0
18580303,Old Bradfieldians,Old Salopians,2,1,4.0,3
18580099,Old Etonians,KCS Old Boys,3,0,2.0,3
18682810,Old Aldenhamians,Old Cholmeleians,0,3,2.0,3
18682808,Old Marlburians,Old Radleians,3,2,4.0,5
18682807,Lancing Old Boys,Old Harrovians,2,5,2.0,7
18682648,Old Foresters II,Old Westminsters,4,3,4.0,7
18682661,Old Citizens,Old Chigwellians II,1,0,3.0,1
18638397,Old Rugbeians,Old Sennockians,0,3,2.0,3
18638402,Old Aldenhamians II,Old Tonbridgians II,0,4,1.0,4
18638398,Old Salopians II,Old Wellingtonians,3,1,3.0,4
18682778,Old Alleynians AFC II,Old Harrovians III,1,6,0.0,7
18682772,Old Eastbournians,Old Columbans,1,6,0.0,7
18682779,Old Haberdashers,Old Stoics,1,4,2.0,5
18580254,Old Cholmeleians II,Old Albanians SA,1,3,3.0,4
18580101,Old Kimboltonians,Old Brentwoods III,3,3,5.0,6
18580227,Old Merchant Taylors II,Old Chigwellians III,2,1,4.0,3
18647618,Old Amplefordians,Old Wykehamists II,1,2,4.0,3
18647617,Old Berkhamstedians II,Old Westminsters II,0,4,1.0,4
18861479,Old Brentwoods II,Old Owens,2,3,4.0,5
18350509,Old Reptonians,Old Berkhamstedians,3,4,4.0,7
18350508,Old Uffingtonians FC,Old Malvernians,4,1,2.0,5
18350507,Old Alleynians AFC,Old Strand Academicals,3,0,2.0,3
18259232,Old Carthusians,Charterhouse School 1st XI,12,0,0.0,12
18259233,Old Carthusians II,Charterhouse School 2nd XI,0,0,4.0,0
18259234,Old Carthusians III,Charterhouse School 3rd XI,6,2,2.0,8
18310908,Old Chigwellians,Glyn Old Boys,2,3,4.0,5
18310903,Old Finchleians,Old Brentwoods,4,6,4.0,10
18310930,Old Etonians II,Enfield Old Grammarians,4,3,4.0,7
18310931,Lancing Old Boys II,Old Blues,1,3,3.0,4
18310932,Old Merchant Taylors,Old Finchleians,5,3,4.0,8
18543584,Old Foresters,Hullbridge Sports Saturday Reserves,1,2,4.0,3
18580245,Old Carthusians,Old Brentwoods,3,1,3.0,4
18580095,Old Foresters,KCS Old Boys,3,2,4.0,5
18682831,Lancing Old Boys,Old Alleynians AFC,2,4,3.0,6
18682805,Old Marlburians,Old Cholmeleians,1,0,3.0,1
18682806,Old Berkhamstedians,Old Radleians,1,2,4.0,3
18682643,Lancing Old Boys II,Old Foresters II,0,3,2.0,3
18682645,Old Westminsters,Old Merchant Taylors,6,0,0.0,6
18682713,Old Chigwellians II,Old Etonians II,0,2,2.0,2
18638396,Old Johnians FC,Old Carthusians III,4,0,1.0,4
18682775,Old Alleynians AFC II,Old Eastbournians,1,0,3.0,1
18682735,Old Haberdashers,Old Suttonians SV,3,7,2.0,10
18580092,Old Chigwellians III,Old Albanians SA,2,3,4.0,5
18580147,Old Brentwoods III,Old Foresters III,3,5,4.0,8
18647615,Old Shirburnians,Old Wykehamists II,8,2,0.0,10
18647613,Old Westminsters II,Old Amplefordians,2,4,3.0,6
18350505,Old Wykehamists,Queen Mary College Old Boys,5,7,4.0,12
18350839,Kings College Wimbledon II,Alleyn Old Boys,4,5,5.0,9
18259452,Old Harrovians,Harrow School 1st XI,0,0,4.0,0
18259453,Old Harrovians II,Harrow School 2nd XI,0,0,4.0,0
18259454,Old Harrovians III,Harrow School 3rd XI,0,0,4.0,0
18330181,Old Kimboltonians,Kimbolton School 1st XI,4,2,3.0,6
18914057,Old Wykehamists Vets,Lancing Old Boys Vets,1,1,4.0,2
18580091,Old Chigwellians,Old Wykehamists,3,1,3.0,4
18580084,Old Bradfieldians,Old Etonians,1,1,4.0,2
18580083,Old Tonbridgians,KCS Old Boys,0,1,3.0,1
18682889,Old Malvernians,Old Alleynians AFC,2,3,4.0,5
18682804,Lancing Old Boys,Old Cholmeleians,1,1,4.0,2
18682875,Old Aldenhamians,Old Reptonians,0,4,1.0,4
18682642,Old Westminsters,Old Chigwellians II,2,0,2.0,2
18682694,Lancing Old Boys II,Old Carthusians II,0,5,0.0,5
18682699,Kings College Wimbledon II,Old Etonians II,2,0,2.0,2
18638395,Old Carthusians III,Old Salopians II,1,4,2.0,5
18638458,Old Johnians FC,Old Tonbridgians II,2,2,5.0,4
18638394,Old Aldenhamians II,Old Rugbeians,1,4,2.0,5
18682731,Old Harrovians III,Old Bancroftians AFC,1,1,4.0,2
18682733,Old Stoics,Old Haberdashers,7,3,2.0,10
18682732,Old Alleynians AFC II,Old Columbans,2,2,5.0,4
18580220,Old Foresters III,Old Merchant Taylors II,1,2,4.0,3
18580087,Old Kimboltonians,Old Cholmeleians II,1,1,4.0,2
18647637,Old Amplefordians,Old Kingstonians KGS,2,3,4.0,5
18350504,Old Salopians,Southgate County,2,3,4.0,5
18350511,Old Foresters II,Old Salvatorians,3,1,3.0,4
18506415,Old Brentwoods,Brentwood School 1st XI,5,2,2.0,7
18554530,Old Brentwoods II,Brentwood School 2nd XI,2,2,5.0,4
18506416,Old Brentwoods III,Brentwood School 3rd XI,3,2,4.0,5
18506417,Old Brentwoods Vets,Brentwood School 4th XI,0,0,4.0,0
18252986,Old Marlburians,Marlborough College 1st XI,5,2,2.0,7
18252992,Old Cholmeleians,Highgate School 1st XI,3,0,2.0,3
18252993,Old Cholmeleians II,Highgate School 2nd XI,0,0,4.0,0
18272292,Old Reptonians,Repton School 1st XI,1,1,4.0,2
18773610,Old Kingstonians KGS,Kingston Grammar School 1st XI,3,1,3.0,4
18258792,Old Parkonians,Old Carthusians,2,5,2.0,7
18638196,Clapham Rovers,Old Carthusians,0,3,2.0,3
18638194,Ibis Eagles,Old Carthusians,0,3,2.0,3
21233948,Old Carthusians,Old Bradfieldians,2,0,2.0,2
20556341,Old Etonians Vets,Old Malvernians Vets,1,1,4.0,2
20625192,Old Reptonians,Old Carthusians,0,3,2.0,3
21233947,Old Bradfieldians,Old Tonbridgians,1,0,3.0,1
20584370,Old Carthusians II,Old Columbans,1,0,3.0,1
20625086,Old Brentwoods II,Old Kimboltonians,1,4,2.0,5
20584045,Old Tonbridgians,Old Bradfieldians,1,1,4.0,2
20845917,Old Ardinians,Old Epsomians,3,2,4.0,5
20809547,Old Westminsters II,Old Amplefordians,3,2,4.0,5
20599033,Old Wellingtonians Vets,Old Tonbridgians Vets,1,2,4.0,3
19702949,Old Chigwellians,Old Alleynians AFC,4,8,2.0,12
19702912,Old Tonbridgians,Old Foresters,1,2,4.0,3
19702943,Old Bradfieldians,Old Etonians,1,3,3.0,4
19836193,Old Berkhamstedians,Old Westminsters,2,2,5.0,4
19836248,Old Marlburians,Old Wykehamists,0,2,2.0,2
19750495,Old Foresters II,Old Rugbeians,1,7,0.0,8
19750558,Old Sennockians,Old Carthusians II,0,5,0.0,5
19750553,Old Chigwellians II,Old Merchant Taylors,1,2,4.0,3
19929968,Old Epsomians,Lancing Old Boys II,3,3,5.0,6
19930003,Old Suttonians SV,Old Wellingtonians,1,3,3.0,4
19890744,Old Alleynians AFC II,Old Brentwoods II,0,2,2.0,2
19908675,Old Cholmeleians II,Old Brentwoods III,5,1,2.0,6
20580940,Old Carthusians,Old Reptonians,0,0,4.0,0
20611604,Old Brentwoods II,Old Alleynians AFC II,2,0,2.0,2
19836235,Old Radleians,Old Malvernians,2,3,4.0,5
20585757,Old Westminsters Vets,Old Carthusians Vets,1,4,2.0,5
19702914,Old Foresters,Old Chigwellians,2,0,2.0,2
19702930,Old Etonians,Old Tonbridgians,2,3,4.0,5
19836243,Old Wykehamists,Old Cholmeleians,4,0,1.0,4
19836218,Old Westminsters,Lancing Old Boys,3,3,5.0,6
19750499,Old Aldenhamians,Old Rugbeians,2,5,2.0,7
19750516,Old Harrovians II,Old Carthusians II,4,4,6.0,8
19929967,Old Columbans,Old Suttonians SV,1,0,3.0,1
19930021,Kings College Wimbledon II,Old Wellingtonians,1,0,3.0,1
19929998,Old Wellingtonians,Kings College Wimbledon II,1,0,3.0,1
19926398,Old Kingstonians KGS,Old Westminsters II,0,5,0.0,5
19926427,Old Wykehamists II,Old Eastbournians,0,1,3.0,1
20584265,Old Brentwoods II,Old Cholmeleians II,3,1,3.0,4
20597565,Old Alleynians AFC III,Old Kimboltonians,4,4,6.0,8
20459921,Old Malvernians,Malvern College 1st XI,3,1,3.0,4
20510133,Old Shirburnians,Sherborne School 1st XI,2,0,2.0,2
19836192,Old Marlburians,Old Reptonians,7,4,3.0,11
20018055,Old Wykehamists Vets,Lancing Old Boys Vets,3,3,5.0,6
20478255,Old Brentwoods Vets,Old Foresters Vets,4,4,6.0,8
20533418,Old Bradfieldians Vets,Old Wellingtonians Vets,4,5,5.0,9
19702928,Old Chigwellians,KCS Old Boys,1,4,2.0,5
19702967,Old Tonbridgians,Old Etonians,1,4,2.0,5
19750537,Old Rugbeians,Old Etonians II,1,1,4.0,2
19750556,Old Etonians II,Old Rugbeians,0,1,3.0,1
19750559,Old Aldenhamians,Old Harrovians II,2,4,3.0,6
19930019,Old Columbans,Old Carthusians III,4,2,3.0,6
19929983,Old Tonbridgians II,Old Johnians FC,1,9,0.0,10
19890722,Old Brentwoods II,Old Shirburnians,5,1,2.0,6
19926424,Old Eastbournians,Old Kingstonians KGS,2,2,5.0,4
19926402,Old Wykehamists II,Old Berkhamstedians II,2,4,3.0,6
20570507,Old Alleynians AFC III,Old Amplefordians,5,1,2.0,6
20584027,Old Kimboltonians,Old Westminsters II,5,0,0.0,5
20570527,Old Stoics,Old Alleynians AFC II,1,5,2.0,6
20018066,Old Carthusians Vets,Old Wykehamists Vets,0,3,2.0,3
20536053,Old Wykehamists Vets,Old Westminsters Vets,0,3,2.0,3
20489642,Old Foresters Vets,Old Chigwellians Vets,0,2,2.0,2
19702946,Old Harrovians,KCS Old Boys,0,3,2.0,3
19836203,Old Cholmeleians,Old Berkhamstedians,2,2,5.0,4
19836216,Old Marlburians,Lancing Old Boys,2,4,3.0,6
19836201,Old Wykehamists,Old Malvernians,1,0,3.0,1
19836247,Old Westminsters,Old Radleians,3,4,4.0,7
19750529,Old Sennockians,Old Etonians II,0,5,0.0,5
19750566,Old Aldenhamians,Old Chigwellians II,1,0,3.0,1
19929952,Old Wellingtonians,Old Johnians FC,2,4,3.0,6
19929995,Old Carthusians III,Old Suttonians SV,3,4,4.0,7
19890738,Old Bancroftians AFC,Old Harrovians III,6,1,0.0,7
19890754,Old Kimboltonians,Old Stoics,8,3,0.0,11
19926404,Old Amplefordians,Old Alleynians AFC III,0,2,2.0,2
20388601,Old Rugbeians,Old Bradfieldians,1,5,2.0,6
20554168,Old Columbans,Old Harrovians II,1,0,3.0,1
20554158,Old Carthusians II,Old Epsomians,3,2,4.0,5
20530819,Old Brentwoods II,Old Wykehamists II,10,3,1.0,13
20554170,Old Brentwoods III,Old Westminsters II,2,4,3.0,6
19702913,Old Etonians,Old Alleynians AFC,2,2,5.0,4
19702922,Old Etonians,Old Harrovians,1,3,3.0,4
19836230,Old Westminsters,Old Berkhamstedians,3,1,3.0,4
19836191,Old Brentwoods,Old Reptonians,2,0,2.0,2
19750522,Old Etonians II,Old Harrovians II,4,2,3.0,6
19750555,Old Carthusians II,Old Merchant Taylors,6,0,0.0,6
19930016,Old Wellingtonians,Lancing Old Boys II,3,4,4.0,7
19929984,Old Epsomians,Old Johnians FC,2,2,5.0,4
19929986,Old Columbans,Kings College Wimbledon II,4,4,6.0,8
20446883,Old Tonbridgians,Old Kimboltonians,2,1,4.0,3
20399579,Old Carthusians,Old Alleynians AFC,3,2,4.0,5
20536039,Old Bancroftians AFC,Old Amplefordians,2,2,5.0,4
20537839,Old Alleynians AFC II,Old Merchant Taylors II,4,0,1.0,4
20554810,Old Gregorians,Old Alleynians AFC III,3,10,1.0,13
20554445,Old Berkhamstedians II,Old Cholmeleians II,2,4,3.0,6
20528638,Hale End Athletic,Old Cholmeleians,2,2,5.0,4
20521663,Alleyn Old Boys,Old Brentwoods II,3,1,3.0,4
20521963,Old Chigwellians Vets,Old Etonians Vets,1,2,4.0,3
19702960,Old Salopians,Old Tonbridgians,1,2,4.0,3
19702906,Old Carthusians,Old Chigwellians,9,1,0.0,10
19702950,Old Harrovians,Old Etonians,1,1,4.0,2
19836233,Old Marlburians,Old Berkhamstedians,3,1,3.0,4
19836215,Old Radleians,Old Wykehamists,2,5,2.0,7
19836260,Old Brentwoods,Old Malvernians,4,1,2.0,5
19750491,Old Chigwellians II,Old Aldenhamians,1,1,4.0,2
19750549,Old Merchant Taylors,Old Etonians II,1,4,2.0,5
19929957,Lancing Old Boys II,Old Johnians FC,1,4,2.0,5
19930008,Old Tonbridgians II,Kings College Wimbledon II,0,1,3.0,1
19890779,Old Brentwoods II,Old Salopians II,4,3,4.0,7
20489842,Old Haberdashers,Old Merchant Taylors II,5,2,2.0,7
19926422,Old Amplefordians,Old Westminsters II,2,0,2.0,2
20399622,KCS Old Boys,Old Reptonians,1,3,3.0,4
20492841,Old Harrovians II,Old Eastbournians,6,0,0.0,6
20499004,Old Rugbeians,Old Epsomians,1,3,3.0,4
20521660,Old Gregorians,Old Kingstonians KGS,5,3,4.0,8
20544315,Old Berkhamstedians II,Old Rugbeians II,5,2,2.0,7
20535885,Old Shirburnians,Old Kimboltonians,1,3,3.0,4
20512848,Old Brentwoods III,Old King's Scholars,3,3,5.0,6
19702961,Old Salopians,Old Alleynians AFC,1,4,2.0,5
19702919,Old Tonbridgians,KCS Old Boys,0,0,4.0,0
19702963,Old Chigwellians,Old Foresters,2,2,5.0,4
19836236,Old Reptonians,Old Berkhamstedians,1,2,4.0,3
19836227,Old Brentwoods,Old Westminsters,2,4,3.0,6
19836271,Old Wykehamists,Old Radleians,1,3,3.0,4
19750547,Old Sennockians,Old Rugbeians,0,2,2.0,2
19750538,Old Harrovians II,Old Merchant Taylors,5,5,6.0,10
19750509,Old Aldenhamians,Old Foresters II,2,2,5.0,4
19750543,Old Chigwellians II,Old Etonians II,4,5,5.0,9
19929959,Old Johnians FC,Old Columbans,3,0,2.0,3
19930001,Old Carthusians III,Old Epsomians,2,3,4.0,5
19890725,Old King's Scholars,Old Bancroftians AFC,0,2,2.0,2
19890762,Old Brentwoods II,Old Kimboltonians,1,1,4.0,2
19908630,Old Cholmeleians II,Old Albanians SA,3,5,4.0,8
20492843,Old Carthusians II,Old Alleynians AFC II,1,1,4.0,2
20512843,Old Harrovians III,Old Merchant Taylors II,0,0,4.0,0
20512841,Old Amplefordians,Old Haberdashers,4,1,2.0,5
20512842,Old Eastbournians,Old Shirburnians,1,2,4.0,3
20039309,Old Carthusians,Polytechnic,1,2,4.0,3
20311089,Lancing Old Boys Vets,Old Malvernians Vets,2,3,4.0,5
19702905,Old Alleynians AFC,Old Bradfieldians,3,1,3.0,4
19702941,Old Carthusians,Old Harrovians,5,2,2.0,7
19702904,Old Salopians,KCS Old Boys,1,6,0.0,7
19702942,Old Tonbridgians,Old Chigwellians,2,3,4.0,5
19702901,Old Foresters,Old Etonians,1,2,4.0,3
19836208,Old Berkhamstedians,Old Brentwoods,0,10,0.0,10
19836210,Old Radleians,Old Westminsters,1,3,3.0,4
19836254,Lancing Old Boys,Old Reptonians,2,1,4.0,3
19836225,Old Cholmeleians,Old Malvernians,1,0,3.0,1
19836222,Old Wykehamists,Old Marlburians,9,1,0.0,10
19750515,Old Carthusians II,Old Rugbeians,6,0,0.0,6
19750525,Old Merchant Taylors,Old Sennockians,0,9,0.0,9
19750554,Old Foresters II,Old Chigwellians II,2,2,5.0,4
19929951,Old Suttonians SV,Old Johnians FC,2,5,2.0,7
19929965,Old Carthusians III,Old Columbans,1,6,0.0,7
19929982,Old Wellingtonians,Old Epsomians,2,4,3.0,6
19930013,Lancing Old Boys II,Old Tonbridgians II,1,8,0.0,9
19890745,Old Stoics,Old Alleynians AFC II,0,2,2.0,2
19890790,Old Shirburnians,Old Salopians II,1,0,3.0,1
20489832,Old Haberdashers,Old Albanians SA,2,3,4.0,5
19908607,Old Brentwoods III,Old Merchant Taylors II,5,1,2.0,6
19926392,Old Berkhamstedians II,Old Kingstonians KGS,5,2,2.0,7
20477129,Old Tenisonians,Old Etonians II,0,3,2.0,3
20372574,Old Brentwoods II,Bealonians,5,1,2.0,6
19702929,Old Salopians,Old Foresters,2,2,5.0,4
19702924,Old Bradfieldians,KCS Old Boys,3,2,4.0,5
19702953,Old Alleynians AFC,Old Etonians,2,2,5.0,4
19702907,Old Tonbridgians,Old Harrovians,4,4,6.0,8
19836256,Lancing Old Boys,Old Berkhamstedians,3,3,5.0,6
19836265,Old Reptonians,Old Westminsters,3,1,3.0,4
19836221,Old Malvernians,Old Wykehamists,7,10,3.0,17
19750541,Old Etonians II,Old Foresters II,3,1,3.0,4
19750523,Old Aldenhamians,Old Merchant Taylors,3,2,4.0,5
19929972,Lancing Old Boys II,Old Columbans,0,4,1.0,4
19930002,Kings College Wimbledon II,Old Johnians FC,0,1,3.0,1
19890770,Old Harrovians III,Old Shirburnians,2,1,4.0,3
19890728,Old Bancroftians AFC,Old Alleynians AFC II,0,1,3.0,1
19890768,Old Stoics,Old Salopians II,5,4,5.0,9
19926400,Old Eastbournians,Old Alleynians AFC III,2,6,2.0,8
20447480,Old Kimboltonians,Old Rugbeians,1,2,4.0,3
20487762,TBC,Old Gregorians,3,3,5.0,6
20310986,Old Foresters Vets,Old Haileyburians Vets,3,1,3.0,4
20338556,Old Brentwoods Vets,Old Harrovians Vets,4,2,3.0,6
20241107,Old Reptonians Vets,Old Carthusians Vets,3,9,0.0,12
20348135,Old Tonbridgians Vets,Old Salopians Vets,4,0,1.0,4
19702939,Old Foresters,Old Bradfieldians,3,10,1.0,13
19702970,Old Salopians,Old Etonians,0,2,2.0,2
19702932,Old Chigwellians,Old Harrovians,4,1,2.0,5
19702968,Old Alleynians AFC,KCS Old Boys,0,5,0.0,5
19836253,Old Berkhamstedians,Old Cholmeleians,1,8,0.0,9
19836245,Old Brentwoods,Lancing Old Boys,2,1,4.0,3
19836195,Old Marlburians,Old Radleians,1,1,4.0,2
19836190,Old Westminsters,Old Malvernians,8,1,0.0,9
19750542,Old Foresters II,Old Aldenhamians,3,3,5.0,6
19750570,Old Etonians II,Old Merchant Taylors,0,0,4.0,0
19930017,Kings College Wimbledon II,Old Carthusians III,0,2,2.0,2
19890755,Old King's Scholars,Old Kimboltonians,2,2,5.0,4
19890743,Old Bancroftians AFC,Old Salopians II,0,1,3.0,1
19908658,Old Brentwoods III,Old Haberdashers,4,1,2.0,5
19926408,Old Berkhamstedians II,Old Alleynians AFC III,3,7,2.0,10
19926401,Old Amplefordians,Old Kingstonians KGS,3,2,4.0,5
19926420,Old Wykehamists II,Old Westminsters II,0,5,0.0,5
20447479,Old Johnians FC,Old Alleynians AFC II,2,3,4.0,5
20447481,Old Sennockians,Old Shirburnians,6,3,3.0,9
20447477,Old Epsomians,Old Cholmeleians II,6,1,0.0,7
20447482,Old Suttonians SV,Old Eastbournians,3,4,4.0,7
20391405,Lancing Old Boys II,Old Harrovians II,1,1,4.0,2
20447478,Old Columbans,Old Tonbridgians II,4,4,6.0,8
20372026,Old Brentwoods II,Old Carthusians II,0,2,2.0,2
20372598,Old Carthusians,Honourable Artillery Company,0,1,3.0,1
20398858,Old Reptonians,Old Wykehamists,1,0,3.0,1
20447457,Old Rugbeians,Old Meadonians,5,3,4.0,8
19702897,Old Carthusians,Old Foresters,5,1,2.0,6
19702908,Old Chigwellians,Old Bradfieldians,1,7,0.0,8
19702956,Old Harrovians,Old Salopians,1,1,4.0,2
19836189,Old Wykehamists,Lancing Old Boys,2,2,5.0,4
19836219,Old Brentwoods,Old Cholmeleians,4,4,6.0,8
19836220,Old Reptonians,Old Radleians,3,1,3.0,4
19750482,Old Etonians II,Old Aldenhamians,2,2,5.0,4
19750505,Old Sennockians,Old Foresters II,0,2,2.0,2
19750512,Old Harrovians II,Old Rugbeians,1,3,3.0,4
19750535,Old Chigwellians II,Old Carthusians II,0,5,0.0,5
19929979,Old Epsomians,Old Tonbridgians II,2,5,2.0,7
19890776,Old Shirburnians,Old Brentwoods II,1,5,2.0,6
19890761,Old Stoics,Old Bancroftians AFC,0,2,2.0,2
19908665,Old Albanians SA,Old Brentwoods III,6,1,0.0,7
20289817,Old Columbans,Old Kimboltonians,1,2,4.0,3
19537199,Old Alleynians AFC,Dulwich College 1st XI,3,3,5.0,6
19537200,Old Alleynians AFC II,Dulwich College 2nd XI,2,0,2.0,2
19537201,Old Alleynians AFC III,Dulwich College 3rd XI,5,0,0.0,5
19750572,KCS Old Boys,"King's College School, Wimbledon 1st XI",4,1,2.0,5
19750573,Kings College Wimbledon II,"King's College School, Wimbledon 2nd XI",0,0,4.0,0
19836206,Lancing Old Boys,Old Cholmeleians,1,5,2.0,6
19750494,Old Carthusians II,Old Harrovians II,3,0,2.0,3
19750514,Old Sennockians,Old Aldenhamians,0,2,2.0,2
19890763,Old Shirburnians,Old King's Scholars,1,2,4.0,3
19908644,Old Haberdashers,Old Merchant Taylors II,2,3,4.0,5
20214942,Old Reptonians,Old Suttonians SV,5,1,2.0,6
20242964,Old Salopians,Old Alleynians AFC,0,1,3.0,1
20289951,Old Tonbridgians,Old Wykehamists,6,1,0.0,7
20242720,Old Radleians,Old Carthusians,0,7,0.0,7
20283026,Old Carthusians III,Old Rugbeians,1,7,0.0,8
19702965,Old Carthusians,Old Alleynians AFC,2,0,2.0,2
19836223,Old Malvernians,Old Reptonians,0,1,3.0,1
19836199,Old Brentwoods,Old Wykehamists,3,2,4.0,5
19836226,Old Berkhamstedians,Old Radleians,4,4,6.0,8
19750513,Old Etonians II,Old Sennockians,7,4,3.0,11
19929970,Old Wellingtonians,Old Carthusians III,3,3,5.0,6
19929975,Old Columbans,Old Tonbridgians II,3,1,3.0,4
19890782,Old Alleynians AFC II,Old Kimboltonians,3,2,4.0,5
19890749,Old Stoics,Old King's Scholars,1,3,3.0,4
19890785,Old Shirburnians,Old Harrovians III,3,0,2.0,3
19926413,Old Berkhamstedians II,Old Wykehamists II,1,2,4.0,3
20243298,Old Rugbeians,Old Westminsters,3,2,4.0,5
20242975,Old Bradfieldians,Old Foresters,5,0,0.0,5
20267345,KCS Old Boys,Old Harrovians,3,2,4.0,5
20300167,Old Cholmeleians II,Old Merchant Taylors,5,2,2.0,7
20352526,Old Brentwoods II,Kings College Wimbledon II,4,2,3.0,6
19836209,Old Cholmeleians,Old Marlburians,6,1,0.0,7
20347298,Old Wykehamists Vets,Old Etonians Vets,1,0,3.0,1
20311694,Alleyn Old Boys,Old Chigwellians Vets,0,1,3.0,1
19702971,Old Harrovians,Old Foresters,1,2,4.0,3
19702926,Old Tonbridgians,Old Carthusians,1,11,0.0,12
19702883,KCS Old Boys,Old Chigwellians,3,0,2.0,3
19836224,Old Cholmeleians,Old Westminsters,2,1,4.0,3
19836211,Old Radleians,Lancing Old Boys,1,2,4.0,3
19836246,Old Reptonians,Old Malvernians,1,1,4.0,2
19836237,Old Brentwoods,Old Marlburians,6,3,3.0,9
19750521,Old Rugbeians,Old Foresters II,2,1,4.0,3
19929974,Old Johnians FC,Old Suttonians SV,3,1,3.0,4
19929994,Lancing Old Boys II,Kings College Wimbledon II,0,5,0.0,5
19890750,Old Bancroftians AFC,Old King's Scholars,1,2,4.0,3
19890792,Old Stoics,Old Harrovians III,1,1,4.0,2
19908649,Old Merchant Taylors II,Old Brentwoods III,5,1,2.0,6
19926430,Old Wykehamists II,Old Amplefordians,3,4,4.0,7
19926403,Old Westminsters II,Old Kingstonians KGS,3,3,5.0,6
20290342,Old Berkhamstedians II,Old Columbans,2,8,0.0,10
20283022,Old Aldenhamians,Old Kimboltonians,2,5,2.0,7
20292796,Old Chigwellians II,Old Alleynians AFC II,1,1,4.0,2
20290255,Old Albanians SA,Old Epsomians,2,5,2.0,7
20306901,Old Rugbeians II,Old Harrovians II,0,9,0.0,9
20283021,Old Etonians II,Old Tonbridgians II,2,2,5.0,4
20291884,Old Carthusians II,Old Thorntonians,1,5,2.0,6
20310881,Old Wykehamists,Rob Roy Rovers,2,1,4.0,3
20244681,Old Minchendenians,Old Etonians,5,3,4.0,8
20638917,Old Chigwellians Vets,London Lions Vets,2,4,3.0,6
20278962,Old Cholmeleians II,Polytechnic,2,6,2.0,8
20268291,Old Brentwoods II,West Wickham,3,2,4.0,5
19516920,Old Berkhamstedians Vets,Old Etonians Vets,0,1,3.0,1
20240977,Old Berkhamstedians Vets,Old Etonians Vets,1,0,3.0,1
19702911,KCS Old Boys,Old Alleynians AFC,4,2,3.0,6
19702887,Old Harrovians,Old Bradfieldians,6,4,4.0,10
19702957,Old Chigwellians,Old Tonbridgians,0,6,0.0,6
19836228,Lancing Old Boys,Old Wykehamists,0,4,1.0,4
19836207,Old Malvernians,Old Radleians,4,1,2.0,5
19836214,Old Westminsters,Old Reptonians,1,1,4.0,2
19750486,Old Foresters II,Old Carthusians II,1,6,0.0,7
19750544,Old Sennockians,Old Merchant Taylors,1,3,3.0,4
19929978,Kings College Wimbledon II,Old Columbans,2,7,0.0,9
19929999,Lancing Old Boys II,Old Carthusians III,1,4,2.0,5
19929993,Old Suttonians SV,Old Epsomians,2,4,3.0,6
19929991,Old Johnians FC,Old Wellingtonians,5,2,2.0,7
19890730,Old Bancroftians AFC,Old Shirburnians,2,7,0.0,9
19890736,Old King's Scholars,Old Alleynians AFC II,3,3,5.0,6
19890778,Old Kimboltonians,Old Harrovians III,5,3,4.0,8
19908625,Old Albanians SA,Old Haberdashers,6,1,0.0,7
19908663,Old Cholmeleians II,Old Merchant Taylors II,8,0,0.0,8
19926397,Old Wykehamists II,Old Alleynians AFC III,2,1,4.0,3
19926426,Old Kingstonians KGS,Old Berkhamstedians II,4,3,4.0,7
19926412,Old Amplefordians,Old Eastbournians,2,2,5.0,4
20251034,Old Dorkinians,Old Foresters,3,0,2.0,3
20251035,Old Carthusians,Winchmore Hill,5,0,0.0,5
20271496,Old Cholmeleians,Worcester College Old Boys,3,2,4.0,5
20295319,Old Rugbeians,Old Thorntonians,12,2,1.0,14
20294144,Old Owens,Old Etonians II,0,3,2.0,3
19702936,Old Etonians,Old Salopians,3,1,3.0,4
20018058,Old Harrovians Vets,Old Wykehamists Vets,2,3,4.0,5
19702959,Old Alleynians AFC,Old Foresters,0,2,2.0,2
19702969,Old Bradfieldians,Old Carthusians,3,2,4.0,5
19702937,Old Harrovians,Old Tonbridgians,1,2,4.0,3
19836255,Old Marlburians,Old Westminsters,3,4,4.0,7
19836212,Old Berkhamstedians,Old Malvernians,1,2,4.0,3
19836240,Old Brentwoods,Old Radleians,9,1,0.0,10
19750552,Old Carthusians II,Old Foresters II,4,1,2.0,5
19750510,Old Merchant Taylors,Old Aldenhamians,6,0,0.0,6
19750528,Old Harrovians II,Old Chigwellians II,0,1,3.0,1
19929996,Old Johnians FC,Lancing Old Boys II,3,1,3.0,4
19929955,Old Suttonians SV,Old Carthusians III,8,0,0.0,8
19890789,Old Harrovians III,Old King's Scholars,3,3,5.0,6
19890751,Old Kimboltonians,Old Salopians II,0,1,3.0,1
19890733,Old Bancroftians AFC,Old Stoics,1,1,4.0,2
19908666,Old Haberdashers,Old Cholmeleians II,2,5,2.0,7
19926405,Old Eastbournians,Old Berkhamstedians II,2,3,4.0,5
19926396,Old Wykehamists II,Old Kingstonians KGS,4,1,2.0,5
19926425,Old Westminsters II,Old Alleynians AFC III,2,4,3.0,6
20218639,Old Chigwellians,Hale End Athletic,1,3,3.0,4
20218640,Old Cholmeleians,Spaniards,0,2,2.0,2
20271556,IB Albion,Old Reptonians,1,2,4.0,3
19656412,Old Etonians,Eton College 1st XI,0,0,4.0,0
20321778,Old Etonians II,Eton College 2nd XI,0,0,4.0,0
20256254,Old Columbans,Bealonians,4,4,6.0,8
19465645,Winchester College 1st XI,Old Wykehamists,3,3,5.0,6
20018064,Old Tonbridgians Vets,Lancing Old Boys Vets,1,3,3.0,4
19516921,Old Chigwellians Vets,Old Wykehamists Vets,9,1,0.0,10
19516919,Old Aldenhamians Vets,Old Foresters Vets,2,9,0.0,11
20110877,Old Tonbridgians Vets,Old Malvernians Vets,0,7,0.0,7
20240979,Old Chigwellians Vets,Old Wykehamists Vets,1,9,0.0,10
20240975,Old Aldenhamians Vets,Old Foresters Vets,9,2,0.0,11
20240978,Old Tonbridgians Vets,Old Malvernians Vets,7,0,0.0,7
19702951,Old Foresters,Old Salopians,1,0,3.0,1
19702958,Old Chigwellians,Old Carthusians,1,4,2.0,5
19702964,KCS Old Boys,Old Harrovians,4,1,2.0,5
19836196,Old Cholmeleians,Old Reptonians,4,3,4.0,7
19836238,Old Malvernians,Old Westminsters,3,2,4.0,5
19750508,Old Etonians II,Old Carthusians II,0,2,2.0,2
19929956,Old Wellingtonians,Old Columbans,3,5,4.0,8
19930000,Old Johnians FC,Old Epsomians,1,1,4.0,2
19929985,Old Carthusians III,Old Tonbridgians II,1,5,2.0,6
19930011,Old Suttonians SV,Kings College Wimbledon II,2,3,4.0,5
19890777,Old Alleynians AFC II,Old King's Scholars,1,0,3.0,1
19890767,Old Harrovians III,Old Kimboltonians,0,4,1.0,4
19890735,Old Salopians II,Old Bancroftians AFC,2,2,5.0,4
19890726,Old Shirburnians,Old Stoics,4,2,3.0,6
19926391,Old Westminsters II,Old Amplefordians,3,1,3.0,4
19926421,Old Alleynians AFC III,Old Eastbournians,4,3,4.0,7
20271428,Old Brentwoods II,Old Merchant Taylors II,2,1,4.0,3
19467229,Lancing Old Boys,Lancing College 1st XI,3,2,4.0,5
19467230,Lancing Old Boys II,Lancing College 2nd XI,2,2,5.0,4
20149125,Old Wykehamists,New College Old Boys,8,1,0.0,9
19702935,Old Bradfieldians,Old Alleynians AFC,2,3,4.0,5
20139305,Lancing Old Boys Vets,Old Cholmeleians Vets,2,2,5.0,4
19516918,Old Wellingtonians Vets,Old Haileyburians Vets,1,7,0.0,8
20139263,Old Salopians Vets,Old Harrovians Vets,2,3,4.0,5
20240974,Old Wellingtonians Vets,Old Haileyburians Vets,7,1,0.0,8
20240976,Lancing Old Boys Vets,Old Cholmeleians Vets,2,2,5.0,4
20240980,Old Salopians Vets,Old Harrovians Vets,3,2,4.0,5
19685998,Old Chigwellians Vets,Old Ignatians,7,1,0.0,8
19685999,Enfield Old Grammarians,Old Foresters Vets,1,8,0.0,9
19702944,KCS Old Boys,Old Foresters,2,0,2.0,2
19702927,Old Salopians,Old Harrovians,1,1,4.0,2
19702934,Old Alleynians AFC,Old Tonbridgians,2,2,5.0,4
19702931,Old Etonians,Old Carthusians,1,3,3.0,4
19702920,Old Bradfieldians,Old Chigwellians,7,2,0.0,9
19836200,Old Marlburians,Old Brentwoods,1,6,0.0,7
19836252,Old Radleians,Old Reptonians,1,3,3.0,4
19836269,Old Westminsters,Old Cholmeleians,1,1,4.0,2
19750569,Old Rugbeians,Old Aldenhamians,4,0,1.0,4
19750562,Old Merchant Taylors,Old Foresters II,3,1,3.0,4
19929973,Old Tonbridgians II,Old Suttonians SV,1,4,2.0,5
19929980,Old Johnians FC,Kings College Wimbledon II,2,1,4.0,3
19571044,Old Wykehamists,Old Sennockians,2,1,4.0,3
19571033,Old Kimboltonians,Old Malvernians,3,1,3.0,4
20271412,Old Stoics,Old Alleynians AFC III,0,2,2.0,2
20271421,Old Berkhamstedians II,Old Brentwoods III,4,2,3.0,6
20271425,Old Kingstonians KGS,Old Shirburnians,2,2,5.0,4
20270737,Old Albanians SA,Old Westminsters II,2,2,5.0,4
20270794,Old Alleynians AFC II,Old Amplefordians,4,1,2.0,5
20270792,Old Bancroftians AFC,Old Harrovians III,1,3,3.0,4
20270747,Old Eastbournians,Old King's Scholars,3,2,4.0,5
20270791,Old Haberdashers,Old Salopians II,2,5,2.0,7
20175880,Old Carthusians II,West Wickham,3,0,2.0,3
19685905,Old Blues,Old Etonians II,0,7,0.0,7
20270400,Lancing Old Boys II,Lancing Old Boys,0,0,4.0,0
19750487,Old Citizens,Old Chigwellians II,0,3,2.0,3
20197614,Old Chigwellians Vets,Hale End Athletic,4,2,3.0,6
19702948,Old Foresters,Old Tonbridgians,0,5,0.0,5
19836267,Lancing Old Boys,Old Brentwoods,2,11,1.0,13
19836268,Old Cholmeleians,Old Radleians,3,1,3.0,4
19836198,Old Berkhamstedians,Old Reptonians,2,0,2.0,2
19750550,Old Chigwellians II,Old Harrovians II,0,6,0.0,6
19750530,Old Foresters II,Old Merchant Taylors,1,3,3.0,4
19929988,Old Columbans,Lancing Old Boys II,2,1,4.0,3
19929971,Old Tonbridgians II,Old Epsomians,2,2,5.0,4
19890765,Old Alleynians AFC II,Old Harrovians III,0,2,2.0,2
19890786,Old Salopians II,Old Kimboltonians,0,3,2.0,3
19926410,Old Kingstonians KGS,Old Wykehamists II,3,1,3.0,4
19926394,Old Berkhamstedians II,Old Eastbournians,3,5,4.0,8
19571043,Old Aldenhamians,KCS Old Boys,0,10,0.0,10
20149126,Old Malvernians,IB Albion,1,8,0.0,9
20240915,Bealonians,Old King's Scholars,2,1,4.0,3
20090201,South Bank Cuaco,Old Cholmeleians II,2,4,3.0,6
20198416,Old Brentwoods II,Old Minchendenians,4,2,3.0,6
19702923,Old Carthusians,Old Salopians,5,2,2.0,7
19702962,Old Etonians,Old Bradfieldians,1,2,4.0,3
20018067,Old Wykehamists Vets,KCS Old Boys Vets,6,4,4.0,10
20155295,Old Finchleians,Old Brentwoods Vets,5,0,0.0,5
19702899,Old Chigwellians,Old Etonians,1,4,2.0,5
19702945,Old Alleynians AFC,Old Harrovians,5,5,6.0,10
19702916,KCS Old Boys,Old Tonbridgians,2,2,5.0,4
19836257,Old Radleians,Old Marlburians,1,2,4.0,3
19750532,Old Chigwellians II,Old Foresters II,4,0,1.0,4
19750502,Old Merchant Taylors,Old Harrovians II,2,4,3.0,6
19750539,Old Aldenhamians,Old Carthusians II,1,4,2.0,5
19929987,Old Carthusians III,Lancing Old Boys II,5,1,2.0,6
19929969,Kings College Wimbledon II,Old Suttonians SV,2,3,4.0,5
19930014,Old Epsomians,Old Wellingtonians,2,2,5.0,4
19890791,Old Brentwoods II,Old Alleynians AFC II,1,4,2.0,5
19890775,Old Salopians II,Old King's Scholars,2,4,3.0,6
19890752,Old Harrovians III,Old Stoics,1,3,3.0,4
19908616,Old Brentwoods III,Old Albanians SA,3,2,4.0,5
19908614,Old Cholmeleians II,Old Haberdashers,2,2,5.0,4
19926399,Old Eastbournians,Old Wykehamists II,2,2,5.0,4
19926407,Old Berkhamstedians II,Old Westminsters II,3,2,4.0,5
19571034,Old Bancroftians AFC,Old Rugbeians,1,5,2.0,6
19571045,Old Shirburnians,Old Bradfieldians,0,4,1.0,4
19571038,Old Kingstonians KGS,Old Carthusians,0,9,0.0,9
19571037,Lancing Old Boys,Old Salopians,1,7,0.0,8
19571032,Old Brentwoods,Old Columbans,0,1,3.0,1
19977638,Wake Green Amateur,Old Foresters,0,7,0.0,7
20175986,Southgate County,Old Reptonians,3,6,3.0,9
20149124,Old Cholmeleians,Globe Rangers,1,0,3.0,1
19750551,Old Citizens,Old Etonians II,2,3,4.0,5
20176044,Glyn Old Boys,Old Sennockians,2,0,2.0,2
19685996,Old Owens,Old Foresters Vets,1,6,0.0,7
19702952,Old Harrovians,Old Carthusians,1,3,3.0,4
19702885,Old Bradfieldians,Old Salopians,2,0,2.0,2
19836204,Old Westminsters,Old Wykehamists,2,5,2.0,7
19836242,Old Malvernians,Old Brentwoods,2,4,3.0,6
19750527,Old Rugbeians,Old Carthusians II,1,4,2.0,5
19930020,Lancing Old Boys II,Old Epsomians,2,3,4.0,5
19929977,Old Carthusians III,Old Johnians FC,1,7,0.0,8
19929990,Old Suttonians SV,Old Tonbridgians II,3,1,3.0,4
19890784,Old Bancroftians AFC,Old Brentwoods II,1,2,4.0,3
19890756,Old Salopians II,Old Shirburnians,0,1,3.0,1
19926395,Old Westminsters II,Old Wykehamists II,5,2,2.0,7
19926418,Old Kingstonians KGS,Old Alleynians AFC III,2,6,2.0,8
19571031,Old Tonbridgians,Old Berkhamstedians,2,0,2.0,2
19571036,Old Marlburians,Old Foresters,1,2,4.0,3
19571040,Old Radleians,Old Amplefordians,5,4,5.0,9
19571046,Old Eastbournians,Old Reptonians,0,8,0.0,8
19571039,Old Merchant Taylors,Old Alleynians AFC,1,4,2.0,5
19836020,Old Cholmeleians,Old Tollingtonians,3,1,3.0,4
19836021,Lancing Old Boys,Old Woodhouseians,0,5,0.0,5
19836019,New College Old Boys,Old Chigwellians,3,3,5.0,6
19685904,Old Foresters II,Old Finchleians,5,6,5.0,11
19685903,Old Minchendenians,Old Harrovians II,4,3,4.0,7
19685978,Old Lyonians,Old King's Scholars,4,3,4.0,7
20194991,Old Columbans,Mill Hill Village,4,3,4.0,7
20179671,KCS Old Boys,IB Albion,3,5,4.0,8
20195923,Rapid Chingford,Kings College Wimbledon II,5,1,2.0,6
19702898,Old Tonbridgians,Old Bradfieldians,2,2,5.0,4
19702917,KCS Old Boys,Old Carthusians,2,1,4.0,3
19836232,Old Radleians,Old Cholmeleians,2,2,5.0,4
19836258,Old Wykehamists,Old Reptonians,1,2,4.0,3
19836213,Old Berkhamstedians,Old Marlburians,0,6,0.0,6
19750565,Old Merchant Taylors,Old Carthusians II,1,2,4.0,3
19750571,Old Chigwellians II,Old Sennockians,1,2,4.0,3
19750488,Old Harrovians II,Old Etonians II,2,1,4.0,3
19930010,Lancing Old Boys II,Old Suttonians SV,1,1,4.0,2
19930006,Old Carthusians III,Kings College Wimbledon II,2,1,4.0,3
19930018,Old Epsomians,Old Columbans,1,5,2.0,6
19890771,Old Bancroftians AFC,Old Kimboltonians,1,5,2.0,6
19890734,Old Harrovians III,Old Alleynians AFC II,2,10,0.0,12
19890740,Old Salopians II,Old Stoics,0,7,0.0,7
19908643,Old Brentwoods III,Old Cholmeleians II,2,9,0.0,11
19926414,Old Kingstonians KGS,Old Amplefordians,3,5,4.0,8
19571041,Old Chigwellians,Old Westminsters,2,4,3.0,6
19571035,Old Harrovians,Old Etonians,3,0,2.0,3
19835282,Old Salopians,Alleyn Old Boys,1,3,3.0,4
20114559,Sinjun Grammarians,Old Rugbeians,0,3,2.0,3
20189275,Old Blues,Lancing Old Boys,1,1,4.0,2
19892303,Old Foresters,Gas Recreation FC,1,3,3.0,4
19685997,Old Haileyburians Vets,Old Brentwoods Vets,5,0,0.0,5
19702894,Old Tonbridgians,Old Alleynians AFC,0,2,2.0,2
19702895,KCS Old Boys,Old Bradfieldians,5,1,2.0,6
19702954,Old Foresters,Old Carthusians,0,2,2.0,2
19702896,Old Harrovians,Old Chigwellians,5,1,2.0,6
19836202,Lancing Old Boys,Old Westminsters,7,6,5.0,13
19836194,Old Cholmeleians,Old Wykehamists,1,1,4.0,2
19836251,Old Malvernians,Old Marlburians,1,1,4.0,2
19750563,Old Rugbeians,Old Harrovians II,1,3,3.0,4
19750493,Old Merchant Taylors,Old Chigwellians II,0,2,2.0,2
19750501,Old Foresters II,Old Etonians II,3,5,4.0,8
19929961,Kings College Wimbledon II,Lancing Old Boys II,2,0,2.0,2
19929962,Old Epsomians,Old Suttonians SV,1,6,0.0,7
19929963,Old Johnians FC,Old Tonbridgians II,0,3,2.0,3
19929964,Old Carthusians III,Old Wellingtonians,2,4,3.0,6
19890783,Old Brentwoods II,Old King's Scholars,4,1,2.0,5
19890769,Old Stoics,Old Kimboltonians,2,4,3.0,6
19890753,Old Shirburnians,Old Bancroftians AFC,2,0,2.0,2
19908635,Old Haberdashers,Old Brentwoods III,8,2,0.0,10
19908650,Old Albanians SA,Old Cholmeleians II,4,5,5.0,9
19926431,Old Westminsters II,Old Berkhamstedians II,3,1,3.0,4
19926417,Old Alleynians AFC III,Old Wykehamists II,5,0,0.0,5
19926415,Old Kingstonians KGS,Old Eastbournians,1,3,3.0,4
20100477,Old Citizens,Blackheath Wanderers (Youth) First Team,2,3,4.0,5
19836177,Old Carthusians II,Reigatians,4,1,2.0,5
20109553,Old Reptonians,Old Aldenhamians,5,0,0.0,5
19685751,Old Etonians,Old Brentwoods,4,3,4.0,7
20018606,Old Sennockians,Old Wilsonians,5,0,0.0,5
20019670,Old Aldenhamians II,Albanian FC,5,2,2.0,7
20018063,Old Carthusians Vets,KCS Old Boys Vets,3,5,4.0,8
19516916,KCS Old Boys Vets,Old Carthusians Vets,5,3,4.0,8
19516915,Old Reptonians Vets,Old Harrovians Vets,3,6,3.0,9
19516914,Old Cholmeleians Vets,Old Westminsters Vets,4,2,3.0,6
19702909,Old Alleynians AFC,Old Carthusians,1,4,2.0,5
19702892,Old Foresters,Old Harrovians,2,3,4.0,5
19702893,Old Chigwellians,Old Salopians,2,3,4.0,5
19702938,Old Etonians,KCS Old Boys,0,0,4.0,0
19836205,Old Westminsters,Old Brentwoods,4,1,2.0,5
19836182,Old Reptonians,Old Marlburians,2,4,3.0,6
19836239,Old Berkhamstedians,Lancing Old Boys,0,2,2.0,2
19750534,Old Merchant Taylors,Old Rugbeians,2,3,4.0,5
19750496,Old Harrovians II,Old Aldenhamians,3,1,3.0,4
19750498,Old Carthusians II,Old Etonians II,2,1,4.0,3
19750506,Old Sennockians,Old Chigwellians II,2,1,4.0,3
19929981,Old Wellingtonians,Old Suttonians SV,2,3,4.0,5
19929960,Old Epsomians,Old Carthusians III,2,0,2.0,2
19929966,Kings College Wimbledon II,Old Tonbridgians II,0,5,0.0,5
19890748,Old Salopians II,Old Alleynians AFC II,3,8,0.0,11
19890773,Old Brentwoods II,Old Harrovians III,3,1,3.0,4
19890739,Old Kimboltonians,Old Shirburnians,3,2,4.0,5
19908628,Old Merchant Taylors II,Old Cholmeleians II,2,7,0.0,9
19926419,Old Eastbournians,Old Amplefordians,2,2,5.0,4
19926411,Old Alleynians AFC III,Old Westminsters II,3,2,4.0,5
19852906,Old Malvernians,Spaniards,3,3,5.0,6
19871158,London Welsh F.C.,Old Wykehamists,1,3,3.0,4
19908652,Old Albanians SA,Old Chigwellians III,3,1,3.0,4
20019666,Old Columbans,Somerville Old Boys,3,2,4.0,5
19702891,Old Etonians,Old Foresters,2,0,2.0,2
19702890,Old Harrovians,Old Alleynians AFC,0,7,0.0,7
19702903,Old Bradfieldians,Old Tonbridgians,1,4,2.0,5
19836234,Old Reptonians,Old Brentwoods,0,8,0.0,8
19836187,Old Malvernians,Old Cholmeleians,1,2,4.0,3
19836188,Old Berkhamstedians,Old Wykehamists,0,3,2.0,3
19836244,Lancing Old Boys,Old Marlburians,1,1,4.0,2
19750490,Old Harrovians II,Old Foresters II,6,3,3.0,9
19750564,Old Aldenhamians,Old Sennockians,3,3,5.0,6
19929958,Old Suttonians SV,Lancing Old Boys II,5,1,2.0,6
19930012,Old Columbans,Old Johnians FC,2,7,0.0,9
19930015,Old Tonbridgians II,Old Wellingtonians,4,1,2.0,5
19890758,Old Harrovians III,Old Bancroftians AFC,2,0,2.0,2
19890747,Old Kimboltonians,Old King's Scholars,5,2,2.0,7
19890757,Old Alleynians AFC II,Old Stoics,5,3,4.0,8
19908610,Old Albanians SA,Old Merchant Taylors II,4,2,3.0,6
19926429,Old Alleynians AFC III,Old Berkhamstedians II,5,2,2.0,7
19926406,Old Amplefordians,Old Wykehamists II,3,2,4.0,5
19926409,Old Westminsters II,Old Eastbournians,2,2,5.0,4
19494153,Old Carthusians,Charterhouse School 1st XI,5,0,0.0,5
19494155,Old Carthusians III,Charterhouse School 1st XI,3,1,3.0,4
19494154,Old Carthusians II,Charterhouse School 2nd XI,0,0,4.0,0
19493580,Old Chigwellians,Chigwell School 1st XI,3,0,2.0,3
19493581,Old Chigwellians II,Chigwell School 2nd XI,0,0,4.0,0
19493582,Old Chigwellians III,Chigwell School 3rd XI,0,0,4.0,0
19657706,Old Salopians,Shrewsbury School 1st XI,2,1,4.0,3
19657707,Old Salopians II,Shrewsbury School 2nd XI,4,1,2.0,5
19843671,Old Rugbeians,Old Dorkinians,5,3,4.0,8
19685876,Old Merchant Taylors,Old Etonians II,1,4,2.0,5
19835953,Wood Green Old Boys,Old Brentwoods II,1,7,0.0,8
20080998,West Fulham,KCS Old Boys,2,4,3.0,6
19702925,Old Foresters,Old Alleynians AFC,3,3,5.0,6
19702915,Old Bradfieldians,Old Harrovians,3,4,4.0,7
19702933,KCS Old Boys,Old Salopians,3,1,3.0,4
19702889,Old Carthusians,Old Tonbridgians,2,0,2.0,2
19702888,Old Etonians,Old Chigwellians,5,2,2.0,7
19836259,Old Radleians,Old Berkhamstedians,3,3,5.0,6
19836185,Old Cholmeleians,Lancing Old Boys,2,3,4.0,5
19836186,Old Westminsters,Old Marlburians,3,4,4.0,7
19750561,Old Etonians II,Old Chigwellians II,0,3,2.0,3
19750503,Old Carthusians II,Old Aldenhamians,2,3,4.0,5
19929992,Old Tonbridgians II,Old Carthusians III,3,0,2.0,3
19929989,Kings College Wimbledon II,Old Epsomians,2,3,4.0,5
19930022,Old Columbans,Old Wellingtonians,3,2,4.0,5
19890746,Old Salopians II,Old Harrovians III,1,1,4.0,2
19908602,Old Merchant Taylors II,Old Albanians SA,0,3,2.0,3
19926423,Old Berkhamstedians II,Old Amplefordians,2,0,2.0,2
19926432,Old Alleynians AFC III,Old Kingstonians KGS,4,1,2.0,5
19926416,Old Eastbournians,Old Westminsters II,0,4,1.0,4
19527717,Old Brentwoods,Brentwood School 1st XI,6,2,2.0,8
19527718,Old Brentwoods II,Brentwood School 2nd XI,1,4,2.0,5
19527719,Old Brentwoods III,Brentwood School 3rd XI,1,6,0.0,7
19527952,Old Brentwoods Vets,Brentwood School 4th XI,0,0,4.0,0
19465643,Old Kimboltonians,Kimbolton School 1st XI,1,1,4.0,2
19835276,Old Suttonians,Old Foresters II,5,0,0.0,5
19835954,Southgate County,Old Cholmeleians II,1,2,4.0,3
19702966,Old Salopians,Old Bradfieldians,4,6,4.0,10
19702884,Old Carthusians,Old Etonians,1,1,4.0,2
19702918,Old Alleynians AFC,Old Chigwellians,4,1,2.0,5
19836266,Old Malvernians,Old Berkhamstedians,0,4,1.0,4
19836250,Old Cholmeleians,Old Brentwoods,2,0,2.0,2
19836184,Lancing Old Boys,Old Radleians,3,2,4.0,5
19750484,Old Chigwellians II,Old Rugbeians,2,1,4.0,3
19750531,Old Aldenhamians,Old Etonians II,1,5,2.0,6
19750485,Old Carthusians II,Old Sennockians,2,1,4.0,3
19930007,Old Suttonians SV,Old Columbans,3,1,3.0,4
19930009,Old Johnians FC,Old Carthusians III,6,3,3.0,9
19929954,Old Wellingtonians,Old Tonbridgians II,2,2,5.0,4
19929953,Old Epsomians,Kings College Wimbledon II,1,1,4.0,2
19890732,Old Salopians II,Old Brentwoods II,1,2,4.0,3
19890731,Old Shirburnians,Old Alleynians AFC II,0,9,0.0,9
19890723,Old Kimboltonians,Old Bancroftians AFC,5,2,2.0,7
19890787,Old King's Scholars,Old Stoics,2,3,4.0,5
19908633,Old Merchant Taylors II,Old Haberdashers,1,5,2.0,6
19926428,Old Alleynians AFC III,Old Amplefordians,1,4,2.0,5
19493595,Old Harrovians,Harrow School 1st XI,0,0,4.0,0
19493596,Old Harrovians II,Harrow School 2nd XI,0,0,4.0,0
19493597,Old Harrovians III,Harrow School 3rd XI,0,0,4.0,0
19977735,Old Kingstonians KGS,Kingston Grammar School 1st XI,3,5,4.0,8
19465664,Old Marlburians,Marlborough College 1st XI,7,3,2.0,10
19908646,Old Cholmeleians II,Old Chigwellians III,3,0,2.0,3
19628666,Old Wykehamists,Old Berkhamstedians,4,2,3.0,6
19654754,Old Etonians,Eton College 1st XI,3,1,3.0,4
19654755,Old Etonians II,Eton College 2nd XI,0,0,4.0,0
19516394,Old Foresters,Forest School 1st XI,4,0,1.0,4
19465668,Old Cholmeleians,Highgate School 1st XI,0,0,4.0,0
19465667,Old Reptonians,Repton School 1st XI,0,0,4.0,0
19541041,Old Whitgiftians,Old Epsomians,0,0,4.0,0
19795577,Old Harrovians II,Old Merchant Taylors,1,2,4.0,3
19942080,Old Rugbeians,Old Suttonians SV,2,4,3.0,6
19835052,Old Brentwoods II,Old Brentwoods,0,1,3.0,1
19988208,Old Albanians SA,Old Aldenhamians,4,4,6.0,8
19510834,Old Parkonians,Old Carthusians,4,2,3.0,6
19631430,Old Amplefordians,Old King's Scholars,2,4,3.0,6
19585167,St Lawrence,Old Sennockians,2,1,4.0,3
19520373,Old Malvernians,Old Reptonians,1,4,2.0,5
19538134,Old Marlburians,Old Alleynians AFC,1,3,3.0,4
19720101,Old Carthusians,Nottsborough FC,6,3,3.0,9
19668988,Old Kingstonians KGS,Lancing Old Boys,0,3,2.0,3
19799263,Old Tonbridgians,Old Harrovians,2,3,4.0,5
19856315,Old Berkhamstedians,Old Suttonians SV,4,0,1.0,4
19786697,Old Berkhamstedians II,Old Westminsters II,6,2,2.0,8
19710413,Old Shirburnians,Old King's Scholars,1,1,4.0,2
19835513,Old Etonians,Old Malvernians,4,2,3.0,6
19538119,Old Harrovians,Old Alleynians AFC,2,3,4.0,5
19538125,Old Rugbeians,Old Alleynians AFC II,0,1,3.0,1
19585166,Old Harrovians II,Old Sennockians,3,2,4.0,5
19737980,Old Reptonians,Old Westminsters,4,1,2.0,5
19668987,Corinthian-Casuals,Lancing Old Boys,1,4,2.0,5
19744940,Old Foresters,Old Brentwoods,4,5,5.0,9
19705488,Old Hamptonians,Old Carthusians,2,2,5.0,4
19628665,Lancing Old Boys,Old Wykehamists,1,4,2.0,5
19538115,Old Alleynians AFC II,Old Tonbridgians II,1,1,4.0,2
19753384,Old Carthusians III,Old Carthusians II,1,3,3.0,4
19538114,Old Alleynians AFC,Old Tonbridgians,3,1,3.0,4
19538110,Old Malvernians,Old Alleynians AFC,1,4,2.0,5
19629479,Old Carthusians III,Old Rugbeians,4,1,2.0,5
19538109,Old Hamptonians,Old Alleynians AFC,2,1,4.0,3
19523240,Vauxhall Invitational XI,Old Reptonians,1,3,3.0,4
20312078,Old Aldenhamians Vets,Old Wellingtonians Vets,0,1,3.0,1
21754725,Old Kimboltonians,Kimbolton School 1st XI,5,0,0.0,5
21770948,Old Salopians,Shrewsbury School 1st XI,0,1,3.0,1
21762661,Jersey Royals,Old Rugbeians,0,4,1.0,4
21833221,Old Haberdashers,Haberdashers Aske School 1st XI,2,0,2.0,2
21771050,Old Brentwoods,Brentwood School 1st XI,2,0,2.0,2
21771052,Old Brentwoods III,Brentwood School 3rd XI,8,2,0.0,10
21770842,Old Foresters,Forest School 1st XI,7,0,0.0,7
21809896,Old Johnians,Kings College Wimbledon II,3,1,3.0,4
21762666,Old Alleynians,Old Reptonians,7,1,0.0,8
21755810,KCS Old Boys,Old Reptonians,8,1,0.0,9
21805099,Yorxeter FC,Old Alleynians,1,2,4.0,3
21803838,Actonians Association,Old Etonians,1,0,3.0,1
21766754,Old Ardinians,Old Etonians,1,5,2.0,6
21734201,Old Haberdashers,Old Westminsters II,1,0,3.0,1
21747760,Old Barryians,Old Merchant Taylors' II,2,2,5.0,4
21728449,Old Brentwoods Vets,Old Chigwellians Vets,1,3,3.0,4
21728392,Old Westminsters Vets,Old Foresters Vets,1,4,2.0,5
21734237,Old Foresters,Old Salopians,4,2,3.0,6
21727383,Kings College Wimbledon II,Old Ardinians,1,2,4.0,3
21727101,Old Albanians SA,Old Cholmeleians II,2,0,2.0,2
21727221,KCS Old Boys,Old Salopians,2,3,4.0,5
21727552,Old Foresters,Old Alleynians,3,0,2.0,3
21731849,Old Berkhamstedians,Old Cholmeleians,3,2,4.0,5
21727288,Old Epsomians,Old Aldenhamians,2,1,4.0,3
21725124,Old King's Scholars,Old Westminsters II,1,5,2.0,6
21724203,Winchmore Hill,Old Carthusians,0,3,2.0,3
21707604,KCS Old Boys Vets,Old Brentwoods Vets,1,3,3.0,4
21698893,Old Chigwellians Vets,Old Harrovians Vets,4,1,2.0,5
21695239,Old Carthusians Vets,Old Foresters Vets,3,4,4.0,7
21674719,Old Foresters,Old Reptonians,2,1,4.0,3
21674327,Old Tonbridgians,KCS Old Boys,2,3,4.0,5
21710124,Old Rugbeians,Old Salopians,1,1,4.0,2
21710032,Old Berkhamstedians,Old Radleians,2,0,2.0,2
21706369,Old Ardinians,Old Kimboltonians,5,1,2.0,6
21706312,Old Albanians SA,Old Stoics,2,1,4.0,3
21703815,Old Merchant Taylors,Old Aldenhamians,0,0,4.0,0
21703813,Old Epsomians,Old Columbans,7,1,0.0,8
21445857,Lancing Old Boys Vets,Old Brentwoods Vets,1,3,3.0,4
21686362,Old Etonians Vets,KCS Old Boys Vets,0,1,3.0,1
21675046,Old Kimboltonians,Old Salopians,2,3,4.0,5
21684714,Old Wykehamists,Old Alleynians,3,5,4.0,8
21673262,Old Brentwoods,Old Westminsters,2,2,5.0,4
21696607,Old Alleynians II,Old Ardinians,2,4,3.0,6
21696315,Kings College Wimbledon II,Old Chigwellians II,4,1,2.0,5
21696355,Old Albanians SA,Old Wellingtonians,3,2,4.0,5
21696416,Old Brentwoods III,Old Cholmeleians II,1,2,4.0,3
21703694,Old Aldenhamians,Old Merchant Taylors,6,1,0.0,7
21703693,Old Columbans,Old Epsomians,3,0,2.0,3
21699795,Old Haberdashers,Old Amplefordians,6,0,0.0,6
21698964,Old Westminsters II,Old Merchant Taylors' II,2,1,4.0,3
21699802,KCS Old Boys,Old Reptonians,2,2,5.0,4
21438422,Old Cholmeleians Vets,Old Chigwellians Vets,0,4,1.0,4
21687868,Old Chigwellians,Old Cholmeleians,0,2,2.0,2
21687858,Old Radleians,Old Kimboltonians,1,2,4.0,3
21667574,Old Ardinians,Old Epsomians,0,0,4.0,0
21687857,Old Aldenhamians,Old Chigwellians II,2,3,4.0,5
21689061,Old Brentwoods III,Old Shirburnians,3,1,3.0,4
21689112,Old Ardinians,Old Wellingtonians,0,3,2.0,3
21684904,Old Kingstonians KGS,Old Cholmeleians II,1,6,0.0,7
21687878,Old Alleynians AFC III,Old Stoics,1,3,3.0,4
21675100,Old Carthusians,West Wickham,3,3,5.0,6
21679793,KCS Old Boys,Old Alleynians,3,1,3.0,4
21256212,Old Foresters Vets,KCS Old Boys Vets,1,4,2.0,5
21437616,Old Haileyburians Vets,Old Etonians Vets,0,6,0.0,6
21437596,Old Salopians Vets,Old Harrovians Vets,0,9,0.0,9
21406911,Old Wykehamists,Old Cholmeleians,2,2,5.0,4
21679851,Old Rugbeians,Old Alleynians,1,8,0.0,9
21681939,Old Chigwellians II,Old Chigwellians,3,3,5.0,6
21667573,Old Sennockians,Old Kimboltonians,1,3,3.0,4
21674232,Old Etonians II,Old Radleians,3,4,4.0,7
21674308,Old Columbans,Old Aldenhamians,4,4,6.0,8
21675328,Kings College Wimbledon II,Old Harrovians II,5,3,4.0,8
21671794,Old Wellingtonians,Old Wykehamists II,1,0,3.0,1
21672549,Old Brentwoods III,Old Amplefordians,8,0,0.0,8
21668178,Old King's Scholars,Old Albanians SA,0,2,2.0,2
21674371,Old Haberdashers,Old Cholmeleians II,1,1,4.0,2
21680825,Old Kingstonians KGS,Old Reptonians,0,3,2.0,3
21678830,Old Carthusians,Nottsborough FC,1,1,4.0,2
21256057,Old Chigwellians Vets,Old Tonbridgians Vets,2,1,4.0,3
21406910,Old Salopians,Old Etonians,1,0,3.0,1
21406912,Lancing Old Boys,Old Foresters,1,5,2.0,6
21436680,Old Malvernians,Old Kimboltonians,3,5,4.0,8
21406907,Old Tonbridgians,Old Sennockians,6,0,0.0,6
21667576,Old Alleynians II,Old Carthusians II,3,3,5.0,6
21667572,Old Suttonians SV,Old Harrovians II,1,5,2.0,6
21667571,Old Tonbridgians II,Old Aldenhamians,1,5,2.0,6
21667569,Old Carthusians III,Old Chigwellians II,0,2,2.0,2
21667570,Old Radleians,Old Merchant Taylors,5,1,2.0,6
21668155,Old Haberdashers,Old Brentwoods IV,5,1,2.0,6
21668156,Old Westminsters II,Old Kingstonians KGS,2,3,4.0,5
21668175,Old Eastbournians,Old Alleynians AFC III,2,3,4.0,5
21671804,Lancing Old Boys II,Old Ardinians,3,5,4.0,8
21668176,Old Shirburnians,Old Merchant Taylors' II,3,1,3.0,4
21669403,Old Harrovians III,Old Stoics,0,2,2.0,2
21668837,Old Cholmeleians II,Old Albanians SA,2,1,4.0,3
21661353,Alleyn Old Boys,Old Carthusians,0,1,3.0,1
21668349,Brymans Park FC,Old Brentwoods III,2,3,4.0,5
21642349,Old Alleynians,Old Reptonians,3,4,4.0,7
21578354,Old Wykehamists Veterans,Old Westminsters Vets,1,2,4.0,3
21663350,Old Salvatorians,Old Brentwoods Vets,3,2,4.0,5
21578671,Old Carthusians,Old Ardinians,3,3,5.0,6
21593993,Old Reptonians,Old Kimboltonians,1,1,4.0,2
21604063,Old Tonbridgians,Old Alleynians,3,3,5.0,6
21618999,Old Wykehamists,Old Etonians,1,3,3.0,4
21624510,Old Marlburians,Old Malvernians,6,2,2.0,8
21578339,Old Bradfieldians,Old Salopians,0,0,4.0,0
21604062,Old Alleynians II,Old Tonbridgians II,10,0,0.0,10
21660216,Old Ardinians,Old Wykehamists II,3,4,4.0,7
21661033,Old Albanians SA,Old Aldenhamians,0,0,4.0,0
21572653,Old Foresters,Old Chigwellians,1,2,4.0,3
21529887,Old Etonians,Old Alleynians,5,2,2.0,7
21617052,Old Reptonians,Old Chigwellians,1,4,2.0,5
21525058,Old Ardinians,Old Salopians,4,0,1.0,4
21578891,Old Ardinians,Old Salopians II,0,0,4.0,0
21579330,Old Alleynians II,Kings College Wimbledon II,1,3,3.0,4
21572648,Old Foresters,Old Brentwoods,7,0,0.0,7
21578992,Old Carthusians,Bank of England,3,0,2.0,3
21604073,Old Etonians II,Old Alleynians II,3,2,4.0,5
21590466,Old Kimboltonians,Old Alleynians,3,0,2.0,3
21401154,Lancing Old Boys Vets,Old Westminsters Vets,12,13,6.0,25
21400621,Old Haileyburians Vets,Old Wykehamists Veterans,1,2,4.0,3
21371288,Old Westminsters,Old Salopians,2,4,3.0,6
21379374,Old Carthusians III,Old Epsomians,1,3,3.0,4
21393888,Old Kingstonians KGS,Old Eastbournians,4,2,3.0,6
21406906,Old Bradfieldians,Old Reptonians,1,3,3.0,4
21256060,Lancing Old Boys Vets,Old Westminsters Vets,3,0,2.0,3
21367055,Old Alleynians,Old Bradfieldians,5,4,5.0,9
21371153,Old Wykehamists,Old Carthusians,2,6,2.0,8
21371179,Old Brentwoods,Old Harrovians,4,4,6.0,8
21371167,KCS Old Boys,Old Etonians,1,1,4.0,2
21371208,Old Westminsters,Old Rugbeians,3,1,3.0,4
21371165,Old Reptonians,Old Berkhamstedians,7,1,0.0,8
21371246,Old Salopians,Lancing Old Boys,3,1,3.0,4
21371143,Old Marlburians,Old Chigwellians,4,4,6.0,8
21371352,Old Etonians II,Old Carthusians II,2,0,2.0,2
21393050,Old Stoics,Old Harrovians III,2,3,4.0,5
21367895,Old Wellingtonians,Old Cholmeleians II,3,6,3.0,9
21386277,Old Bancroftians,Old Haberdashers,0,7,0.0,7
21393877,Old Berkhamstedians II,Old Kingstonians KGS,2,0,2.0,2
21393878,Old Wykehamists II,Old Salopians II,1,2,4.0,3
21256034,Old Haileyburians Vets,Old Wykehamists Veterans,2,1,4.0,3
21256037,Old Bradfieldians Vets,Old Salopians Vets,3,4,4.0,7
21243539,Old Foresters Vets,Old Malvernians Vets,5,5,6.0,10
21371315,Old Brentwoods,Old Alleynians,3,0,2.0,3
21371320,Old Carthusians,Old Foresters,4,1,2.0,5
21371364,Old Alleynians,Old Brentwoods,1,2,4.0,3
21371373,Old Etonians,Old Wykehamists,2,0,2.0,2
21371158,Old Bradfieldians,Old Harrovians,6,1,0.0,7
21371287,Old Malvernians,Old Rugbeians,1,3,3.0,4
21371155,Old Berkhamstedians,Old Cholmeleians,2,1,4.0,3
21371169,Old Westminsters,Lancing Old Boys,4,3,4.0,7
21367058,Old Reptonians,Old Marlburians,1,5,2.0,6
21371385,Old Chigwellians,Old Salopians,1,2,4.0,3
21367066,Old Chigwellians II,Old Johnians,2,4,3.0,6
21367068,Old Radleians,Old Etonians II,2,5,2.0,7
21379375,Old Brentwoods II,Old Alleynians II,0,2,2.0,2
21379371,Old Alleynians II,Old Brentwoods II,2,0,2.0,2
21379413,Old Foresters II,Old Carthusians III,1,7,0.0,8
21379407,Kings College Wimbledon II,Old Suttonians SV,2,0,2.0,2
21379372,Old Suttonians SV,Kings College Wimbledon II,1,1,4.0,2
21393927,Old Ardinians,Old Westminsters II,2,3,4.0,5
21393884,Old Westminsters II,Old Ardinians,0,2,2.0,2
21406905,Old Kimboltonians,Old Aldenhamians,2,1,4.0,3
21434552,Inter London,Old Haberdashers,4,9,1.0,13
21312329,Old Carthusians Vets,Lancing Old Boys Vets,2,3,4.0,5
21256058,Old Brentwoods Vets,Old Reptonians Vets,3,1,3.0,4
21401152,Old Brentwoods Vets,Old Reptonians Vets,1,3,3.0,4
21336875,Old Wykehamists,Old Bradfieldians,5,4,5.0,9
21336874,Old Tonbridgians,Old Etonians,2,4,3.0,6
21336877,Old Rugbeians,Lancing Old Boys,2,0,2.0,2
21336878,Old Reptonians,Old Cholmeleians,2,1,4.0,3
21336876,Old Westminsters,Old Marlburians,3,3,5.0,6
21336882,Old Merchant Taylors,Old Columbans,2,6,2.0,8
21336884,Old Carthusians II,Old Harrovians II,2,0,2.0,2
21336886,Old Etonians II,Old Johnians,1,1,4.0,2
21350025,Old Suttonians SV,Old Carthusians III,3,3,5.0,6
21350024,Old Epsomians,Old Foresters II,1,1,4.0,2
21350023,Old Tonbridgians II,Old Alleynians II,0,1,3.0,1
21336893,Old King's Scholars,Old Cholmeleians II,1,4,2.0,5
21336892,Old Alleynians AFC III,Old Harrovians III,4,3,4.0,7
21336894,Lancing Old Boys II,Old Wellingtonians,0,4,1.0,4
21336891,Old Stoics,Old Shirburnians,1,3,3.0,4
21336897,Old Haberdashers,Old Brentwoods IV,9,1,0.0,10
21336896,Old Brentwoods III,Old Merchant Taylors' II,4,2,3.0,6
21336899,Old Eastbournians,Old Wykehamists II,2,8,0.0,10
21336898,Old Kingstonians KGS,Old Salopians II,5,1,2.0,6
21406797,Old Aldenhamians,Old Kimboltonians,1,1,4.0,2
21406800,Old Harrovians,Old Malvernians,0,2,2.0,2
21406803,Old Berkhamstedians,Old Sennockians,3,5,4.0,8
21406793,KCS Old Boys,Old Amplefordians,7,1,0.0,8
20904102,Old Blues,Old Ardinians,2,0,2.0,2
21308093,KCS Old Boys,Old Harrovians,1,0,3.0,1
21316391,Old Berkhamstedians,Old Rugbeians,2,2,5.0,4
21308101,Old Harrovians II,Old Johnians,0,5,0.0,5
21308098,Old Carthusians II,Old Radleians,2,2,5.0,4
21308099,Old Sennockians,Old Chigwellians II,1,1,4.0,2
21308100,Old Aldenhamians,Old Etonians II,1,3,3.0,4
21308104,Old Epsomians,Old Carthusians III,0,2,2.0,2
21308102,Old Foresters II,Old Alleynians II,2,3,4.0,5
21308103,Old Brentwoods II,Old Tonbridgians II,4,2,3.0,6
21318805,Old King's Scholars,Lancing Old Boys II,3,2,4.0,5
21308106,Old Alleynians AFC III,Old Cholmeleians II,3,2,4.0,5
21308107,Old Harrovians III,Old Shirburnians,1,3,3.0,4
21312402,Old Merchant Taylors' II,Old Albanians SA,0,4,1.0,4
21316766,Old Berkhamstedians II,Old Eastbournians,1,3,3.0,4
21406799,Lancing Old Boys,Old Kingstonians KGS,2,1,4.0,3
21406795,Old Brentwoods,Old Wykehamists,1,2,4.0,3
21406805,Old Columbans,Old Alleynians,1,4,2.0,5
21406796,Old Bancroftians,Old Foresters,0,10,0.0,10
21406808,Old Etonians,Old Merchant Taylors,7,0,0.0,7
21406807,Old Tonbridgians,Old Chigwellians,4,3,4.0,7
21406802,Old Suttonians SV,Old Westminsters,6,3,3.0,9
20904736,Old Reptonians,Brent,5,0,0.0,5
20904734,Old Cholmeleians,Old Lyonians,7,1,0.0,8
21234796,Old Ardinians,Bank of England,2,4,3.0,6
21233985,Old Carthusians,Old Bradfieldians,2,0,2.0,2
21288960,KCS Old Boys,Old Brentwoods,2,3,4.0,5
21288876,Old Harrovians,Old Wykehamists,1,9,0.0,10
21273452,Old Foresters,Old Etonians,2,1,4.0,3
21288962,Old Alleynians,Old Tonbridgians,1,1,4.0,2
21306172,Old Berkhamstedians,Old Chigwellians,2,2,5.0,4
21293735,Old Malvernians,Old Westminsters,1,3,3.0,4
21279435,Old Etonians II,Old Columbans,1,1,4.0,2
21273462,Old Carthusians II,Old Sennockians,4,0,1.0,4
21273637,Old Carthusians III,Old Foresters II,0,3,2.0,3
21273638,Old Tonbridgians II,Old Kimboltonians,0,7,0.0,7
21273573,Old Suttonians SV,Old Alleynians II,0,6,0.0,6
21288862,Old Wellingtonians,Old Alleynians AFC III,4,3,4.0,7
21288859,Lancing Old Boys II,Old Harrovians III,3,2,4.0,5
21279763,Old Brentwoods III,Old Albanians SA,3,1,3.0,4
21286452,Old Brentwoods IV,Old Merchant Taylors' II,1,6,0.0,7
21279773,Old Westminsters II,Old Wykehamists II,1,2,4.0,3
21279772,Old Amplefordians,Old Salopians II,1,0,3.0,1
21406801,Old Shirburnians,Old Salopians,0,4,1.0,4
21406794,Old Rugbeians,Old Carthusians,0,4,1.0,4
21406804,Old Bradfieldians,Old Eastbournians,10,0,0.0,10
21406798,Old Cholmeleians,Old Radleians,2,1,4.0,3
20906970,Little Heath,Old Bancroftians,2,3,4.0,5
21257264,Old Manorians,Old Cholmeleians II,2,5,2.0,7
20906971,Pembroke Old Boys,Old Haberdashers,0,7,0.0,7
20876632,Old Ardinians,Glyn Old Boys,2,4,3.0,6
20877196,Alleyn Old Boys,Old King's Scholars,5,0,0.0,5
21255384,UCC Diaspora 1st XI,Old Epsomians,2,1,4.0,3
21254207,KCS Old Boys,Old Wykehamists,0,2,2.0,2
21254208,Old Tonbridgians,Old Brentwoods,4,1,2.0,5
21254205,Old Bradfieldians,Old Foresters,1,0,3.0,1
21254206,Old Alleynians,Old Harrovians,7,0,0.0,7
21254204,Old Carthusians,Old Etonians,4,2,3.0,6
21260715,Old Malvernians,Old Chigwellians,0,6,0.0,6
21254213,Old Salopians,Old Cholmeleians,1,0,3.0,1
21260714,Old Reptonians,Old Westminsters,3,2,4.0,5
21266386,Old Harrovians II,Old Aldenhamians,2,2,5.0,4
21255698,Old Carthusians II,Old Etonians II,3,2,4.0,5
21265359,Old Columbans,Old Sennockians,1,0,3.0,1
21266387,Old Radleians,Old Merchant Taylors,3,0,2.0,3
21255694,Old Suttonians SV,Old Brentwoods II,1,5,2.0,6
21255696,Old Foresters II,Old Kimboltonians,1,4,2.0,5
21266591,Old Epsomians,Old Alleynians II,0,2,2.0,2
21255695,Kings College Wimbledon II,Old Tonbridgians II,1,2,4.0,3
21266432,Old Alleynians AFC III,Old King's Scholars,3,1,3.0,4
21266171,Old Shirburnians,Lancing Old Boys II,5,1,2.0,6
21255704,Old Stoics,Old Cholmeleians II,3,4,4.0,7
21266433,Old Harrovians III,Old Wellingtonians,0,0,4.0,0
21255708,Old Haberdashers,Old Bancroftians,1,3,3.0,4
21255707,Old Brentwoods IV,Old Brentwoods III,4,10,1.0,14
21255706,Old Albanians SA,Old Merchant Taylors' II,6,0,0.0,6
21255710,Old Eastbournians,Old Ardinians,0,7,0.0,7
21263465,Old Berkhamstedians II,Old Wykehamists II,2,2,5.0,4
20904024,Alleyn Old Boys,Old Rugbeians,3,1,3.0,4
21260374,Old Chigwellians II,Galleywood Reserves,1,2,4.0,3
21234337,Old Alleynians,Old Foresters,2,6,2.0,8
21234336,Old Harrovians,Old Bradfieldians,1,6,0.0,7
21234338,Old Carthusians,Old Tonbridgians,3,1,3.0,4
21059824,Lancing Old Boys,Old Berkhamstedians,1,1,4.0,2
21234342,Old Chigwellians,Old Reptonians,3,1,3.0,4
21234341,Old Salopians,Old Malvernians,2,2,5.0,4
21234339,Old Marlburians,Old Westminsters,2,1,4.0,3
21234718,Old Aldenhamians,Old Johnians,1,3,3.0,4
21234717,Old Harrovians II,Old Sennockians,2,2,5.0,4
21234719,Old Merchant Taylors,Old Etonians II,2,2,5.0,4
21234720,Old Carthusians II,Old Chigwellians II,6,1,0.0,7
21235348,Old Tonbridgians II,Old Epsomians,4,3,4.0,7
21234466,Old Foresters II,Old Brentwoods II,2,6,2.0,8
21234467,Old Kimboltonians,Kings College Wimbledon II,1,3,3.0,4
21234726,Old King's Scholars,Old Harrovians III,3,3,5.0,6
21234733,Old Merchant Taylors' II,Old Brentwoods III,1,7,0.0,8
21234734,Old Brentwoods IV,Old Bancroftians,1,8,0.0,9
21234732,Old Albanians SA,Old Haberdashers,2,1,4.0,3
21234784,Old Eastbournians,Old Berkhamstedians II,5,2,2.0,7
21234785,Old Amplefordians,Old Kingstonians KGS,0,7,0.0,7
21234786,Old Salopians II,Old Wykehamists II,2,3,4.0,5
21256059,Old Carthusians Vets,Old Cholmeleians Vets,1,3,3.0,4
21256036,KCS Old Boys Vets,Old Wellingtonians Vets,3,1,3.0,4
21401153,Old Carthusians Vets,Old Cholmeleians Vets,3,1,3.0,4
21400623,KCS Old Boys Vets,Old Wellingtonians Vets,1,3,3.0,4
20877326,Old Etonians Vets,Old Malvernians Vets,1,1,4.0,2
20955564,Old Alleynians,KCS Old Boys,2,0,2.0,2
20952166,Old Foresters,Old Wykehamists,1,0,3.0,1
21181606,Old Brentwoods,Old Etonians,3,3,5.0,6
20952167,Old Harrovians,Old Tonbridgians,0,5,0.0,5
20963334,Lancing Old Boys,Old Cholmeleians,0,2,2.0,2
20951252,Old Malvernians,Old Berkhamstedians,2,2,5.0,4
20951251,Old Rugbeians,Old Marlburians,3,7,2.0,10
20963335,Old Salopians,Old Westminsters,1,4,2.0,5
21194948,Old Radleians,Old Aldenhamians,3,2,4.0,5
21194949,Old Carthusians II,Old Columbans,2,0,2.0,2
21137811,Old Johnians,Old Sennockians,2,0,2.0,2
20951723,Old Harrovians II,Old Etonians II,2,2,5.0,4
21202679,Old Tonbridgians II,Old Foresters II,1,0,3.0,1
20952900,Old Kimboltonians,Old Epsomians,2,1,4.0,3
21202678,Old Alleynians II,Kings College Wimbledon II,3,1,3.0,4
21194953,Old Harrovians III,Old Alleynians AFC III,3,6,3.0,9
21195216,Old Shirburnians,Old Stoics,1,0,3.0,1
21194923,Lancing Old Boys II,Old Cholmeleians II,3,7,2.0,10
21194925,Old Bancroftians,Old Albanians SA,0,3,2.0,3
21194951,Old Amplefordians,Old Wykehamists II,2,1,4.0,3
21194950,Old Westminsters II,Old Berkhamstedians II,3,1,3.0,4
21194927,Old Ardinians,Weirside Rangers,3,2,4.0,5
20904031,Old Reptonians,Old Carthusians,0,3,2.0,3
20948443,Old Harrovians,Old Carthusians,0,10,0.0,10
20948442,Old Alleynians,Old Etonians,2,0,2.0,2
20948440,KCS Old Boys,Old Foresters,2,1,4.0,3
20948441,Old Wykehamists,Old Brentwoods,5,1,2.0,6
20951131,Lancing Old Boys,Old Malvernians,2,3,4.0,5
21135003,Old Marlburians,Old Salopians,0,0,4.0,0
20951133,Old Westminsters,Old Chigwellians,0,2,2.0,2
21093172,Old Etonians II,Old Aldenhamians,1,0,3.0,1
20942024,Old Radleians,Old Chigwellians II,3,1,3.0,4
21093173,Old Harrovians II,Old Merchant Taylors,0,2,2.0,2
20951894,Kings College Wimbledon II,Old Foresters II,1,2,4.0,3
20951896,Old Carthusians III,Old Alleynians II,3,3,5.0,6
20951895,Old Tonbridgians II,Old Suttonians SV,2,3,4.0,5
20953861,Old King's Scholars,Old Alleynians AFC III,2,4,3.0,6
20953863,Lancing Old Boys II,Old Stoics,1,4,2.0,5
20953862,Old Shirburnians,Old Wellingtonians,5,2,2.0,7
21093237,Old Albanians SA,Old Brentwoods IV,19,0,1.0,19
21093236,Old Merchant Taylors' II,Old Haberdashers,1,4,2.0,5
21093312,Old Wykehamists II,Old Berkhamstedians II,3,3,5.0,6
21093311,Old Kingstonians KGS,Old Ardinians,0,2,2.0,2
21064094,Old Amplefordians,Old Westminsters II,5,3,4.0,8
21087743,Old Bradfieldians,Old Tonbridgians,1,0,3.0,1
20904027,Hale End Athletic,Old Reptonians,1,0,3.0,1
20942096,Old Carthusians II,Old Columbans,1,0,3.0,1
21061046,Old Brentwoods II,Old Kimboltonians,1,4,2.0,5
20877215,Old Tonbridgians Vets,Old Carthusians Vets,1,3,3.0,4
20952505,Old Alleynians,Old Wykehamists,3,1,3.0,4
20921997,Old Carthusians,Old Brentwoods,3,1,3.0,4
21079977,Old Bradfieldians,KCS Old Boys,4,3,4.0,7
20952504,Old Foresters,Old Tonbridgians,1,0,3.0,1
20929926,Old Salopians,Old Rugbeians,3,1,3.0,4
20929928,Old Malvernians,Old Marlburians,3,2,4.0,5
21059557,Old Cholmeleians,Old Chigwellians,6,1,0.0,7
21048854,Old Columbans,Old Johnians,0,4,1.0,4
21002540,Old Carthusians II,Old Aldenhamians,0,1,3.0,1
20941968,Old Harrovians II,Old Chigwellians II,1,1,4.0,2
20951887,Old Alleynians II,Old Kimboltonians,4,1,2.0,5
20951886,Old Foresters II,Old Epsomians,0,3,2.0,3
20951885,Old Carthusians III,Old Brentwoods II,2,3,4.0,5
21054388,Old Alleynians AFC III,Lancing Old Boys II,3,2,4.0,5
21048828,Old Cholmeleians II,Old Harrovians III,12,0,0.0,12
21048829,Old Brentwoods III,Old Brentwoods IV,8,0,0.0,8
21048841,Old Westminsters II,Old Eastbournians,1,1,4.0,2
21048840,Old Ardinians,Old Salopians II,4,0,1.0,4
20878195,Glyn Old Boys,Old Etonians II,1,0,3.0,1
20958953,Old Radleians,Old Harrovians II,1,1,4.0,2
20921996,Old Harrovians,Old Etonians,3,3,5.0,6
20921995,KCS Old Boys,Old Carthusians,0,3,2.0,3
20976860,Lancing Old Boys,Old Chigwellians,1,1,4.0,2
20923091,Old Berkhamstedians,Old Salopians,2,2,5.0,4
20923089,Old Cholmeleians,Old Rugbeians,1,2,4.0,3
20923088,Old Marlburians,Old Reptonians,1,3,3.0,4
20927568,Old Chigwellians II,Old Merchant Taylors,1,3,3.0,4
20923107,Old Radleians,Old Columbans,1,1,4.0,2
20923108,Old Johnians,Old Etonians II,1,3,3.0,4
20923116,Old Alleynians II,Old Epsomians,3,4,4.0,7
20923114,Kings College Wimbledon II,Old Carthusians III,5,2,2.0,7
20923115,Old Kimboltonians,Old Tonbridgians II,1,2,4.0,3
20923125,Old Cholmeleians II,Old Wellingtonians,4,3,4.0,7
20923172,Old Haberdashers,Old Merchant Taylors' II,1,2,4.0,3
20923171,Old Albanians SA,Old Bancroftians,1,3,3.0,4
20976210,Old Salopians II,Old Berkhamstedians II,3,2,4.0,5
20923214,Old Ardinians,Old Amplefordians,7,2,0.0,9
20923215,Old Wykehamists II,Old Eastbournians,4,1,2.0,5
20877459,Old Alleynians,Old Hamptonians,0,4,1.0,4
20997846,Old Stoics,Old Harrovians III,1,1,4.0,2
20904032,Old Tonbridgians,Old Bradfieldians,1,1,4.0,2
20929684,Old Alleynians,Old Harrovians,1,1,4.0,2
20880184,Kings College Wimbledon II,Old Epsomians,4,1,2.0,5
20921702,Old Carthusians,Nottsborough FC,1,2,4.0,3
22420457,Old Bradfieldians,Old Brentwoods,1,2,4.0,3
22425376,Old Wykehamists II,Old Salopians II,0,0,4.0,0
23141556,Old Reptonians,Old Etonians,7,1,0.0,8
23135237,Old Etonians II,Old Alleynians II,6,0,0.0,6
23135967,Old Shirburnians,Old Haberdashers,2,4,3.0,6
23137198,Old Harrovians Vets,KCS Old Boys Vets,1,6,0.0,7
23147809,Old Foresters Vets,Old Chigwellians Vets Blues,2,3,4.0,5
22420438,Old Brentwoods,KCS Old Boys,1,6,0.0,7
22420196,Old Salopians,Old Reptonians,1,6,0.0,7
23127734,Old Berkhamstedians II,Old Amplefordians,2,1,4.0,3
23128487,AFC Representative Team,Arthurian League Representative Team,3,2,4.0,5
22420380,Old Bradfieldians,Old Etonians,1,2,4.0,3
23089112,Old Etonians,Old Bradfieldians,2,1,4.0,3
22657575,Lloyds of London Representative Team,Arthurian League Representative Team,1,1,4.0,2
23128397,Old Wellingtonians Vets,Old Tonbridgians Vets,2,5,2.0,7
22420376,Old Foresters,Old Brentwoods,4,1,2.0,5
22420283,Old Harrovians,Old Bradfieldians,1,6,0.0,7
22420301,Old Marlburians,Old Berkhamstedians,7,4,3.0,11
22420464,Old Chigwellians,Old Westminsters,1,4,2.0,5
22420299,Old Merchant Taylors',Old Alleynians II,1,13,1.0,14
22420300,Old Kimboltonians,Old Alleynians III,2,2,5.0,4
23128257,Old Etonians II,Old Ardinians,1,1,4.0,2
23117072,Old Haberdashers,Old Cheltonians,1,1,4.0,2
23116426,Old Wellingtonians,Old Shirburnians,1,4,2.0,5
22425335,Old Salopians II,Old Ardinians II,0,0,4.0,0
22420469,Old Brentwoods,Old Etonians,3,0,2.0,3
22420416,Old Wykehamists,Old Bradfieldians,0,5,0.0,5
22420399,Old Foresters,KCS Old Boys,1,0,3.0,1
22420507,Old Reptonians,Old Berkhamstedians,1,0,3.0,1
22420225,Old Chigwellians,Old Cholmeleians,2,5,2.0,7
22420229,Old Westminsters,Old Salopians,1,1,4.0,2
22420347,Old Sennockians,Old Aldenhamians,1,2,4.0,3
22420404,Old Harrovians II,Old Chigwellians II,3,3,5.0,6
22420262,Old Johnians,Old Merchant Taylors',0,2,2.0,2
22420177,Old Epsomians,Old Brentwoods II,3,0,2.0,3
22425369,Old Ardinians,Old Wellingtonians,3,0,2.0,3
23116708,Old Haberdashers,Old Berkhamstedians II,2,3,4.0,5
23116710,Old Brentwoods III,Old Amplefordians,2,2,5.0,4
22572000,Beder FC,Old Alleynians AFC,10,10,7.0,20
23116709,Old Amplefordians,Old Brentwoods III,0,0,4.0,0
23116707,Old Berkhamstedians II,Old Haberdashers,0,0,4.0,0
21871132,Old Radleians,Radley College 1st XI,10,10,7.0,20
22420442,Old Carthusians,Old Bradfieldians,3,0,2.0,3
22420439,Old Foresters,Old Alleynians,3,4,4.0,7
22420372,Old Tonbridgians,KCS Old Boys,1,0,3.0,1
22420227,Lancing Old Boys,Old Malvernians,1,0,3.0,1
22420295,Old Rugbeians,Old Westminsters,2,3,4.0,5
22420172,Old Etonians II,Old Alleynians II,7,0,0.0,7
22420462,Old Chigwellians II,Old Merchant Taylors',2,2,5.0,4
22420424,Old Harrovians II,Old Sennockians,2,1,4.0,3
23068337,Old Cholmeleians II,Old Tonbridgians II,3,0,2.0,3
22425444,Old Stoics,Old King's Scholars,5,1,2.0,6
22196864,Old Cheltonians,Old Haberdashers,1,1,4.0,2
22425354,Old Eastbournians,Old Berkhamstedians II,1,6,0.0,7
22425315,Old Westminsters II,Old Salopians II,8,0,0.0,8
23101937,Old Ardinians,Old Wykehamists II,2,1,4.0,3
23056802,Old Wellingtonians,Lancing Old Boys II,6,1,0.0,7
23098141,Brentwood School 1st XI,Old Brentwoods,2,1,4.0,3
23098142,Brentwood School 2nd XI,Old Brentwoods II,10,0,0.0,10
23098143,Brentwood School 3rd XI,Old Brentwoods III,0,3,2.0,3
23098144,Brentwood School 4th XI,Old Brentwoods IV,10,0,0.0,10
23098145,Brentwood School 5th XI,Old Brentwoods Vets,10,0,0.0,10
22985980,Old Stoics,Stowe School,5,4,5.0,9
22420362,Old Harrovians,Old Carthusians,2,2,5.0,4
22420264,Old Westminsters,Old Reptonians,1,1,4.0,2
22420356,Old Chigwellians II,Old Radleians,2,1,4.0,3
22420313,Old Aldenhamians,Old Alleynians II,1,4,2.0,5
23068338,Old Brentwoods II,Old Tonbridgians II,0,3,2.0,3
22425357,Old King's Scholars,Old Shirburnians,1,1,4.0,2
22425304,Old Kingstonians,Old Berkhamstedians II,3,4,4.0,7
22425412,Old Eastbournians,Old Salopians II,2,2,5.0,4
22425432,Old Wykehamists II,Old Westminsters II,0,0,4.0,0
23073027,Old Ardinians,Old Merchant Taylors',5,0,0.0,5
23053369,Old Cheltonians,Cheltenham College 1st XI,4,3,4.0,7
22978237,KCS Old Boys,"King's College School, Wimbledon 1st XI",3,1,3.0,4
22978306,Kings College Wimbledon II,"King's College School, Wimbledon 2nd XI",4,0,1.0,4
22815829,Old Malvernians,Malvern College 1st XI,3,2,4.0,5
23073461,Old Brentwoods III,Old Parkonians,0,2,2.0,2
22942648,KCS Old Boys Vets,Old Etonians Vets,0,0,4.0,0
23068563,Old Chigwellians Vets Blues,Old Foresters Vets,1,4,2.0,5
22420437,Old Tonbridgians,Old Wykehamists,2,2,5.0,4
22420458,Old Foresters,Old Carthusians,0,13,1.0,13
22420315,Lancing Old Boys,Old Berkhamstedians,5,3,4.0,8
22420261,Old Malvernians,Old Marlburians,0,3,2.0,3
22420423,Old Cholmeleians,Old Salopians,3,1,3.0,4
22420334,Old Etonians II,Old Johnians,1,3,3.0,4
22420173,Old Harrovians II,Old Alleynians II,0,8,0.0,8
22420443,Old Merchant Taylors',Old Carthusians II,2,3,4.0,5
22420230,Old Radleians,Old Sennockians,1,1,4.0,2
22420407,Old Brentwoods II,Old Kimboltonians,1,4,2.0,5
22425393,Lancing Old Boys II,Old Ardinians,1,4,2.0,5
22196859,Old Brentwoods III,Old Brentwoods IV,2,0,2.0,2
22425414,Old Eastbournians,Old Amplefordians,4,3,4.0,7
23038168,Old Reptonians,Old Chigwellians,3,1,3.0,4
23038167,Old Bradfieldians,Old Etonians,5,5,6.0,10
23013924,Old King's Scholars,Old Shirburnians,1,3,3.0,4
22986391,Old Albanians SA,Old Haberdashers,1,2,4.0,3
22921507,Old Wellingtonians Vets,Old Bradfieldians Vets,3,1,3.0,4
23007844,Old Shirburnians,Sherborne School 1st XI,0,10,0.0,10
22420253,Old Carthusians,Old Foresters,1,0,3.0,1
22420171,Old Brentwoods,Old Alleynians,1,4,2.0,5
22420231,KCS Old Boys,Old Wykehamists,1,4,2.0,5
22420364,Old Tonbridgians,Old Etonians,1,4,2.0,5
22420350,Old Cholmeleians,Old Chigwellians,8,0,0.0,8
22420425,Old Berkhamstedians,Old Westminsters,0,1,3.0,1
22420431,Old Aldenhamians,Old Etonians II,2,4,3.0,6
22420474,Old Merchant Taylors',Old Sennockians,1,7,0.0,8
22420187,Old Chigwellians II,Old Carthusians II,5,4,5.0,9
22420290,Old Johnians,Old Harrovians II,7,5,4.0,12
22425400,Lancing Old Boys II,Old Harrovians III,0,1,3.0,1
22425390,Old Stoics,Old Wellingtonians,2,3,4.0,5
22425426,Old Eastbournians,Old Ardinians II,1,3,3.0,4
23039047,Old Brentwoods II,Old Alleynians II,1,7,0.0,8
23052033,Old Ardinians,Old Berkhamstedians II,3,0,2.0,3
22947975,Old Carthusians Vets,Old Tonbridgians Vets,0,1,3.0,1
22420478,Old Harrovians,Old Wykehamists,3,4,4.0,7
22420275,Old Alleynians,Old Foresters,2,1,4.0,3
22420401,Old Etonians,Old Carthusians,1,7,0.0,8
22420524,Old Chigwellians,Old Reptonians,0,2,2.0,2
22420409,Old Cholmeleians,Old Rugbeians,9,1,0.0,10
22420305,Old Radleians,Old Chigwellians II,0,3,2.0,3
22420496,Old Merchant Taylors',Old Etonians II,0,6,0.0,6
22420355,Old Carthusians II,Old Johnians,0,10,0.0,10
22425349,Old Stoics,Old Albanians SA,0,2,2.0,2
22425319,Old Wellingtonians,Old King's Scholars,1,4,2.0,5
22425318,Old Haberdashers,Old Brentwoods IV,2,2,5.0,4
22425364,Old Kingstonians,Old Ardinians II,1,2,4.0,3
22940669,Old Wykehamists II,Lancing Old Boys II,0,2,2.0,2
22940021,Old Aldenhamians,Aldenham School 1st XI,0,10,0.0,10
22942224,Old Westminsters,Westminster School 1st XI,3,3,5.0,6
22941909,Old Westminsters II,Westminster School 2nd XI,1,3,3.0,4
22420515,Old Brentwoods,Old Wykehamists,7,1,0.0,8
22420448,Old Tonbridgians,Old Harrovians,2,1,4.0,3
22420481,Old Malvernians,Old Berkhamstedians,3,3,5.0,6
22420506,Old Rugbeians,Lancing Old Boys,2,2,5.0,4
22425423,Old Albanians SA,Old King's Scholars,2,1,4.0,3
22425305,Old Brentwoods III,Old Cheltonians,7,2,0.0,9
22425322,Old Amplefordians,Old Westminsters II,3,1,3.0,4
22800286,Old Chigwellians,Old Salopians,2,1,4.0,3
22800463,Old Reptonians,Old Shirburnians,3,1,3.0,4
22940489,Old Etonians II,Old Kimboltonians,6,5,5.0,11
22952164,Old Johnians,Old Alleynians II,2,2,5.0,4
22940692,Old Brentwoods II,Old Harrovians II,4,1,2.0,5
22420414,Old Tonbridgians,Old Alleynians,2,8,0.0,10
22420296,Old Foresters,Old Wykehamists,3,3,5.0,6
22420441,Old Chigwellians,Old Berkhamstedians,6,1,0.0,7
22420367,Old Cholmeleians,Old Reptonians,4,1,2.0,5
22420268,Old Marlburians,Lancing Old Boys,2,3,4.0,5
22420204,Old Rugbeians,Old Malvernians,3,0,2.0,3
22420427,Old Radleians,Old Alleynians II,1,0,3.0,1
22420420,Old Merchant Taylors',Old Johnians,0,4,1.0,4
22420287,Old Carthusians II,Old Chigwellians II,4,5,5.0,9
22420288,Old Sennockians,Old Etonians II,1,2,4.0,3
22420498,Old Aldenhamians,Old Harrovians II,4,4,6.0,8
22420460,Old Kimboltonians,Old Cholmeleians II,4,5,5.0,9
22420360,Old Alleynians III,Kings College Wimbledon II,1,2,4.0,3
22425392,Old Wellingtonians,Old Shirburnians,2,4,3.0,6
22425358,Old Kingstonians,Old Amplefordians,2,1,4.0,3
22800454,Old Brentwoods,Old Bradfieldians,2,5,2.0,7
22800342,KCS Old Boys,Old Etonians,3,4,4.0,7
22913381,Old Brentwoods IV,Old King's Scholars,0,1,3.0,1
22919699,Winchmore Hill,Old Carthusians,1,0,3.0,1
22420432,Old Brentwoods,Old Foresters,1,4,2.0,5
22420245,Old Alleynians,KCS Old Boys,0,1,3.0,1
22420393,Old Etonians,Old Harrovians,2,1,4.0,3
22420388,Old Cholmeleians,Old Berkhamstedians,2,0,2.0,2
22420426,Old Malvernians,Lancing Old Boys,2,1,4.0,3
22420451,Old Reptonians,Old Marlburians,3,5,4.0,8
22420430,Old Salopians,Old Chigwellians,3,4,4.0,7
22420271,Old Aldenhamians,Old Chigwellians II,3,2,4.0,5
22420309,Old Sennockians,Old Harrovians II,0,1,3.0,1
22420322,Old Radleians,Old Johnians,1,2,4.0,3
22420218,Old Carthusians II,Old Merchant Taylors',2,1,4.0,3
22420185,Old Brentwoods II,Old Alleynians III,5,2,2.0,7
22420484,Old Kimboltonians,Old Epsomians,2,2,5.0,4
22425361,Lancing Old Boys II,Old King's Scholars,0,1,3.0,1
22425415,Old Wellingtonians,Old Ardinians,0,5,0.0,5
22425345,Old Wykehamists II,Old Eastbournians,4,2,3.0,6
22425445,Old Ardinians II,Old Westminsters II,4,3,4.0,7
22918830,Old Kingstonians,Old Albanians SA,0,3,2.0,3
22939858,Old Berkhamstedians II,Old Cheltonians,1,4,2.0,5
22783125,Old Carthusians,Civil Service,1,2,4.0,3
22750544,Old Finchleians,Old Brentwoods III,1,3,3.0,4
22769569,Old Owens,Old Etonians II,4,3,4.0,7
22420302,Old Wykehamists,Old Brentwoods,3,6,3.0,9
22420327,Old Carthusians,KCS Old Boys,3,1,3.0,4
22420419,Old Foresters,Old Harrovians,1,2,4.0,3
22420310,Old Etonians,Old Tonbridgians,4,1,2.0,5
22420421,Old Reptonians,Old Malvernians,5,0,0.0,5
22420250,Old Westminsters,Old Cholmeleians,2,4,3.0,6
22420480,Old Sennockians,Old Alleynians II,1,4,2.0,5
22420494,Old Radleians,Old Carthusians II,3,1,3.0,4
22420485,Old Chigwellians II,Old Etonians II,0,8,0.0,8
22420487,Old Merchant Taylors',Old Harrovians II,0,3,2.0,3
22420406,Old Aldenhamians,Old Johnians,0,4,1.0,4
22420314,Old Epsomians,Old Alleynians III,1,1,4.0,2
23068610,Old Tonbridgians II,Old Kimboltonians,0,10,0.0,10
22420428,Kings College Wimbledon II,Old Brentwoods II,1,3,3.0,4
22425348,Old Harrovians III,Lancing Old Boys II,2,2,5.0,4
22425401,Old Ardinians,Old Stoics,4,0,1.0,4
22425378,Old Albanians SA,Old Wellingtonians,7,1,0.0,8
22425299,Old Brentwoods IV,Old Haberdashers,1,3,3.0,4
22425403,Old Berkhamstedians II,Old Westminsters II,1,1,4.0,2
22761650,Old Wykehamists II,Old Cholmeleians II,3,2,4.0,5
22744106,Lancing Old Boys Vets,Old Etonians Vets,2,5,2.0,7
22560643,Old Foresters Vets,Old Malvernians Vets,2,0,2.0,2
22570654,Old Harrovians Vets,Old Tonbridgians Vets,0,0,4.0,0
22420284,KCS Old Boys,Old Brentwoods,4,2,3.0,6
22420378,Old Alleynians,Old Carthusians,3,4,4.0,7
22420359,Old Bradfieldians,Old Wykehamists,3,0,2.0,3
22420510,Old Tonbridgians,Old Foresters,4,3,4.0,7
22420228,Old Berkhamstedians,Old Reptonians,0,5,0.0,5
22420395,Old Rugbeians,Old Marlburians,2,2,5.0,4
22420403,Old Malvernians,Old Chigwellians,1,7,0.0,8
22420202,Old Salopians,Old Cholmeleians,2,3,4.0,5
22420504,Lancing Old Boys,Old Westminsters,0,1,3.0,1
22420374,Old Carthusians II,Old Aldenhamians,1,5,2.0,6
22420236,Old Cholmeleians II,Old Epsomians,3,3,5.0,6
22425301,Old Wellingtonians,Lancing Old Boys II,4,2,3.0,6
22425408,Old Amplefordians,Old Ardinians II,4,2,3.0,6
22425331,Old Kingstonians,Old Eastbournians,1,6,0.0,7
22425368,Old Berkhamstedians II,Old Salopians II,3,3,5.0,6
22783114,Old Shirburnians,Old Kimboltonians,0,5,0.0,5
22783115,Old Brentwoods II,Old Chigwellians II,1,1,4.0,2
22831215,Old Radleians,Old Etonians II,0,1,3.0,1
22782968,Old Westminsters II,Old Harrovians II,1,7,0.0,8
22896325,Kings College Wimbledon II,Old Johnians,1,3,3.0,4
22491640,Old Stoics,Old Wykehamists II,2,4,3.0,6
22816234,Old Cheltonians,Old Harrovians III,2,2,5.0,4
22750538,Old Finchleians,Old Etonians,1,0,3.0,1
22708415,Old Cholmeleians Vets,KCS Old Boys Vets,1,6,0.0,7
22784721,Old Bradfieldians Vets,Old Aldenhamians Vets,8,1,0.0,9
22420486,Old Etonians,Old Foresters,6,3,3.0,9
22420238,Old Alleynians,Old Harrovians,5,3,4.0,8
22420254,Old Marlburians,Old Rugbeians,0,4,1.0,4
22420375,Old Salopians,Old Berkhamstedians,4,2,3.0,6
22420297,Old Cholmeleians,Lancing Old Boys,1,3,3.0,4
22420477,Old Reptonians,Old Westminsters,1,1,4.0,2
22420263,Old Harrovians II,Old Radleians,4,5,5.0,9
22420467,Old Alleynians II,Old Carthusians II,3,1,3.0,4
22420523,Old Aldenhamians,Old Merchant Taylors',4,0,1.0,4
22420452,Old Etonians II,Old Sennockians,5,1,2.0,6
22420392,Old Johnians,Old Chigwellians II,3,1,3.0,4
22420335,Kings College Wimbledon II,Old Kimboltonians,0,0,4.0,0
22420174,Old Cholmeleians II,Old Alleynians III,2,3,4.0,5
22425442,Old Shirburnians,Old Ardinians,4,0,1.0,4
22425413,Old King's Scholars,Old Stoics,3,5,4.0,8
22491651,Old Berkhamstedians II,Old Salopians II,4,3,4.0,7
22804870,Old Westminsters II,Old Albanians SA,2,2,5.0,4
22820187,Old Brentwoods III,Old Wellingtonians,2,3,4.0,5
22772286,Nottsborough FC,Old Carthusians,1,2,4.0,3
22695584,Old Salopians Vets,Old Carthusians Vets,2,9,0.0,11
22708255,Old Reptonians Vets,Old Wellingtonians Vets,1,5,2.0,6
22420493,Old Foresters,Old Bradfieldians,3,4,4.0,7
22420326,Old Carthusians,Old Wykehamists,7,0,0.0,7
22420316,Old Tonbridgians,Old Brentwoods,1,3,3.0,4
22420273,Old Harrovians,Old Etonians,3,7,2.0,10
22420357,Old Westminsters,Old Rugbeians,0,1,3.0,1
22420181,Old Malvernians,Old Reptonians,2,6,2.0,8
22420479,Old Chigwellians,Lancing Old Boys,4,3,4.0,7
22420472,Old Etonians II,Old Radleians,2,4,3.0,6
22420233,Old Aldenhamians,Old Carthusians II,1,3,3.0,4
22420242,Old Merchant Taylors',Old Chigwellians II,2,3,4.0,5
22420516,Old Cholmeleians II,Kings College Wimbledon II,2,3,4.0,5
23068608,Old Kimboltonians,Old Tonbridgians II,3,2,4.0,5
22425297,Old Harrovians III,Old Ardinians,0,6,0.0,6
22425386,Lancing Old Boys II,Old Stoics,1,2,4.0,3
22425402,Old King's Scholars,Old Wellingtonians,0,5,0.0,5
22425314,Old Millhillians,Old Brentwoods III,3,4,4.0,7
22425320,Old Salopians II,Old Kingstonians,7,1,0.0,8
22425302,Old Wykehamists II,Old Amplefordians,1,4,2.0,5
22425303,Old Westminsters II,Old Ardinians II,2,2,5.0,4
22484868,Old Johnians,Old Albanians SA,4,4,6.0,8
22701416,Old Cholmeleians,Old Vaughanians,0,3,2.0,3
22856198,Old Harrovians Select XI,Old Harrovians II,4,4,6.0,8
22788770,Old Alleynians,Dulwich College 1st XI,5,1,2.0,6
22788761,Old Alleynians II,Dulwich College 2nd XI,0,0,4.0,0
22788762,Old Alleynians III,Dulwich College 3rd XI,0,0,4.0,0
22595669,Old Epsomians,Epsom College 1st XI,5,5,6.0,10
22420369,Old Chigwellians II,Old Sennockians,2,3,4.0,5
22425328,Lancing Old Boys II,Old Wellingtonians,1,11,0.0,12
22604848,Old Ardinians,Old Bradfieldians,3,5,4.0,8
22644903,Old Tonbridgians,Old Brentwoods,2,3,4.0,5
22604682,Old Reptonians,Old Berkhamstedians,6,1,0.0,7
22604671,Old Wykehamists,KCS Old Boys,2,4,3.0,6
22576243,Old Chigwellians,Old Alleynians,4,3,4.0,7
22645128,Lancing Old Boys,Old Etonians,1,2,4.0,3
22668194,Old Brentwoods III,Old Merchant Taylors',3,4,4.0,7
22695586,Old Bradfieldians Vets,Old Wykehamists Veterans,6,0,0.0,6
22733161,Old Ignatians,Old Foresters Vets,1,3,3.0,4
22420466,Old Alleynians,Old Bradfieldians,7,2,0.0,9
22420358,Old Harrovians,Old Tonbridgians,1,2,4.0,3
22420412,Old Etonians,KCS Old Boys,4,0,1.0,4
22420346,Old Berkhamstedians,Lancing Old Boys,3,3,5.0,6
22420294,Old Reptonians,Old Salopians,4,2,3.0,6
22420508,Old Marlburians,Old Chigwellians,1,7,0.0,8
22425312,Old Eastbournians,Old Wykehamists II,0,4,1.0,4
22425311,Old Ardinians II,Old Kingstonians,3,3,5.0,6
22762677,Old Brentwoods II,Old Carthusians II,2,1,4.0,3
22666996,Old Suttonians SV,Old Haberdashers,1,3,3.0,4
22484875,Kings College Wimbledon II,Old Aldenhamians,6,2,2.0,8
22699327,Old Shirburnians,Old Epsomians,2,1,4.0,3
22484867,Old Alleynians III,Old Etonians II,0,9,0.0,9
22677005,Old Stoics,Old Harrovians II,0,5,0.0,5
22677163,Old Sennockians,Old Westminsters II,2,3,4.0,5
22729792,Old Hamptonians,Old Foresters,7,1,0.0,8
22729793,Old Carthusians,South Bank Cuaco,3,2,4.0,5
22729794,Old Brentwoods,West Wickham,1,6,0.0,7
22769240,Old Merchant Taylors',Merchant Taylors School 1st XI,0,5,0.0,5
22733158,Old King's Scholars,Old Parkonians,0,8,0.0,8
21871298,Old Kimboltonians,Kimbolton School 1st XI,0,0,4.0,0
22420210,Old Harrovians,KCS Old Boys,2,1,4.0,3
22420199,Old Etonians,Old Alleynians,1,1,4.0,2
22420410,Old Brentwoods,Old Tonbridgians,2,5,2.0,7
22420304,Old Westminsters,Old Chigwellians,4,0,1.0,4
22420182,Old Marlburians,Old Reptonians,0,5,0.0,5
22420323,Old Cholmeleians,Old Malvernians,2,2,5.0,4
22420368,Old Rugbeians,Old Salopians,1,1,4.0,2
22420456,Old Johnians,Old Alleynians II,5,2,2.0,7
22420408,Old Merchant Taylors',Old Radleians,1,3,3.0,4
22420413,Old Chigwellians II,Old Aldenhamians,0,3,2.0,3
22420249,Old Sennockians,Old Carthusians II,4,2,3.0,6
23073606,Old Tonbridgians II,Old Brentwoods II,4,0,1.0,4
22420447,Old Epsomians,Old Cholmeleians II,3,0,2.0,3
22425418,Old Stoics,Old Shirburnians,0,5,0.0,5
22425337,Old Harrovians III,Old Wellingtonians,1,1,4.0,2
22425416,Old Haberdashers,Old Brentwoods III,1,4,2.0,5
22425293,Old Eastbournians,Old Kingstonians,1,1,4.0,2
22425420,Old Wykehamists II,Old Ardinians II,5,2,2.0,7
22425419,Old Salopians II,Old Amplefordians,3,8,0.0,11
22678737,Bank of England,Old Brentwoods IV,1,1,4.0,2
22701453,Old Etonians II,Bealonians,3,0,2.0,3
22420361,Old Bradfieldians,Old Alleynians,4,5,5.0,9
22420490,Old Wykehamists,KCS Old Boys,1,2,4.0,3
22420417,Old Brentwoods,Old Carthusians,0,1,3.0,1
22420383,Old Chigwellians,Old Rugbeians,7,3,2.0,10
22420373,Old Reptonians,Lancing Old Boys,2,0,2.0,2
22420269,Old Johnians,Old Carthusians II,1,0,3.0,1
22420265,Old Alleynians II,Old Sennockians,2,2,5.0,4
22420274,Old Harrovians II,Old Etonians II,3,1,3.0,4
22420461,Old Brentwoods II,Old Epsomians,2,4,3.0,6
23073611,Kings College Wimbledon II,Old Tonbridgians II,0,4,1.0,4
22425439,Old Stoics,Old Ardinians,0,4,1.0,4
22425375,Old Berkhamstedians II,Old Kingstonians,4,0,1.0,4
22425380,Old Westminsters II,Old Amplefordians,1,2,4.0,3
22581805,Old Brentwoods III,Albanian FC,6,0,0.0,6
22581801,Old Parkonians,Old Brentwoods IV,1,0,3.0,1
22679836,Old Etonians,Bealonians,3,1,3.0,4
22676921,Civil Service,Old Foresters,3,1,3.0,4
22420491,Old Harrovians,Old Alleynians,1,11,0.0,12
22420176,KCS Old Boys,Old Bradfieldians,2,0,2.0,2
22420365,Old Westminsters,Old Malvernians,4,3,4.0,7
22420325,Old Marlburians,Old Salopians,4,1,2.0,5
22420270,Old Berkhamstedians,Old Chigwellians,0,3,2.0,3
22420468,Old Rugbeians,Old Cholmeleians,2,3,4.0,5
22420470,Old Chigwellians II,Old Johnians,1,4,2.0,5
22420382,Old Alleynians II,Old Merchant Taylors',6,1,0.0,7
22420384,Old Kimboltonians,Kings College Wimbledon II,5,2,2.0,7
22420285,Old Cholmeleians II,Old Brentwoods II,1,2,4.0,3
23073613,Old Epsomians,Old Tonbridgians II,1,1,4.0,2
22425395,Old Albanians SA,Old Shirburnians,2,2,5.0,4
22425370,Old Ardinians,Lancing Old Boys II,4,0,1.0,4
22425422,Old Stoics,Old Harrovians III,2,1,4.0,3
22425362,Old Westminsters II,Old Wykehamists II,4,5,5.0,9
22425306,Old Salopians II,Old Eastbournians,5,2,2.0,7
22425436,Old Berkhamstedians II,Old Amplefordians,3,2,4.0,5
22708546,Weirside Rangers,Old Brentwoods,1,3,3.0,4
22649059,Dorkinians,Old Carthusians,0,1,3.0,1
22649060,Cambridge Heath,Old Foresters,1,2,4.0,3
21871307,Old Etonians,Eton College 1st XI,3,3,5.0,6
22661537,Old Etonians II,Eton College 2nd XI,0,5,0.0,5
22307167,Old King's Scholars,Old Wilsonians,4,3,4.0,7
22552406,Winchester College 1st XI,Old Wykehamists,0,2,2.0,2
21916688,Old Chigwellians Vets Blues,Old Wellingtonians Vets,5,3,4.0,8
22420282,Old Carthusians,Old Alleynians,1,1,4.0,2
22420389,Old Tonbridgians,Old Bradfieldians,4,1,2.0,5
22420203,Old Wykehamists,Old Foresters,0,0,4.0,0
22420319,KCS Old Boys,Old Etonians,2,4,3.0,6
22420333,Old Brentwoods,Old Harrovians,5,1,2.0,6
22420278,Old Malvernians,Old Rugbeians,2,1,4.0,3
22420454,Old Salopians,Lancing Old Boys,5,6,5.0,11
22420436,Old Marlburians,Old Westminsters,2,2,5.0,4
22420488,Old Johnians,Old Radleians,3,2,4.0,5
22420178,Old Carthusians II,Old Harrovians II,5,0,0.0,5
22420499,Old Alleynians III,Old Kimboltonians,0,3,2.0,3
22420505,Old Brentwoods II,Kings College Wimbledon II,4,5,5.0,9
23073609,Old Tonbridgians II,Old Epsomians,1,6,0.0,7
22425363,Old Harrovians III,Old Albanians SA,2,2,5.0,4
22425300,Old Wellingtonians,Old Stoics,2,4,3.0,6
22425391,Old Ardinians,Old King's Scholars,4,1,2.0,5
22425440,Old Wykehamists II,Old Berkhamstedians II,1,5,2.0,6
22425429,Old Westminsters II,Old Kingstonians,2,4,3.0,6
22425325,Old Ardinians II,Old Eastbournians,2,5,2.0,7
22484105,Old Shirburnians,Old Brentwoods IV,3,0,2.0,3
22518161,Globe Rangers,Old Aldenhamians,4,2,3.0,6
22518160,Earlsfield FC,Old Cholmeleians,1,5,2.0,6
22683241,West Wickham,Old Haberdashers,3,3,5.0,6
22543051,Old Chigwellians II,Old Pauline,5,6,5.0,11
22642727,Old Merchant Taylors',Bealonians,0,8,0.0,8
22543141,Old Reptonians,Mill Hill Village,1,4,2.0,5
22646643,Albanian FC,Old Cholmeleians II,2,2,5.0,4
22666482,Arthurian League Representative Team,Southern Amateur League Rep XI,1,3,3.0,4
21874502,Lancing Old Boys,Lancing College 1st XI,4,1,2.0,5
22420307,Old Harrovians,Old Foresters,0,7,0.0,7
22420517,KCS Old Boys,Old Alleynians,2,7,0.0,9
22420465,Old Etonians,Old Wykehamists,2,2,5.0,4
22420280,Old Carthusians,Old Tonbridgians,2,4,3.0,6
22420328,Old Westminsters,Old Berkhamstedians,0,2,2.0,2
22420324,Old Rugbeians,Old Reptonians,2,2,5.0,4
22420500,Old Chigwellians,Old Malvernians,3,2,4.0,5
22420293,Old Cholmeleians,Old Marlburians,4,3,4.0,7
22420353,Old Alleynians II,Old Etonians II,2,4,3.0,6
22420344,Old Harrovians II,Old Johnians,3,3,5.0,6
22420260,Old Epsomians,Old Kimboltonians,0,2,2.0,2
22420272,Old Alleynians III,Old Cholmeleians II,1,4,2.0,5
22425290,Old Ardinians,Old Albanians SA,7,2,0.0,9
22484119,Old Cheltonians,Old Wykehamists II,3,4,4.0,7
22484118,Old Westminsters II,Old Harrovians III,3,2,4.0,5
22484111,Old Eastbournians,Old Merchant Taylors' II,2,3,4.0,5
22484109,Old Kingstonians,St Edwards OSE,0,2,2.0,2
22484117,Old Stoics,Old Amplefordians,5,2,2.0,7
22642695,Old Brentwoods IV,South Bank Cuaco,3,2,4.0,5
21871130,Old Salopians,Shrewsbury School 1st XI,0,0,4.0,0
21871131,Old Salopians II,Shrewsbury School 2nd XI,0,0,4.0,0
22306984,Old Aldenhamians,Albanian FC,0,1,3.0,1
22581824,Old Brentwoods,Bealonians,0,3,2.0,3
22603871,Old Meadonians,Kings College Wimbledon II,6,1,0.0,7
22420332,Old Bradfieldians,Old Foresters,5,3,4.0,8
22420482,Old Wykehamists,Old Carthusians,2,3,4.0,5
22420340,Old Alleynians,Old Tonbridgians,2,2,5.0,4
22420518,Old Rugbeians,Old Berkhamstedians,3,1,3.0,4
22420422,Old Chigwellians,Old Marlburians,0,5,0.0,5
22420247,Old Harrovians II,Old Aldenhamians,1,3,3.0,4
22420445,Old Alleynians II,Old Chigwellians II,2,1,4.0,3
22420252,Old Johnians,Old Etonians II,4,2,3.0,6
22420526,Old Carthusians II,Old Sennockians,2,3,4.0,5
22420440,Kings College Wimbledon II,Old Alleynians III,0,1,3.0,1
22425394,Old Harrovians III,Old King's Scholars,1,0,3.0,1
22425321,Old Albanians SA,Old Stoics,5,0,0.0,5
22425295,Old Salopians II,Old Wykehamists II,5,2,2.0,7
22425435,Old Amplefordians,Old Kingstonians,6,0,0.0,6
22425434,Old Berkhamstedians II,Old Ardinians II,4,0,1.0,4
22425338,Old Eastbournians,Old Westminsters II,0,2,2.0,2
22029904,Old Malvernians,Lancing Old Boys,1,8,0.0,9
22029899,Old Harrovians,Old Brentwoods,1,2,4.0,3
22029900,Old Kimboltonians,Old Salopians,0,4,1.0,4
22029893,Old Shirburnians,Old Merchant Taylors',2,1,4.0,3
22306989,Old Parkonians,Old Brentwoods II,2,2,5.0,4
22306417,Old Lyonians,Old Etonians,2,4,3.0,6
22543140,Old Cholmeleians,Old Woodhouseians,1,3,3.0,4
22543142,Old Cholmeleians II,Old Kingsburians,4,2,3.0,6
22603870,Economicals,KCS Old Boys,3,3,5.0,6
22420345,Lancing Old Boys,Old Marlburians,1,4,2.0,5
22420244,Old Chigwellians,Old Salopians,2,5,2.0,7
22420321,Old Chigwellians II,Old Harrovians II,2,1,4.0,3
22420223,Old Carthusians II,Old Alleynians II,1,1,4.0,2
22420240,Old Etonians II,Old Merchant Taylors',4,1,2.0,5
22420502,Old Johnians,Old Sennockians,1,2,4.0,3
23073605,Old Tonbridgians II,Old Alleynians III,2,1,4.0,3
22420379,Kings College Wimbledon II,Old Epsomians,4,1,2.0,5
22425438,Old Shirburnians,Old King's Scholars,3,3,5.0,6
22425313,Old Stoics,Lancing Old Boys II,4,1,2.0,5
22425437,Old Albanians SA,Old Harrovians III,3,1,3.0,4
22196856,Old Cheltonians,Old Brentwoods IV,4,2,3.0,6
22425343,Old Berkhamstedians II,Old Wykehamists II,5,1,2.0,6
22425352,Old Salopians II,Old Westminsters II,4,2,3.0,6
22029901,Old Kingstonians,Old Bradfieldians,0,8,0.0,8
22029895,Old Tonbridgians,Old Foresters,2,0,2.0,2
22029898,Old Rugbeians,Old Cholmeleians,1,4,2.0,5
22029894,Old Reptonians,Old Radleians,5,2,2.0,7
22029903,Old Eastbournians,Old Wykehamists,2,6,2.0,8
22029892,Old Berkhamstedians,Old Aldenhamians,4,1,2.0,5
22029902,Old Ardinians,Old Westminsters,2,1,4.0,3
22410220,Old Parkonians,Old Haberdashers,1,6,0.0,7
22410199,Old Kingsburians,Old Brentwoods II,3,1,3.0,4
22455817,Old Brentwoods,Crouch End Vampires,4,1,2.0,5
22543139,Old Malvernians,Latymer Old Boys,2,8,0.0,10
22420175,Old Etonians,Old Bradfieldians,4,5,5.0,9
22420381,Old Wykehamists,Old Harrovians,6,2,2.0,8
22420463,KCS Old Boys,Old Tonbridgians,0,3,2.0,3
22420241,Old Reptonians,Old Rugbeians,2,0,2.0,2
22420366,Old Berkhamstedians,Old Marlburians,4,2,3.0,6
22420525,Old Malvernians,Old Salopians,2,6,2.0,8
22420489,Old Cholmeleians,Old Westminsters,1,1,4.0,2
22420385,Old Alleynians II,Old Aldenhamians,3,2,4.0,5
22420363,Old Harrovians II,Old Carthusians II,3,1,3.0,4
22420520,Old Radleians,Old Etonians II,0,9,0.0,9
23073604,Old Tonbridgians II,Kings College Wimbledon II,1,2,4.0,3
22420232,Old Alleynians III,Old Brentwoods II,1,5,2.0,6
22425379,Old King's Scholars,Old Albanians SA,1,3,3.0,4
22425294,Old Harrovians III,Old Shirburnians,2,4,3.0,6
22196857,Old Brentwoods III,Old Haberdashers,4,3,4.0,7
22425387,Old Ardinians II,Old Berkhamstedians II,1,3,3.0,4
22425388,Old Wykehamists II,Old Kingstonians,0,4,1.0,4
22425340,Old Amplefordians,Old Eastbournians,3,6,3.0,9
22029896,Old Chigwellians,Old Sennockians,7,1,0.0,8
22455816,Old Carthusians,Alexandra Park FC,4,2,3.0,6
22455818,Old Garchonians,Old Foresters,0,2,2.0,2
22455819,Old Alleynians,South Bank Cuaco,2,2,5.0,4
21872200,Old Bradfieldians Vets,Lancing Old Boys Vets,1,3,3.0,4
22420519,Old Etonians,Old Brentwoods,2,2,5.0,4
22420267,Old Alleynians,Old Wykehamists,1,2,4.0,3
22420528,KCS Old Boys,Old Carthusians,2,4,3.0,6
22420511,Old Bradfieldians,Old Harrovians,8,0,0.0,8
22420292,Old Berkhamstedians,Old Malvernians,3,1,3.0,4
22420446,Lancing Old Boys,Old Cholmeleians,0,2,2.0,2
22420391,Old Reptonians,Old Chigwellians,2,4,3.0,6
22420281,Old Salopians,Old Westminsters,3,3,5.0,6
22420180,Old Sennockians,Old Radleians,2,5,2.0,7
22420194,Old Alleynians II,Old Johnians,2,2,5.0,4
22420336,Old Harrovians II,Old Merchant Taylors',1,2,4.0,3
22420298,Old Etonians II,Old Aldenhamians,4,1,2.0,5
22420483,Old Brentwoods II,Old Cholmeleians II,1,6,0.0,7
23073612,Old Alleynians III,Old Tonbridgians II,7,5,4.0,12
22425330,Old Albanians SA,Lancing Old Boys II,2,0,2.0,2
22425308,Old King's Scholars,Old Harrovians III,1,3,3.0,4
22196838,Old Brentwoods IV,Old Cheltonians,2,2,5.0,4
22425316,Old Ardinians II,Old Wykehamists II,4,1,2.0,5
22425365,Old Westminsters II,Old Eastbournians,4,2,3.0,6
22425441,Old Amplefordians,Old Salopians II,5,2,2.0,7
22455821,Old Parmiterians,Old Ardinians,3,0,2.0,3
22134304,Chelmsford City Reserves,Old Foresters,2,1,4.0,3
21870904,Old Marlburians,Marlborough College 1st XI,3,3,5.0,6
22306427,Old Finchleians,Old Chigwellians II,3,2,4.0,5
22420212,Old Brentwoods,Old Bradfieldians,1,1,4.0,2
22420216,Old Wykehamists,Old Etonians,3,3,5.0,6
22420220,Old Foresters,Old Tonbridgians,3,3,5.0,6
22420434,Old Berkhamstedians,Old Rugbeians,1,4,2.0,5
22420211,Old Westminsters,Lancing Old Boys,5,1,2.0,6
22420501,Old Salopians,Old Marlburians,2,4,3.0,6
22420459,Old Malvernians,Old Cholmeleians,0,5,0.0,5
22420342,Old Etonians II,Old Chigwellians II,2,3,4.0,5
22420449,Old Radleians,Old Harrovians II,1,2,4.0,3
22420277,Old Sennockians,Old Merchant Taylors',2,4,3.0,6
22420215,Old Alleynians III,Old Epsomians,4,3,4.0,7
22420224,Old Kimboltonians,Old Brentwoods II,2,2,5.0,4
22425296,Old Shirburnians,Old Albanians SA,1,3,3.0,4
22425428,Old Wellingtonians,Old Harrovians III,2,2,5.0,4
22425324,Old Haberdashers,Old Cheltonians,4,1,2.0,5
22425443,Old Berkhamstedians II,Old Eastbournians,2,1,4.0,3
22425385,Old Ardinians II,Old Salopians II,6,1,0.0,7
22425347,Old Kingstonians,Old Westminsters II,3,0,2.0,3
22410175,Old Chigwellians,London Welsh F.C.,4,3,4.0,7
22410176,Old Reptonians,Old Vaughanians,2,4,3.0,6
22410213,Old King's Scholars,Old Finchleians,1,4,2.0,5
22464899,Old Carthusians,Charterhouse School 1st XI,6,1,0.0,7
22464900,Old Carthusians II,Charterhouse School 2nd XI,0,0,4.0,0
22464901,Old Carthusians III,Charterhouse School 3rd XI,6,1,0.0,7
21872179,Old Carthusians Vets,Old Etonians Vets,0,1,3.0,1
22420354,KCS Old Boys,Old Foresters,2,2,5.0,4
22420200,Old Harrovians,Old Brentwoods,0,2,2.0,2
22420201,Old Tonbridgians,Old Carthusians,1,4,2.0,5
22420352,Old Alleynians,Old Etonians,2,3,4.0,5
22420206,Lancing Old Boys,Old Reptonians,0,4,1.0,4
22420450,Old Salopians,Old Malvernians,1,2,4.0,3
22420205,Old Westminsters,Old Marlburians,1,2,4.0,3
22420239,Old Alleynians II,Old Harrovians II,2,0,2.0,2
22420179,Old Radleians,Old Merchant Taylors',2,7,0.0,9
22420207,Old Aldenhamians,Old Sennockians,2,7,0.0,9
22425289,Old King's Scholars,Lancing Old Boys II,0,6,0.0,6
22425405,Old Ardinians,Old Harrovians III,6,1,0.0,7
22425334,Old Shirburnians,Old Wellingtonians,9,2,0.0,11
22425407,Old Kingstonians,Old Wykehamists II,2,4,3.0,6
22425291,Old Ardinians II,Old Amplefordians,3,4,4.0,7
22410190,Old Cholmeleians II,Albanian FC,2,4,3.0,6
22410189,Old Chigwellians II,East Barnet Old Grammarians,3,1,3.0,4
21870903,Old Haberdashers,Haberdashers Aske School 1st XI,2,0,2.0,2
22420191,Old Foresters,Old Etonians,1,2,4.0,3
22420184,Old Bradfieldians,KCS Old Boys,0,6,0.0,6
22420186,Old Alleynians,Old Brentwoods,1,1,4.0,2
22420193,Old Carthusians,Old Harrovians,9,0,0.0,9
22420197,Old Wykehamists,Old Tonbridgians,3,3,5.0,6
22420183,Old Salopians,Old Rugbeians,4,1,2.0,5
22420188,Lancing Old Boys,Old Chigwellians,0,0,4.0,0
22420189,Old Berkhamstedians,Old Cholmeleians,3,4,4.0,7
22420198,Old Malvernians,Old Westminsters,1,4,2.0,5
22420513,Old Alleynians II,Old Radleians,5,1,2.0,6
22420170,Old Merchant Taylors',Old Aldenhamians,3,2,4.0,5
22420394,Old Etonians II,Old Harrovians II,11,0,0.0,11
22420190,Kings College Wimbledon II,Old Cholmeleians II,4,3,4.0,7
22425276,Old Shirburnians,Lancing Old Boys II,5,2,2.0,7
22425284,Old King's Scholars,Old Ardinians,0,6,0.0,6
22425283,Old Wellingtonians,Old Albanians SA,3,5,4.0,8
22425287,Old Harrovians III,Old Stoics,1,5,2.0,6
22196825,Old Cheltonians,Old Brentwoods III,4,6,4.0,10
22425285,Old Amplefordians,Old Berkhamstedians II,2,1,4.0,3
22425286,Old Kingstonians,Old Salopians II,4,1,2.0,5
22421285,Old Wykehamists,Old Alleynians,2,1,4.0,3
22421284,Old Carthusians,Old Etonians,2,1,4.0,3
22420338,Lancing Old Boys,Old Rugbeians,0,2,2.0,2
22420471,Old Marlburians,Old Malvernians,1,1,4.0,2
22420473,Old Berkhamstedians,Old Salopians,2,1,4.0,3
22420330,Old Reptonians,Old Cholmeleians,1,0,3.0,1
22420455,Old Radleians,Old Aldenhamians,1,4,2.0,5
22420492,Old Chigwellians II,Old Alleynians II,2,0,2.0,2
22420320,Old Carthusians II,Old Etonians II,1,13,1.0,14
22420433,Old Sennockians,Old Johnians,0,4,1.0,4
22420246,Old Epsomians,Kings College Wimbledon II,1,0,3.0,1
23073607,Old Tonbridgians II,Old Cholmeleians II,0,5,0.0,5
22425377,Old Shirburnians,Old Stoics,2,0,2.0,2
22425344,Old Salopians II,Old Berkhamstedians II,0,2,2.0,2
21871123,Old Brentwoods,Brentwood School 1st XI,0,0,4.0,0
21871124,Old Brentwoods II,Brentwood School 2nd XI,0,0,4.0,0
21871125,Old Brentwoods III,Brentwood School 3rd XI,0,0,4.0,0
21871126,Old Brentwoods IV,Brentwood School 4th XI,0,0,4.0,0
21871127,Old Brentwoods Vets,Brentwood School 5th XI,0,0,4.0,0
21926256,Old Kingstonians,Kingston Grammar School 1st XI,4,3,4.0,7
21871128,Old Westminsters,Westminster School 1st XI,0,0,4.0,0
21871129,Old Westminsters II,Westminster School 2nd XI,0,0,4.0,0
22421247,Old Carthusians,Old Brentwoods,3,0,2.0,3
22421248,KCS Old Boys,Old Harrovians,5,0,0.0,5
22421246,Old Bradfieldians,Old Tonbridgians,2,4,3.0,6
22420397,Lancing Old Boys,Old Salopians,5,2,2.0,7
22420235,Old Marlburians,Old Cholmeleians,2,1,4.0,3
22420258,Old Rugbeians,Old Chigwellians,2,4,3.0,6
22420396,Old Carthusians II,Old Radleians,1,2,4.0,3
22420222,Old Johnians,Old Aldenhamians,4,1,2.0,5
22420214,Old Sennockians,Old Chigwellians II,3,1,3.0,4
22420512,Old Cholmeleians II,Old Kimboltonians,4,2,3.0,6
22425383,Old Shirburnians,Old Harrovians III,1,0,3.0,1
22196903,Old Brentwoods IV,Old Brentwoods III,0,12,0.0,12
22425329,Old Amplefordians,Old Wykehamists II,1,0,3.0,1
22278370,Old Ardinians II,Old Ardinians,0,0,4.0,0
21870896,Old Alleynians AFC,West Wickham,0,0,4.0,0
22173775,Old Alleynians III,West Wickham III,0,0,4.0,0
21870883,Old Etonians,Eton College 1st XI,0,0,4.0,0
21870884,Old Etonians II,Eton College 2nd XI,0,0,4.0,0
21870881,Old Foresters,Forest School 1st XI,0,0,4.0,0
21870882,Old Foresters II,Forest School 2nd XI,0,0,4.0,0
21870895,Old Reptonians,Repton School 1st XI,0,0,4.0,0
22236126,Old Rugbeians,Old Malvernians,1,4,2.0,5
21870879,Old Cholmeleians,Highgate School 1st XI,0,0,4.0,0
21870880,Old Cholmeleians II,Highgate School 2nd XI,0,0,4.0,0
22229769,Old Radleians,Old Harrovians II,2,2,5.0,4
21871231,Old Wykehamists,Old Reptonians,0,0,4.0,0
21890839,KCS Old Boys Vets,KCS Old Boys,0,0,4.0,0
21988171,Lancing Old Boys,Corinthian-Casuals,0,0,4.0,0
21871230,Kings College Wimbledon II,KCS Old Boys,5,5,6.0,10
21891282,Old Alleynians II,Old Berkhamstedians,0,0,4.0,0
21871256,Old Reptonians,NUFC Oilers,3,2,4.0,5
21871220,Old Alleynians AFC,Old Salopians,0,0,4.0,0
21894738,Old Johnians,Kings College Wimbledon II,0,0,4.0,0
21871210,Old Alleynians AFC,Old Reptonians,7,1,0.0,8
21871209,KCS Old Boys,Old Reptonians,0,0,4.0,0
21870364,Old Suttonians,Old Berkhamstedians,3,2,4.0,5
24215482,Old Chigwellians,Old Foresters,3,2,4.0,5
24222178,Old Tonbridgians II,Kings College Wimbledon II,0,4,1.0,4
24222284,Old Brentwoods III,Old Haberdashers,2,1,4.0,3
24254080,Old Brentwoods IV,Old Eastbournians,0,0,4.0,0
24239849,Old Carthusians,Old Alleynians,0,1,3.0,1
24215477,Old Rugbeians,Lancing Old Boys,1,2,4.0,3
24140992,Old Etonians II,Old Malvernians,5,0,0.0,5
24220997,Old Aldenhamians,Old Radleians,4,2,3.0,6
24239881,Old Chigwellians II,Old Cholmeleians II,2,5,2.0,7
24220982,Old Sennockians,Old Harrovians II,0,3,2.0,3
24222176,Old Carthusians II,Kings College Wimbledon II,2,6,2.0,8
24222119,Old Alleynians III,Old Brentwoods II,9,1,0.0,10
24222144,Old Epsomians,Old Ardinians,3,5,4.0,8
24140975,Old Tonbridgians II,Old Brentwoods II,3,1,3.0,4
24210550,Old Berkhamstedians II,Old Haberdashers,2,6,2.0,8
24222262,Old Stoics,Old Amplefordians,1,15,1.0,16
24640005,Old Etonians Vets,Old Cholmeleians Vets,3,2,4.0,5
24642893,Old Salopians Vets,KCS Old Boys Vets,2,4,3.0,6
24222616,Old Wykehamists,Old Carthusians,1,5,2.0,6
23786198,Old Cholmeleians II,Old Aldenhamians,0,1,3.0,1
24222177,Old Tonbridgians II,Old Epsomians,0,0,4.0,0
24140987,Old Eastbournians,Old Kingstonians,1,2,4.0,3
24220966,Old Etonians II,Old Radleians,3,2,4.0,5
24621038,Old Foresters Vets,Old Cholmeleians Vets,3,4,4.0,7
24620901,Old Salopians Vets,Old Wykehamists Vets,7,2,0.0,9
24222641,Old Wykehamists,KCS Old Boys,4,3,4.0,7
24140962,Old Cholmeleians,Old Brentwoods,2,3,4.0,5
24140972,Old Johnians,Old Rugbeians,2,5,2.0,7
24215479,Old Westminsters,Old Berkhamstedians,5,2,2.0,7
24220971,Old Aldenhamians,Old Chigwellians II,3,2,4.0,5
24220953,Old Malvernians,Old Sennockians,2,0,2.0,2
24222139,Old Merchant Taylors,Old Ardinians,1,2,4.0,3
23786220,Old Brentwoods II,Kings College Wimbledon II,2,6,2.0,8
24222118,Old Shirburnians,Old Epsomians,2,2,5.0,4
23786219,Old Carthusians II,Old Tonbridgians II,1,1,4.0,2
24141012,Old Wellingtonians,Old Stoics,8,2,0.0,10
23786229,Old Cheltonians,Old Brentwoods IV,0,2,2.0,2
24602105,Old Reptonians,Old Carthusians,0,0,4.0,0
24615264,Old Kimboltonians,Old Alleynians II,1,2,4.0,3
24602203,Old Brentwoods III,Old Haberdashers,2,4,3.0,6
24621039,Old Etonians Vets,Lancing Old Boys Vets,6,0,0.0,6
24220942,Old Aldenhamians,Old Malvernians,5,2,2.0,7
24220943,Old Radleians,Old Sennockians,4,0,1.0,4
24215451,Old Bradfieldians,Old Cholmeleians,2,4,3.0,6
24215465,Old Carthusians,Old Reptonians,2,0,2.0,2
24215440,Old Etonians,Old Brentwoods,1,5,2.0,6
24215402,Old Alleynians,KCS Old Boys,6,3,3.0,9
24239812,Old Berkhamstedians,Lancing Old Boys,2,1,4.0,3
24239814,Old Rugbeians,Old Foresters,0,1,3.0,1
24215561,Old Salopians,Old Westminsters,0,4,1.0,4
24220981,Old Malvernians,Old Alleynians II,3,3,5.0,6
24220945,Old Kimboltonians,Old Aldenhamians,2,1,4.0,3
24220979,Old Radleians,Old Cholmeleians II,1,0,3.0,1
24220955,Old Etonians II,Old Sennockians,1,3,3.0,4
24222195,Kings College Wimbledon II,Old Shirburnians,2,4,3.0,6
24222130,Old Carthusians II,Old Merchant Taylors,3,2,4.0,5
24222196,Old Albanians,Old Ardinians,3,3,5.0,6
23785745,Old Stoics,Old Brentwoods III,0,4,1.0,4
24222263,Old Harrovians III,Old Haberdashers,1,7,0.0,8
24222368,Old Westminsters II,Lancing Old Boys II,5,0,0.0,5
24222430,Old Kingstonians,Old Brentwoods IV,1,3,3.0,4
24222360,Old Oundelians,Old Eastbournians,1,3,3.0,4
24220972,Old Etonians II,Old Alleynians II,3,0,2.0,3
24221876,Old Alleynians,Old Brentwoods,1,3,3.0,4
24222161,Kings College Wimbledon II,Old Alleynians III,6,1,0.0,7
24239842,Old Carthusians,Old Cholmeleians,4,1,2.0,5
24222288,Old Haberdashers,Old King's Scholars,5,2,2.0,7
24620898,Old Malvernians Vets,Old Salopians Vets,0,4,1.0,4
24613318,Old Malvernians Vets,Old Salopians Vets,0,4,1.0,4
24215414,KCS Old Boys,Old Bradfieldians,3,2,4.0,5
24215471,Old Alleynians,Old Wykehamists,7,1,0.0,8
24222630,Old Reptonians,Old Carthusians,1,3,3.0,4
24215449,Old Brentwoods,Old Cholmeleians,1,2,4.0,3
24215533,Old Chigwellians,Old Marlburians,1,2,4.0,3
24215498,Old Harrovians,Old Foresters,1,3,3.0,4
24215564,Old Rugbeians,Old Westminsters,1,2,4.0,3
24220969,Old Chigwellians II,Old Malvernians,2,3,4.0,5
24222124,Old Epsomians,Kings College Wimbledon II,2,1,4.0,3
24254085,Old Alleynians III,Old Carthusians II,2,5,2.0,7
24222114,Old Ardinians,Old Merchant Taylors,2,1,4.0,3
24222191,Old Brentwoods II,Old Tonbridgians II,4,3,4.0,7
24222292,Old King's Scholars,Old Brentwoods III,2,7,0.0,9
24222356,Old Cheltonians,Old Eastbournians,4,1,2.0,5
24587665,Old Etonians II,Old Kimboltonians,2,3,4.0,5
24572429,Old Cholmeleians II,Old Alleynians II,1,3,3.0,4
24222639,KCS Old Boys,Old Carthusians,0,1,3.0,1
24215466,Old Alleynians,Old Tonbridgians,0,2,2.0,2
24215543,Old Harrovians,Old Rugbeians,5,3,4.0,8
24215563,Old Johnians,Old Westminsters,5,3,4.0,8
24220976,Old Cholmeleians II,Old Kimboltonians,1,2,4.0,3
24220958,Old Chigwellians II,Old Alleynians II,6,4,4.0,10
24239884,Old Sennockians,Old Malvernians,2,3,4.0,5
24220947,Old Harrovians II,Old Etonians II,1,2,4.0,3
24222188,Kings College Wimbledon II,Old Ardinians,2,4,3.0,6
24222182,Old Epsomians,Old Carthusians II,0,5,0.0,5
24222111,Old Tonbridgians II,Old Albanians,2,6,2.0,8
24222283,Old King's Scholars,Old Wellingtonians,0,0,4.0,0
24240047,Old Amplefordians,Old Brentwoods III,1,5,2.0,6
24222426,Old Eastbournians,Old Cheltonians,0,1,3.0,1
24222428,Lancing Old Boys II,Old Kingstonians,2,12,1.0,14
24510057,Old Reptonians,Old Foresters,2,1,4.0,3
24572183,Old Westminsters II,Old Haberdashers,2,3,4.0,5
24555119,Old Brentwoods III,Old Amplefordians,5,1,2.0,6
24442748,Old Etonians Vets,Old Aldenhamians Vets,5,0,0.0,5
24215470,Old Cholmeleians,Old Wykehamists,5,1,2.0,6
24215453,Old Reptonians,Old Etonians,5,2,2.0,7
24215515,Old Johnians,Old Harrovians,7,1,0.0,8
24215557,Old Marlburians,Old Westminsters,1,3,3.0,4
24140993,Old Kimboltonians,Old Cholmeleians II,1,3,3.0,4
24220962,Old Aldenhamians,Old Harrovians II,2,3,4.0,5
24222186,Old Shirburnians,Old Alleynians III,3,0,2.0,3
24222200,Old Carthusians II,Old Epsomians,4,5,5.0,9
24222318,Old Haberdashers,Old Berkhamstedians II,4,2,3.0,6
24222408,Old Westminsters II,Old Salopians II,8,0,0.0,8
24534443,Old Carthusians,Old Brentwoods,2,0,2.0,2
24509707,Old Tonbridgians II,Old Etonians II,1,4,2.0,5
24215400,Old Cholmeleians,KCS Old Boys,2,1,4.0,3
24215410,Old Bradfieldians,Old Alleynians,6,3,3.0,9
24215444,Old Tonbridgians,Old Carthusians,2,5,2.0,7
24239815,Old Marlburians,Old Johnians,3,2,4.0,5
24215499,Old Salopians,Old Foresters,0,4,1.0,4
24194596,Lancing Old Boys,Old Westminsters,2,3,4.0,5
24220964,Old Kimboltonians,Old Chigwellians II,4,4,6.0,8
24220968,Old Radleians,Old Harrovians II,1,0,3.0,1
24222180,Old Carthusians II,Old Alleynians III,8,0,0.0,8
24140980,Kings College Wimbledon II,Old Epsomians,2,2,5.0,4
24222181,Old Albanians,Old Shirburnians,0,2,2.0,2
24222324,Old King's Scholars,Old Berkhamstedians II,1,2,4.0,3
24222314,Old Haberdashers,Old Wellingtonians,10,1,0.0,11
24222348,Old Salopians II,Old Brentwoods IV,0,5,0.0,5
24540985,Old Cholmeleians II,Old Ardinians,3,0,2.0,3
24509994,Old Alleynians II,Old Brentwoods III,2,1,4.0,3
24535359,Old Westminsters II,Old Harrovians III,5,0,0.0,5
24421580,Bealonians,Old Brentwoods,2,1,4.0,3
24439515,Bealonians VII,Old Merchant Taylors II,4,5,5.0,9
24500307,Kings Old Boys,Old Rugbeians,0,1,3.0,1
24540260,Old Reptonians Vets,Old Cholmeleians Vets,1,3,3.0,4
24215469,Old Etonians,Old Wykehamists,3,1,3.0,4
24215398,Old Carthusians,KCS Old Boys,1,2,4.0,3
24215441,Old Brentwoods,Old Alleynians,2,2,5.0,4
24215450,Old Reptonians,Old Cholmeleians,2,1,4.0,3
24215542,Old Foresters,Old Rugbeians,3,1,3.0,4
24239813,Old Harrovians,Lancing Old Boys,2,3,4.0,5
24215547,Old Berkhamstedians,Old Westminsters,3,2,4.0,5
24220952,Old Kimboltonians,Old Radleians,2,6,2.0,8
24220965,Old Sennockians,Old Cholmeleians II,2,1,4.0,3
24239895,Old Aldenhamians,Old Etonians II,0,5,0.0,5
23786197,Old Chigwellians II,Old Harrovians II,3,1,3.0,4
24140981,Old Carthusians II,Old Ardinians,1,5,2.0,6
24222159,Old Epsomians,Old Merchant Taylors,1,4,2.0,5
24222160,Old Albanians,Old Tonbridgians II,3,1,3.0,4
24222321,Old Stoics,Old King's Scholars,1,3,3.0,4
24222358,Old Brentwoods IV,Old Kingstonians,1,2,4.0,3
24482921,Old Amplefordians,Old Berkhamstedians II,3,3,5.0,6
24472479,Old Foresters Vets,Old Brentwoods Vets,2,2,5.0,4
24215463,Old Wykehamists,Old Reptonians,1,3,3.0,4
24215399,Old Tonbridgians,KCS Old Boys,5,0,0.0,5
24215455,Old Brentwoods,Old Etonians,1,2,4.0,3
24221871,Old Westminsters,Old Marlburians,2,0,2.0,2
24215541,Old Berkhamstedians,Old Rugbeians,3,3,5.0,6
24215516,Old Foresters,Old Harrovians,8,0,0.0,8
24220959,Old Etonians II,Old Kimboltonians,4,2,3.0,6
24220960,Old Cholmeleians II,Old Malvernians,3,2,4.0,5
24220961,Old Alleynians II,Old Radleians,0,0,4.0,0
24222156,Old Epsomians,Old Alleynians III,1,1,4.0,2
24222131,Kings College Wimbledon II,Old Brentwoods II,2,2,5.0,4
24239908,Old Merchant Taylors,Old Carthusians II,1,3,3.0,4
24222149,Old Shirburnians,Old Tonbridgians II,1,2,4.0,3
24222294,Old Wellingtonians,Old Berkhamstedians II,2,2,5.0,4
24222290,Old Haberdashers,Old Amplefordians,5,0,0.0,5
24222372,Old Westminsters II,Old Brentwoods IV,4,0,1.0,4
24381740,Old Carthusians,Old Salopians,5,1,2.0,6
24427038,Old Harrovians III,Lancing Old Boys II,3,2,4.0,5
23954929,Old Ardinians,Old Haberdashers,10,2,0.0,12
24215416,Old Etonians,Old Bradfieldians,1,0,3.0,1
24222611,Old Tonbridgians,Old Alleynians,2,6,2.0,8
24215528,Lancing Old Boys,Old Marlburians,1,5,2.0,6
24215545,Old Johnians,Old Salopians,2,3,4.0,5
24215483,Old Rugbeians,Old Chigwellians,4,3,4.0,7
24220984,Old Chigwellians II,Old Aldenhamians,2,0,2.0,2
24222185,Old Merchant Taylors,Old Alleynians III,3,0,2.0,3
24222135,Old Albanians,Kings College Wimbledon II,2,1,4.0,3
24076663,Old Wellingtonians,Old King's Scholars,1,4,2.0,5
24222285,Old Amplefordians,Old Harrovians III,0,1,3.0,1
24222406,Old Cheltonians,Lancing Old Boys II,3,0,2.0,3
24222367,Old Oundelians,Old Brentwoods IV,2,7,0.0,9
24222401,Old Kingstonians,Old Westminsters II,0,2,2.0,2
24398093,Old Reptonians,KCS Old Boys,4,1,2.0,5
24397061,Old Westminsters,Old Brentwoods,1,8,0.0,9
24418415,Old Radleians,Old Foresters,1,4,2.0,5
24482923,Old Carthusians II,Old Kimboltonians,2,2,5.0,4
24441272,Old Sennockians,Old Brentwoods III,2,3,4.0,5
24460765,Old Alleynians II,Old Berkhamstedians II,0,0,4.0,0
24466500,Old Brentwoods II,Old Cholmeleians II,1,4,2.0,5
24483120,Old Etonians II,Old Harrovians II,4,2,3.0,6
24482983,Old Stoics,Old Haberdashers,1,4,2.0,5
24215413,Old Carthusians,Old Bradfieldians,2,2,5.0,4
24215434,Old Reptonians,Old Brentwoods,1,1,4.0,2
24215411,Old Cholmeleians,Old Alleynians,4,4,6.0,8
24215476,Old Westminsters,Lancing Old Boys,1,0,3.0,1
24215526,Old Berkhamstedians,Old Marlburians,2,3,4.0,5
24215492,Old Foresters,Old Chigwellians,3,2,4.0,5
24220957,Old Radleians,Old Malvernians,4,5,5.0,9
24220956,Old Aldenhamians,Old Cholmeleians II,0,3,2.0,3
24222138,Old Brentwoods II,Old Shirburnians,3,1,3.0,4
24222143,Kings College Wimbledon II,Old Merchant Taylors,6,2,2.0,8
24222136,Old Epsomians,Old Tonbridgians II,2,3,4.0,5
24222373,Old Salopians II,Old Eastbournians,1,1,4.0,2
24222362,Old Cheltonians,Old Westminsters II,0,1,3.0,1
24466488,Old Harrovians III,Old Kimboltonians,1,4,2.0,5
24221962,Old Harrovians II,Old Brentwoods IV,5,3,4.0,8
23954939,Old Merchant Taylors II,Old Haberdashers,0,1,3.0,1
23954950,Old Wykehamists II,Old Wellingtonians,0,2,2.0,2
24388887,Old Amplefordians,Old Kingstonians,2,1,4.0,3
24396969,Old Owens II,Old Etonians II,4,1,2.0,5
24222640,Old Alleynians,Old Carthusians,1,2,4.0,3
24215415,Old Alleynians,Old Bradfieldians,2,0,2.0,2
24215462,KCS Old Boys,Old Reptonians,0,1,3.0,1
24215432,Old Wykehamists,Old Brentwoods,3,4,4.0,7
24215454,Old Cholmeleians,Old Etonians,0,2,2.0,2
24215521,Old Westminsters,Old Johnians,1,0,3.0,1
24215484,Old Salopians,Old Chigwellians,0,4,1.0,4
24215497,Lancing Old Boys,Old Foresters,0,7,0.0,7
24220954,Old Harrovians II,Old Alleynians II,4,0,1.0,4
24222179,Old Ardinians,Old Epsomians,2,2,5.0,4
24222127,Old Merchant Taylors,Old Albanians,2,0,2.0,2
24222313,Old Brentwoods III,Old King's Scholars,6,1,0.0,7
24222361,Old Brentwoods IV,Lancing Old Boys II,3,4,4.0,7
24222366,Old Kingstonians,Old Salopians II,1,4,2.0,5
24372943,Old Berkhamstedians II,Old Wellingtonians,3,1,3.0,4
24397717,Old Etonians II,Old Cheltonians,2,0,2.0,2
23954926,Old Kimboltonians,Kings College Wimbledon II,5,2,2.0,7
24440051,Old Cholmeleians II,Old Eastbournians,3,1,3.0,4
24440036,Old Brentwoods II,Old Stoics,4,1,2.0,5
24441271,Old Malvernians,Old Carthusians II,0,5,0.0,5
24441281,Old Radleians,Old Tonbridgians II,3,4,4.0,7
24439476,Old Haberdashers,Actonians Association VII,3,4,4.0,7
24416362,Old Carthusians,Dorkinians,5,6,5.0,11
24215464,Old Tonbridgians,Old Reptonians,2,2,5.0,4
24215431,Old Bradfieldians,Old Brentwoods,0,4,1.0,4
24140964,KCS Old Boys,Old Etonians,3,0,2.0,3
24215478,Old Salopians,Old Berkhamstedians,1,3,3.0,4
24215539,Old Chigwellians,Old Rugbeians,0,1,3.0,1
24215504,Lancing Old Boys,Old Harrovians,2,6,2.0,8
24221881,Old Foresters,Old Westminsters,3,2,4.0,5
24220996,Old Kimboltonians,Old Alleynians II,1,4,2.0,5
24220950,Old Etonians II,Old Aldenhamians,6,1,0.0,7
24220948,Old Sennockians,Old Chigwellians II,2,1,4.0,3
24222126,Old Ardinians,Old Carthusians II,6,1,0.0,7
24222155,Kings College Wimbledon II,Old Albanians,2,5,2.0,7
24222125,Old Alleynians III,Old Tonbridgians II,3,1,3.0,4
24222281,Old Amplefordians,Old Ardinians II,1,1,4.0,2
24222282,Old Berkhamstedians II,Old Brentwoods III,1,3,3.0,4
24240049,Old Cheltonians,Old Oundelians,6,0,0.0,6
24222357,Lancing Old Boys II,Old Salopians II,4,0,1.0,4
23954910,Old King's Scholars,Old Eastbournians,2,2,5.0,4
23954934,Old Merchant Taylors,Old Malvernians,2,3,4.0,5
23954906,Old Kingstonians,Old Stoics,2,2,5.0,4
23954928,Old Radleians,Old Epsomians,11,2,1.0,13
24254220,Dorkinians,Old Carthusians,3,2,4.0,5
24380543,Old Alleynians,Old Hamptonians,1,3,3.0,4
24240055,Old Cholmeleians,Shene Old Grammarians,1,2,4.0,3
24422289,Old Haberdashers,East Barnet Old Grammarians IV,6,3,3.0,9
24223938,Old Brentwoods IV,Bealonians VII,1,2,4.0,3
24221462,Old Merchant Taylors II,Bealonians VIII,9,3,0.0,12
24215447,Old Tonbridgians,Old Cholmeleians,2,3,4.0,5
24215461,Old Alleynians,Old Reptonians,1,2,4.0,3
24107283,Old Carthusians,Old Wykehamists,4,2,3.0,6
24215396,Old Etonians,KCS Old Boys,5,3,4.0,8
24215518,Old Salopians,Old Johnians,3,1,3.0,4
24215525,Old Foresters,Old Marlburians,2,0,2.0,2
24215503,Old Berkhamstedians,Old Harrovians,4,6,4.0,10
24215562,Old Chigwellians,Old Westminsters,4,1,2.0,5
24222265,Old Harrovians III,Old King's Scholars,3,1,3.0,4
24222347,Lancing Old Boys II,Old Cheltonians,1,0,3.0,1
23954927,Old Shirburnians,Old Alleynians II,1,5,2.0,6
24372944,Old Westminsters II,Old Tonbridgians II,3,3,5.0,6
23954951,Old Brentwoods IV,Old Berkhamstedians II,1,3,3.0,4
24201397,Old Wilsonians,Old Brentwoods,1,2,4.0,3
24372780,Old Aloysians,Old Rugbeians,1,2,4.0,3
24402119,Kings College Wimbledon II,Old Tenisonians II,0,7,0.0,7
24222427,Old Wykehamists II,Old Oundelians,2,4,3.0,6
24238037,Old Salopians Vets,Old Bradfieldians Vets,1,1,4.0,2
24215459,Old Cholmeleians,Old Reptonians,2,1,4.0,3
24215452,Old Carthusians,Old Etonians,7,0,0.0,7
24215467,Old Wykehamists,Old Tonbridgians,2,7,0.0,9
24215538,Old Salopians,Old Rugbeians,2,5,2.0,7
24215517,Old Foresters,Old Johnians,5,3,4.0,8
24215502,Old Chigwellians,Old Harrovians,3,2,4.0,5
24220974,Old Harrovians II,Old Kimboltonians,1,4,2.0,5
24220951,Old Alleynians II,Old Cholmeleians II,1,4,2.0,5
24222117,Old Brentwoods II,Old Carthusians II,4,3,4.0,7
24222312,Old Ardinians II,Old Berkhamstedians II,3,4,4.0,7
24222323,Old Amplefordians,Old Stoics,1,1,4.0,2
24121590,KCS Old Boys,Old Shirburnians,4,2,3.0,6
24048105,Old Brentwoods,Old Alleynians,3,2,4.0,5
24374753,Old Merchant Taylors,Old Westminsters,2,3,4.0,5
23954932,Old Brentwoods III,Old Chigwellians II,2,1,4.0,3
23954933,Old Alleynians III,Old Sennockians,1,2,4.0,3
23954938,Lancing Old Boys II,Old Oundelians,3,3,5.0,6
23954952,Old Westminsters II,Old Cheltonians,1,1,4.0,2
24360680,Old Meadonians VI,Old Haberdashers,4,8,2.0,12
24215458,Old Brentwoods,Old Reptonians,2,2,5.0,4
24215443,Old Cholmeleians,Old Carthusians,0,7,0.0,7
24215537,Lancing Old Boys,Old Rugbeians,2,3,4.0,5
24220937,Old Harrovians II,Old Cholmeleians II,0,5,0.0,5
24220935,Old Etonians II,Old Chigwellians II,2,2,5.0,4
24220936,Old Kimboltonians,Old Sennockians,3,1,3.0,4
24222066,Old Ardinians,Old Brentwoods II,7,1,0.0,8
24222261,Old King's Scholars,Old Ardinians II,4,4,6.0,8
24222264,Old Berkhamstedians II,Old Amplefordians,3,0,2.0,3
24176719,Old Westminsters,Old Merchant Taylors,1,1,4.0,2
24121500,Old Foresters,Old Aldenhamians,8,1,0.0,9
24121632,Old Salopians,Old Etonians,2,0,2.0,2
23954907,Old Merchant Taylors II,Old Cheltonians,4,5,5.0,9
23954908,Old Harrovians III,Lancing Old Boys II,3,0,2.0,3
23954909,Old Westminsters II,Old Oundelians,3,1,3.0,4
23954911,Old Wykehamists II,Old Wellingtonians,2,2,5.0,4
24140966,Old Cholmeleians,Old Bradfieldians,2,3,4.0,5
24121591,Old Chigwellians,Old Reptonians,0,3,2.0,3
24140954,Old Tonbridgians,Old Bradfieldians,2,3,4.0,5
23786191,Old Chigwellians,Old Berkhamstedians,2,1,4.0,3
24141007,Old Foresters,Lancing Old Boys,5,1,2.0,6
23785497,Old Harrovians,Old Salopians,2,2,5.0,4
23786214,Old Sennockians,Old Alleynians II,2,7,0.0,9
24141008,Old Ardinians,Old Shirburnians,2,1,4.0,3
23786227,Old Ardinians II,Old King's Scholars,4,3,4.0,7
24096906,Old Brentwoods III,Old Amplefordians,3,2,4.0,5
24140965,Old Salopians II,Old Cheltonians,3,2,4.0,5
23774116,Lancing Old Boys II,Old Oundelians,2,2,5.0,4
24231517,Old Meadonians,Old Alleynians,2,3,4.0,5
24231516,Old Blues,Old Carthusians,0,4,1.0,4
24197374,Old Sedcopians,Old Rugbeians,1,3,3.0,4
23786251,Old Kingstonians,Old Wykehamists II,1,0,3.0,1
23949449,Old Carthusians Vets,Old Bradfieldians Vets,0,1,3.0,1
24116862,Old Chigwellians Vets Blues,Old Foresters Vets,3,4,4.0,7
23786053,Old Bradfieldians,KCS Old Boys,2,6,2.0,8
23786062,Old Brentwoods,Old Wykehamists,1,2,4.0,3
23786054,Old Etonians,Old Tonbridgians,3,2,4.0,5
23786081,Old Johnians,Lancing Old Boys,2,1,4.0,3
23786082,Old Chigwellians,Old Salopians,9,0,0.0,9
23786074,Old Marlburians,Old Foresters,1,3,3.0,4
23786073,Old Harrovians,Old Westminsters,2,5,2.0,7
23786196,Old Cholmeleians II,Old Radleians,4,3,4.0,7
24048167,Old Alleynians II,Old Aldenhamians,2,0,2.0,2
23773845,Old Chigwellians II,Old Etonians II,2,1,4.0,3
23786195,Old Harrovians II,Old Sennockians,1,4,2.0,5
24141002,Old Ardinians,Old Alleynians III,5,0,0.0,5
23786215,Old Epsomians,Old Brentwoods II,4,1,2.0,5
23786218,Old Merchant Taylors,Old Shirburnians,1,4,2.0,5
24141003,Old Carthusians II,Old Albanians,2,3,4.0,5
23786223,Old Amplefordians,Old Wellingtonians,1,5,2.0,6
23786222,Old Brentwoods III,Old Stoics,4,0,1.0,4
23786221,Old Berkhamstedians II,Old Harrovians III,2,0,2.0,2
23786231,Old Eastbournians,Old Oundelians,2,1,4.0,3
24193555,Old Cholmeleians,Hale End Athletic,3,0,2.0,3
24231593,Polytechnic Vets,Old Chigwellians Vets Blues,0,3,2.0,3
24197375,Old Carthusians,Old Salvatorians,5,0,0.0,5
24188875,Old Wokingians,Old Reptonians,4,0,1.0,4
23949457,Old Wykehamists Vets,Old Brentwoods Vets,0,2,2.0,2
24140989,Old Wykehamists,Old Alleynians,2,7,0.0,9
24076670,Old Etonians,Old Reptonians,1,1,4.0,2
24076667,KCS Old Boys,Old Brentwoods,2,1,4.0,3
24076669,Old Bradfieldians,Old Tonbridgians,1,0,3.0,1
23785513,Old Salopians,Lancing Old Boys,3,1,3.0,4
24048165,Old Berkhamstedians,Old Foresters,2,5,2.0,7
23785519,Old Harrovians,Old Johnians,5,4,5.0,9
23785511,Old Rugbeians,Old Marlburians,0,2,2.0,2
23785522,Old Westminsters,Old Chigwellians,2,3,4.0,5
23785628,Old Chigwellians II,Old Kimboltonians,2,2,5.0,4
23785626,Old Sennockians,Old Aldenhamians,1,4,2.0,5
23785624,Old Cholmeleians II,Old Etonians II,1,3,3.0,4
23785625,Old Malvernians,Old Harrovians II,3,5,4.0,8
23925612,Old Ardinians,Kings College Wimbledon II,6,2,2.0,8
23785651,Old Albanians,Old Brentwoods II,4,0,1.0,4
23785652,Old Alleynians III,Old Merchant Taylors,2,1,4.0,3
23785877,Old Berkhamstedians II,Old Ardinians II,9,1,0.0,10
23785853,Old Haberdashers,Old Brentwoods III,4,1,2.0,5
23785866,Old Wellingtonians,Old Harrovians III,4,8,2.0,12
23785865,Old King's Scholars,Old Amplefordians,3,3,5.0,6
23786030,Old Westminsters II,Old Kingstonians,2,4,3.0,6
23786027,Old Oundelians,Old Cheltonians,0,8,0.0,8
23774120,Old Eastbournians,Old Salopians II,0,3,2.0,3
24152936,Bromleians,Old Carthusians,0,7,0.0,7
24231602,Halstead Town Vets,Old Chigwellians Vets Blues,2,3,4.0,5
24152946,Canning Town Vets,Old Chigwellians Vets Blues,5,3,4.0,8
23837661,Old Parmiterians VII,Old Brentwoods IV,2,7,0.0,9
24197379,Economicals III,Old Epsomians,2,1,4.0,3
23786029,Lancing Old Boys II,Old Wykehamists II,5,2,2.0,7
23949452,Lancing Old Boys Vets,Old Malvernians Vets,4,2,3.0,6
24107282,Old Reptonians,Old Bradfieldians,8,0,0.0,8
23785487,KCS Old Boys,Old Alleynians,4,4,6.0,8
24096852,Old Johnians,Old Berkhamstedians,3,2,4.0,5
24048164,Old Marlburians,Old Salopians,2,1,4.0,3
24048159,Lancing Old Boys,Old Chigwellians,0,1,3.0,1
24048160,Old Westminsters,Old Harrovians,2,0,2.0,2
23785619,Old Harrovians II,Old Radleians,0,5,0.0,5
23785617,Old Alleynians II,Old Sennockians,1,2,4.0,3
23785648,Old Epsomians,Old Shirburnians,5,0,0.0,5
23785647,Old Ardinians,Old Albanians,3,0,2.0,3
24115347,Old Harrovians III,Old Ardinians II,2,3,4.0,5
24096903,Old Berkhamstedians II,Old Wellingtonians,9,1,0.0,10
23786025,Old Kingstonians,Lancing Old Boys II,3,3,5.0,6
23786014,Old Brentwoods IV,Old Cheltonians,2,8,0.0,10
23786018,Old Salopians II,Old Oundelians,3,2,4.0,5
23786017,Old Eastbournians,Old Westminsters II,0,2,2.0,2
24092599,Old Cholmeleians,Old Carthusians,1,4,2.0,5
24111773,Old King's Scholars,Old Meadonians IV,0,1,3.0,1
24178512,Old Blues,Old Brentwoods,0,1,3.0,1
24070035,Old Rugbeians,Old Strand Academicals,4,1,2.0,5
23968292,Old Thorntonians IV,Kings College Wimbledon II,1,5,2.0,6
23949454,Old Tonbridgians Vets,Old Reptonians Vets,1,3,3.0,4
24076650,Old Tonbridgians,Old Etonians,3,1,3.0,4
23785500,Old Marlburians,Lancing Old Boys,3,1,3.0,4
23785498,Old Rugbeians,Old Johnians,1,3,3.0,4
23786192,Old Foresters,Old Salopians,5,3,4.0,8
23971044,Old Sennockians,Old Kimboltonians,2,4,3.0,6
23891543,Old Aldenhamians,Old Alleynians II,1,3,3.0,4
23785605,Old Malvernians,Old Etonians II,2,5,2.0,7
23785603,Old Radleians,Old Chigwellians II,1,2,4.0,3
23785641,Old Shirburnians,Old Carthusians II,4,2,3.0,6
23785645,Old Alleynians III,Old Albanians,3,5,4.0,8
23912201,Old Brentwoods II,Old Merchant Taylors,1,3,3.0,4
23912196,Old Ardinians,Old Tonbridgians II,2,0,2.0,2
24096893,Old Ardinians II,Old Wellingtonians,0,5,0.0,5
24115344,Old Stoics,Old Berkhamstedians II,1,3,3.0,4
23785669,Old Brentwoods III,Old Harrovians III,6,3,3.0,9
23786012,Old Salopians II,Old Kingstonians,1,2,4.0,3
23786011,Lancing Old Boys II,Old Eastbournians,1,2,4.0,3
24144172,Old Berkhamstedians,Old Westminsters,2,5,2.0,7
24026293,Old Cholmeleians,Leyton County Old Boys,2,1,4.0,3
24026294,Richmond & Kew SSEC,Old Chigwellians,5,3,4.0,8
24026297,Old Cholmeleians II,Fulham Compton Old Boys II,1,4,2.0,5
24096609,St. James' Old Boys IV,Old Brentwoods IV,0,8,0.0,8
24026298,Actonians Association VIII,Old Haberdashers,1,11,0.0,12
24026312,Old Chigwellians Vets Blues,Croxley Green Vets,3,0,2.0,3
24152944,Atletico Trotters Vets,Old Chigwellians Vets Blues,2,5,2.0,7
24042761,Enfield Old Grammarians,Old Brentwoods,2,4,3.0,6
24070006,Old Minchendenians,Old Carthusians,2,4,3.0,6
24070005,Old Suttonians,Old Alleynians,4,3,4.0,7
24048157,Old Oundelians,Old Wykehamists II,3,1,3.0,4
23785468,Old Bradfieldians,Old Wykehamists,2,2,5.0,4
23785465,Old Alleynians,Old Etonians,2,3,4.0,5
23785467,Old Reptonians,Old Tonbridgians,4,3,4.0,7
23785496,Old Rugbeians,Old Berkhamstedians,4,2,3.0,6
24014047,Old Chigwellians,Old Johnians,1,5,2.0,6
23785493,Old Harrovians,Old Marlburians,4,2,3.0,6
23785599,Old Sennockians,Old Radleians,2,6,2.0,8
23785598,Old Kimboltonians,Old Malvernians,2,2,5.0,4
23785590,Old Cholmeleians II,Old Chigwellians II,0,3,2.0,3
23925606,Old Carthusians II,Old Brentwoods II,0,6,0.0,6
23785637,Old Shirburnians,Old Albanians,3,4,4.0,7
23785658,Old Brentwoods III,Old Ardinians II,9,0,0.0,9
23875023,Old Amplefordians,Old Berkhamstedians II,3,3,5.0,6
24076661,Old King's Scholars,Old Stoics,2,1,4.0,3
23785659,Old Haberdashers,Old Harrovians III,2,0,2.0,2
23911886,Old Eastbournians,Old Brentwoods IV,1,3,3.0,4
23786005,Old Kingstonians,Old Oundelians,3,2,4.0,5
23925613,Lancing Old Boys II,Old Westminsters II,3,4,4.0,7
23968303,Icarus,Old Ardinians,2,0,2.0,2
23968305,Old Meadonians,Old Foresters,3,2,4.0,5
23837648,Old Minchendenians II,Old Etonians II,1,3,3.0,4
23837649,Old Woodhouseians II,Old Merchant Taylors,3,1,3.0,4
23904799,Old Wykehamists,Old Cholmeleians,3,3,5.0,6
24067055,Old Brentwoods,Old Tonbridgians,2,1,4.0,3
24002446,Lancing Old Boys,Old Berkhamstedians,0,4,1.0,4
23773766,Old Johnians,Old Marlburians,2,1,4.0,3
23785505,Old Westminsters,Old Salopians,1,0,3.0,1
23523098,Old Radleians,Old Aldenhamians,4,2,3.0,6
24002453,Old Etonians II,Old Cholmeleians II,7,1,0.0,8
24002454,Old Malvernians,Old Chigwellians II,3,2,4.0,5
23773844,Old Alleynians II,Old Harrovians II,2,0,2.0,2
23773917,Old Tonbridgians II,Old Alleynians III,2,5,2.0,7
24002456,Old Shirburnians,Kings College Wimbledon II,1,2,4.0,3
23773910,Old Albanians,Old Merchant Taylors,8,4,2.0,12
23773989,Old Wellingtonians,Old Haberdashers,3,3,5.0,6
23773988,Old Amplefordians,Old King's Scholars,3,5,4.0,8
23785743,Old Berkhamstedians II,Old Stoics,1,2,4.0,3
23773987,Old Ardinians II,Old Harrovians III,1,3,3.0,4
23774126,Old Oundelians,Old Westminsters II,0,4,1.0,4
23562218,Old Bradfieldians,KCS Old Boys,1,5,2.0,6
23562213,Old Reptonians,Old Rugbeians,2,1,4.0,3
23562220,Old Chigwellians,Old Eastbournians,13,0,1.0,13
24107081,Old Foresters,Old Ardinians,4,2,3.0,6
23562210,Old Kimboltonians,Old Etonians,1,3,3.0,4
24026280,Old Alleynians,Fulham Compton Old Boys,3,2,4.0,5
24026281,Old Carthusians,Richmond & Kew SAL,4,0,1.0,4
23837655,Southgate County III,Old Brentwoods II,4,1,2.0,5
23837656,Old Brentwoods III,Old Parkonians IV,1,4,2.0,5
23837657,Old Epsomians,Old Suttonians IV,0,3,2.0,3
23774134,Old Salopians II,Old Wykehamists II,1,0,3.0,1
23522924,Old Tonbridgians,Old Wykehamists,1,2,4.0,3
24006547,Old Reptonians,Old Alleynians,1,3,3.0,4
24006549,Old Etonians,Old Carthusians,2,6,2.0,8
23773758,Old Marlburians,Old Rugbeians,3,2,4.0,5
24006597,Lancing Old Boys,Old Johnians,0,2,2.0,2
24008696,Old Aldenhamians,Old Kimboltonians,5,3,4.0,8
23773827,Old Radleians,Old Alleynians II,4,4,6.0,8
24006587,Old Sennockians,Old Etonians II,0,0,4.0,0
23773829,Old Harrovians II,Old Chigwellians II,2,2,5.0,4
23773897,Old Alleynians III,Kings College Wimbledon II,5,2,2.0,7
24044589,Old Albanians,Old Epsomians,1,2,4.0,3
23773908,Old Merchant Taylors,Old Tonbridgians II,1,3,3.0,4
23773980,Old Stoics,Old Haberdashers,2,3,4.0,5
23773978,Old Harrovians III,Old Wellingtonians,3,2,4.0,5
23774108,Old Kingstonians,Old Cheltonians,1,3,3.0,4
23786244,Old Oundelians,Lancing Old Boys II,6,2,2.0,8
23774122,Old Brentwoods IV,Old Westminsters II,3,3,5.0,6
23562209,Old Westminsters,Old Berkhamstedians,2,2,5.0,4
23562215,Old Harrovians,Old Shirburnians,1,5,2.0,6
23568919,Old Cholmeleians,Old Malvernians,2,1,4.0,3
23562211,Old Amplefordians,Old Salopians,1,2,4.0,3
23968313,Old Carthusians II,Old Thorntonians III,1,2,4.0,3
24026275,Old Blues II,Old King's Scholars,0,2,2.0,2
23970904,Old Bradfieldians,Old Etonians,1,1,4.0,2
23987840,Old Cholmeleians,Old Tonbridgians,4,2,3.0,6
23785514,Old Foresters,Old Berkhamstedians,2,2,5.0,4
23773740,Old Marlburians,Old Chigwellians,2,5,2.0,7
24006537,Old Salopians,Old Harrovians,1,2,4.0,3
23773805,Old Malvernians,Old Radleians,2,2,5.0,4
23988411,Old Alleynians II,Old Etonians II,3,2,4.0,5
23773811,Old Cholmeleians II,Old Harrovians II,1,3,3.0,4
23773887,Old Merchant Taylors,Old Brentwoods II,0,1,3.0,1
23773895,Old Tonbridgians II,Old Shirburnians,1,7,0.0,8
23773889,Old Alleynians III,Old Epsomians,1,2,4.0,3
23773888,Kings College Wimbledon II,Old Carthusians II,2,2,5.0,4
23773971,Old Haberdashers,Old Ardinians II,6,3,3.0,9
23786224,Old Wellingtonians,Old Brentwoods III,4,2,3.0,6
23786226,Old Harrovians III,Old Stoics,7,1,0.0,8
23774104,Old Westminsters II,Old Eastbournians,2,1,4.0,3
23774103,Old Cheltonians,Old Salopians II,3,1,3.0,4
24006546,Old Brentwoods IV,Old Oundelians,4,2,3.0,6
23562219,Old Aldenhamians,Old Kingstonians,5,1,2.0,6
23562208,Lancing Old Boys,Old Brentwoods,2,8,0.0,10
23562217,Old Wykehamists,Old Sennockians,1,2,4.0,3
23968288,KCS Old Boys,Glyn Old Boys,2,4,3.0,6
23969942,Old Alleynians,Reigatians,5,1,2.0,6
23968287,Old Reptonians,UCL Academicals,7,2,0.0,9
23968289,Rob Roy Rovers,Old Carthusians,0,3,2.0,3
23968291,Old Pauline,Old Rugbeians,2,3,4.0,5
23970906,Old Johnians,Shene Old Grammarians,1,2,4.0,3
23773713,Old Bradfieldians,Old Reptonians,2,4,3.0,6
23969950,Old Carthusians,Old Brentwoods,5,2,2.0,7
23773712,KCS Old Boys,Old Wykehamists,8,1,0.0,9
23773710,Old Etonians,Old Cholmeleians,3,0,2.0,3
23773736,Old Berkhamstedians,Old Salopians,2,3,4.0,5
23773737,Old Harrovians,Old Chigwellians,2,4,3.0,6
23785609,Old Cholmeleians II,Old Alleynians II,2,2,5.0,4
23909473,Old Harrovians II,Old Malvernians,2,2,5.0,4
23810068,Old Kimboltonians,Old Etonians II,2,3,4.0,5
23773880,Old Brentwoods II,Old Alleynians III,2,6,2.0,8
23773879,Old Tonbridgians II,Old Carthusians II,2,5,2.0,7
23773881,Old Epsomians,Old Albanians,3,3,5.0,6
23773873,Old Shirburnians,Old Merchant Taylors,0,1,3.0,1
23773952,Old Harrovians III,Old Berkhamstedians II,3,3,5.0,6
23773950,Old Ardinians II,Old Stoics,5,1,2.0,6
23992270,Old Wellingtonians,Old Amplefordians,2,4,3.0,6
23774090,Old Salopians II,Lancing Old Boys II,3,2,4.0,5
23562216,Old Alleynians,Old Tonbridgians,6,0,0.0,6
23968307,Old Westminsters,Rob Roy Rovers,1,4,2.0,5
23968309,Kings College Wimbledon II,City of London,3,6,3.0,9
23968310,Old Parmiterians II,Old Chigwellians II,3,2,4.0,5
23968311,Old Aldenhamians,Reigatians II,2,3,4.0,5
23968315,Old Parkonians VI,Old Brentwoods IV,4,5,5.0,9
23968316,Albanian V,Old Haberdashers,0,4,1.0,4
23968318,Old Foresters,Earls Colne,3,5,4.0,8
23774091,Old Westminsters II,Old Wykehamists II,4,0,1.0,4
23841919,Old Wykehamists,Old Bradfieldians,1,3,3.0,4
23773705,Old Brentwoods,KCS Old Boys,1,3,3.0,4
23773733,Old Berkhamstedians,Old Johnians,0,3,2.0,3
23773734,Old Rugbeians,Old Salopians,1,0,3.0,1
23841921,Old Marlburians,Old Harrovians,3,1,3.0,4
23810146,Old Alleynians II,Old Kimboltonians,2,7,0.0,9
23773780,Old Chigwellians II,Old Radleians,0,8,0.0,8
23925599,Old Malvernians,Old Cholmeleians II,4,3,4.0,7
23785596,Old Etonians II,Old Harrovians II,2,2,5.0,4
23773863,Old Albanians,Old Alleynians III,2,7,0.0,9
23773871,Old Shirburnians,Old Brentwoods II,3,0,2.0,3
23773870,Old Merchant Taylors,Old Epsomians,2,1,4.0,3
23773864,Kings College Wimbledon II,Old Tonbridgians II,1,1,4.0,2
23773944,Old Stoics,Old Wellingtonians,5,1,2.0,6
23925604,Old Harrovians III,Old Brentwoods III,0,2,2.0,2
23773942,Old Ardinians II,Old Amplefordians,3,1,3.0,4
23904797,Old Brentwoods IV,Old Salopians II,0,7,0.0,7
23774077,Old Cheltonians,Old Kingstonians,0,0,4.0,0
23774075,Old Westminsters II,Old Oundelians,2,2,5.0,4
23968306,Spaniards,Old Chigwellians,0,4,1.0,4
23837610,Old Etonians,Alleyn Old Boys,0,4,1.0,4
23837577,Old Owens,Old Foresters,3,1,3.0,4
23543987,Old Tonbridgians,Old Brentwoods,1,5,2.0,6
23522940,Old Bradfieldians,Old Carthusians,1,1,4.0,2
23522939,Old Reptonians,Old Wykehamists,6,0,0.0,6
23522941,Old Etonians,Old Alleynians,1,3,3.0,4
23535286,KCS Old Boys,Old Cholmeleians,2,0,2.0,2
23522972,Old Harrovians,Old Berkhamstedians,4,4,6.0,8
23522980,Old Westminsters,Old Rugbeians,4,1,2.0,5
23522971,Old Chigwellians,Lancing Old Boys,2,0,2.0,2
23538728,Old Salopians,Old Marlburians,5,1,2.0,6
23522979,Old Johnians,Old Foresters,2,5,2.0,7
23538686,Old Alleynians II,Old Malvernians,1,3,3.0,4
23523383,Old Radleians,Old Etonians II,3,1,3.0,4
23523382,Old Kimboltonians,Old Harrovians II,3,1,3.0,4
23535287,Old Aldenhamians,Old Sennockians,3,3,5.0,6
23523512,Old Alleynians III,Old Ardinians,1,6,0.0,7
23523514,Old Carthusians II,Old Shirburnians,8,0,0.0,8
23523505,Old Merchant Taylors,Kings College Wimbledon II,2,0,2.0,2
23523513,Old Brentwoods II,Old Albanians,2,4,3.0,6
23523569,Old Wellingtonians,Old Ardinians II,9,5,3.0,14
23523570,Old King's Scholars,Old Haberdashers,2,1,4.0,3
23523542,Old Harrovians III,Old Amplefordians,1,1,4.0,2
23523949,Old Westminsters II,Old Cheltonians,5,3,4.0,8
23523868,Lancing Old Boys II,Old Brentwoods IV,3,2,4.0,5
23968317,Old Epsomians,Earlsfield United,2,9,0.0,11
23523953,Old Wykehamists II,Old Salopians II,3,4,4.0,7
23522932,Old Brentwoods,Old Bradfieldians,6,1,0.0,7
23538723,Old Reptonians,KCS Old Boys,0,2,2.0,2
23522931,Old Alleynians,Old Cholmeleians,6,0,0.0,6
23522934,Old Wykehamists,Old Etonians,1,1,4.0,2
23522933,Old Carthusians,Old Tonbridgians,5,6,5.0,11
23522962,Old Marlburians,Old Berkhamstedians,3,4,4.0,7
23522967,Old Westminsters,Old Foresters,0,2,2.0,2
23522954,Lancing Old Boys,Old Salopians,2,3,4.0,5
23522955,Old Johnians,Old Chigwellians,0,2,2.0,2
23522963,Old Rugbeians,Old Harrovians,5,4,5.0,9
23523361,Old Malvernians,Old Kimboltonians,2,2,5.0,4
23523114,Old Harrovians II,Old Aldenhamians,0,1,3.0,1
23523106,Old Alleynians II,Old Chigwellians II,6,0,0.0,6
23523110,Old Cholmeleians II,Old Sennockians,2,1,4.0,3
23902771,Old Tonbridgians II,Old Ardinians,1,8,0.0,9
23543993,Old Alleynians III,Old Shirburnians,3,1,3.0,4
23523475,Old Albanians,Old Carthusians II,4,2,3.0,6
23523538,Old Amplefordians,Old Haberdashers,2,2,5.0,4
23523540,Old Berkhamstedians II,Old King's Scholars,3,5,4.0,8
23523541,Old Stoics,Old Harrovians III,5,1,2.0,6
23523853,Old Oundelians,Old Kingstonians,1,4,2.0,5
23523850,Old Eastbournians,Lancing Old Boys II,1,1,4.0,2
23523861,Old Salopians II,Old Westminsters II,3,4,4.0,7
23523862,Old Wykehamists II,Old Brentwoods IV,2,4,3.0,6
23522872,Old Brentwoods,Old Carthusians,1,1,4.0,2
23522871,KCS Old Boys,Old Tonbridgians,3,0,2.0,3
23522948,Old Berkhamstedians,Old Chigwellians,0,5,0.0,5
23523011,Old Radleians,Old Kimboltonians,2,1,4.0,3
23523007,Old Malvernians,Old Aldenhamians,1,0,3.0,1
23523006,Old Chigwellians II,Old Sennockians,1,0,3.0,1
23523403,Old Shirburnians,Old Ardinians,0,1,3.0,1
23523414,Old Tonbridgians II,Old Merchant Taylors,2,3,4.0,5
23523530,Old Brentwoods III,Old Berkhamstedians II,1,1,4.0,2
23523531,Old Haberdashers,Old Stoics,2,0,2.0,2
23523534,Old King's Scholars,Old Harrovians III,3,2,4.0,5
23523745,Old Kingstonians,Old Eastbournians,4,2,3.0,6
23523749,Old Oundelians,Old Salopians II,0,4,1.0,4
26111257,Old Reptonians,Old Carthusians,0,0,4.0,0
26202289,Old Brentwoods II,Old Haberdashers,6,2,2.0,8
26329400,KCS Old Boys Vets,Old Brentwoods Vets,0,1,3.0,1
26091155,Old Alleynians,Old Cholmeleians,0,1,3.0,1
26110630,KCS Old Boys,Old Carthusians,2,5,2.0,7
26237552,Old Brentwoods,Old Chigwellians,3,0,2.0,3
26091159,Old Johnians,Old Radleians,8,0,0.0,8
26244280,Old Ardinians,Old Cholmeleians II,1,1,4.0,2
26237554,Old Alleynians II,Old Aldenhamians,5,1,2.0,6
26237556,KCS Old Boys II,Old Haberdashers,2,5,2.0,7
26108851,Old Alleynians III,Old Brentwoods II,1,3,3.0,4
26170413,Old Carthusians II,Old Merchant Taylors,1,2,4.0,3
26170419,Old Berkhamstedians II,Old Brentwoods III,3,1,3.0,4
26199272,Old King's Scholars,Old Tonbridgians II,3,5,4.0,8
26265230,Old Foresters,Old Chigwellians,3,4,4.0,7
26234198,Old Salopians Vets,Old Brentwoods Vets,0,2,2.0,2
26110620,Old Chigwellians,Old Bradfieldians,1,5,2.0,6
26110625,Old Etonians,KCS Old Boys,0,2,2.0,2
26205894,Old Foresters,Old Brentwoods,0,0,4.0,0
26180231,Lancing Old Boys,Old Alleynians II,2,10,0.0,12
26199222,Old Cholmeleians II,Old Chigwellians II,7,2,0.0,9
26237555,Old Shirburnians,KCS Old Boys II,3,3,5.0,6
26170421,Old Epsomians,Old Brentwoods II,0,6,0.0,6
26307484,Old Tonbridgians,Old Reptonians,0,1,3.0,1
26307177,Old Aldenhamians,Old Kimboltonians,3,3,5.0,6
26307064,Old Berkhamstedians II,Old Harrovians III,1,0,3.0,1
26091156,Old Chigwellians,Old Brentwoods,2,1,4.0,3
26277505,Old Foresters Vets,Old Carthusians Vets,3,0,2.0,3
26110635,Old Chigwellians,Old Reptonians,3,5,4.0,8
26110633,KCS Old Boys,Old Cholmeleians,1,2,4.0,3
26205884,Old Alleynians,Old Foresters,1,2,4.0,3
26199140,Old Malvernians,Old Rugbeians,0,8,0.0,8
26170428,Old Berkhamstedians,Old Ardinians,5,6,5.0,11
26170440,Old Brentwoods II,KCS Old Boys II,6,0,0.0,6
26111265,Old Merchant Taylors,Old Alleynians III,6,3,3.0,9
26170445,Old Tonbridgians II,Old Brentwoods III,3,4,4.0,7
26170406,Old Bradfieldians,Old Brentwoods,0,4,1.0,4
26110621,Old Reptonians,Old Foresters,1,2,4.0,3
26170422,Old Chigwellians,KCS Old Boys,2,3,4.0,5
26237553,Old Alleynians,Old Etonians,2,3,4.0,5
26216833,Old Radleians,Old Rugbeians,4,4,6.0,8
26170408,Lancing Old Boys,Old Kimboltonians,1,5,2.0,6
26170401,Old Chigwellians II,Old Berkhamstedians,0,7,0.0,7
26112020,Old Ardinians,Old Etonians II,3,0,2.0,3
26170414,Old Epsomians,Old Alleynians III,2,0,2.0,2
26202285,Old Haberdashers,Old Brentwoods II,2,3,4.0,5
26110758,Old Sennockians,Old Carthusians II,1,2,4.0,3
26200800,Old Carthusians,Old Tonbridgians,2,3,4.0,5
26284074,Old Aldenhamians,Old Tonbridgians II,4,1,2.0,5
26302872,Old Harrovians III,Old Brentwoods III,3,2,4.0,5
26256569,Old Berkhamstedians II,Old Brentwoods IV,3,2,4.0,5
26110636,Old Brentwoods,Old Foresters,1,0,3.0,1
26170423,Old Foresters,Old Bradfieldians,3,7,2.0,10
26110631,Old Chigwellians,Old Etonians,2,5,2.0,7
26064419,Old Rugbeians,Old Malvernians,4,1,2.0,5
26110724,Old Johnians,Old Wykehamists,3,3,5.0,6
26110755,Old Cholmeleians II,Lancing Old Boys,5,0,0.0,5
26110728,Old Albanians,Old Etonians II,4,5,5.0,9
26170403,Old Sennockians,Old Alleynians III,0,2,2.0,2
26152695,Old Merchant Taylors,Old Haberdashers,3,2,4.0,5
26254919,Old Shirburnians,Old Brentwoods II,0,2,2.0,2
26237558,Old Brentwoods III,Old Tonbridgians II,1,4,2.0,5
26205178,Old Kingstonians,Old Westminsters II,1,2,4.0,3
26170415,Old Cheltonians,Old Stoics,2,1,4.0,3
26200799,Old Alleynians,Old Reptonians,2,3,4.0,5
26170122,Old Aldenhamians,Old Alleynians II,2,2,5.0,4
26253786,Old Kimboltonians,Old Ardinians,4,4,6.0,8
26224538,Old Etonians Vets,KCS Old Boys Vets,1,3,3.0,4
26274693,Old Wykehamists Vets,Old Harrovians Vets,3,2,4.0,5
26268021,Old Cholmeleians,KCS Old Boys,2,1,4.0,3
26110634,Old Carthusians,Old Etonians,1,2,4.0,3
26110723,Old Radleians,Old Tonbridgians,2,3,4.0,5
26110722,Old Rugbeians,Old Westminsters,4,1,2.0,5
26110753,Old Albanians,Old Aldenhamians,2,5,2.0,7
26170410,Old Berkhamstedians,Old Cholmeleians II,2,0,2.0,2
26170417,Old Chigwellians II,Old Etonians II,2,2,5.0,4
26110764,Old Epsomians,Old Haberdashers,1,0,3.0,1
25918113,Old Carthusians II,Old Brentwoods II,3,4,4.0,7
26110771,Old Brentwoods III,Old Kingstonians,3,4,4.0,7
26110772,Old Oundelians,Old Salopians II,2,7,0.0,9
26195986,Old Meadonians,Old Foresters,3,2,4.0,5
26253906,Old Woodhouseians II,Old Alleynians II,1,0,3.0,1
26140677,Old Parmiterians IV,Old Alleynians III,0,0,4.0,0
26117294,Old Parmiterians VIII,Old Merchant Taylors II,3,2,4.0,5
26110624,Old Cholmeleians,Old Reptonians,0,14,1.0,14
26170398,Old Etonians,Old Brentwoods,1,1,4.0,2
26241650,Old Foresters,Old Carthusians,1,7,0.0,8
26110721,Old Radleians,Old Wykehamists,3,3,5.0,6
26241059,Old Tonbridgians,Old Malvernians,5,1,2.0,6
26110747,Old Aldenhamians,Old Etonians II,1,2,4.0,3
26216821,Old Haberdashers,Old Shirburnians,2,1,4.0,3
25562130,KCS Old Boys II,Old Sennockians,1,0,3.0,1
26239167,Old Ardinians,Old Brentwoods II,2,1,4.0,3
26170287,Old Cholmeleians II,Old Tonbridgians II,0,2,2.0,2
26140308,Old Kimboltonians,Old Chigwellians II,3,2,4.0,5
26170123,Old Harrovians III,Old Canfordians,2,1,4.0,3
26241051,Old Alleynians II,Old Tenisonians II,2,1,4.0,3
26110619,Old Alleynians,KCS Old Boys,7,3,2.0,10
26205896,Old Cholmeleians,Old Carthusians,1,7,0.0,8
26110718,Old Tonbridgians,Old Johnians,2,3,4.0,5
26170400,Old Wykehamists,Old Salopians,1,4,2.0,5
26180159,Old Kimboltonians,Old Berkhamstedians,3,3,5.0,6
26110757,Old Merchant Taylors,Old Epsomians,8,0,0.0,8
26091165,Old Carthusians II,Old Haberdashers,3,4,4.0,7
26110769,Old Westminsters II,Old Wellingtonians,5,3,4.0,8
26111241,Old Brentwoods IV,Old Stoics,3,0,2.0,3
26140430,Old Brentwoods II,KCS Old Boys II,2,1,4.0,3
26068088,Old Canfordians,Old Cheltonians,3,0,2.0,3
25876642,Old Malvernians Vets,KCS Old Boys Vets,1,2,4.0,3
25863321,Old Salopians Vets,Old Chigwellians Vets,2,1,4.0,3
25863689,Old Etonians Vets,Old Cholmeleians Vets,2,1,4.0,3
25935452,Old Bradfieldians Vets,Old Foresters Vets,0,2,2.0,2
25935453,Old Reptonians Vets,Old Harrovians Vets,4,4,6.0,8
26170346,KCS Old Boys,Old Bradfieldians,6,1,0.0,7
26170420,Old Etonians,Old Foresters,5,3,4.0,8
26091161,Old Westminsters,Old Wykehamists,0,1,3.0,1
26091163,Lancing Old Boys,Old Etonians II,0,2,2.0,2
26170409,Old Alleynians II,Old Chigwellians II,6,4,4.0,10
26111261,Old Shirburnians,Old Epsomians,2,1,4.0,3
26111260,Old Merchant Taylors,Old Sennockians,1,1,4.0,2
26091169,Old Amplefordians,Old Berkhamstedians II,1,1,4.0,2
26091167,Old King's Scholars,Old Harrovians III,5,1,2.0,6
26091166,Old Tonbridgians II,Old Westminsters II,4,2,3.0,6
26091170,Old Oundelians,Old Johnians II,0,4,1.0,4
26091171,Old Stoics,Old Salopians II,2,5,2.0,7
26110622,Old Brentwoods,Old Alleynians,1,5,2.0,6
26091137,Old Cholmeleians,Old Chigwellians,1,1,4.0,2
26091144,Old Tonbridgians,Old Rugbeians,2,0,2.0,2
26068072,Old Harrovians,Old Marlburians,3,2,4.0,5
26068071,Old Malvernians,Old Westminsters,3,3,5.0,6
26110752,Old Chigwellians II,Old Kimboltonians,1,8,0.0,9
26110741,Old Albanians,Lancing Old Boys,0,5,0.0,5
26068074,Old Etonians II,Old Ardinians,2,3,4.0,5
26068079,Old Aldenhamians,Old Cholmeleians II,1,1,4.0,2
26110760,KCS Old Boys II,Old Shirburnians,4,4,6.0,8
26111266,Old Harrovians II,Old Alleynians III,1,2,4.0,3
26068087,Old Kingstonians,Old Harrovians III,1,2,4.0,3
26068090,Old Johnians II,Old Stoics,2,1,4.0,3
25928093,KCS Old Boys,Old Reptonians,0,4,1.0,4
26116200,Old Johnians,Old Carthusians,0,4,1.0,4
25923789,Old Amplefordians,Old Berkhamstedians II,1,5,2.0,6
26093052,Old Westminsters II,Old Merchant Taylors II,1,2,4.0,3
26106998,Old Foresters,Bealonians,1,0,3.0,1
26140724,St. James' Old Boys,Old Alleynians II,1,4,2.0,5
26116528,Old Brentwoods II,Old Woodhouseians II,4,6,4.0,10
26075882,Old Cholmeleians,Old Foresters,1,4,2.0,5
26068060,Old Rugbeians,Old Johnians,1,3,3.0,4
26068059,Old Salopians,Old Harrovians,4,0,1.0,4
26068058,Old Marlburians,Old Westminsters,2,2,5.0,4
26091129,Old Etonians II,Old Berkhamstedians,3,3,5.0,6
26068056,Old Kimboltonians,Old Ardinians,2,1,4.0,3
26068057,Old Aldenhamians,Old Chigwellians II,4,2,3.0,6
26068055,Old Harrovians II,Old Merchant Taylors,5,3,4.0,8
25928091,Old Alleynians,Old Bradfieldians,3,2,4.0,5
25928092,Old Tonbridgians,Old Chigwellians,4,2,3.0,6
26067125,Old Alleynians III,Old Cholmeleians II,2,3,4.0,5
26093088,Old Epsomians,Old Alleynians II,2,5,2.0,7
26098199,Old Brentwoods IV,Old Salopians II,4,1,2.0,5
25923808,Old Kingstonians,Old Canfordians,2,4,3.0,6
25923788,Old Tonbridgians II,Old King's Scholars,4,5,5.0,9
26092731,Old Meadonians,Old Etonians,3,2,4.0,5
26286571,Old Brentwoods Vets,Old Westminster Citizens Vets,3,4,4.0,7
26073409,Old Alleynians,Old Reptonians,0,1,3.0,1
26064413,Old Foresters,KCS Old Boys,4,2,3.0,6
26075884,Old Carthusians,Old Brentwoods,1,0,3.0,1
26064414,Old Cholmeleians,Old Etonians,3,4,4.0,7
26064418,Old Marlburians,Old Johnians,2,6,2.0,8
26064420,Old Westminsters,Old Salopians,2,6,2.0,8
26064421,Old Wykehamists,Old Tonbridgians,0,2,2.0,2
26102054,Old Etonians II,Lancing Old Boys,4,2,3.0,6
26068005,Old Cholmeleians II,Old Albanians,5,3,4.0,8
26068011,Old Shirburnians,Old Haberdashers,3,2,4.0,5
26068022,Old Brentwoods II,Old Harrovians II,4,4,6.0,8
26068031,Old Berkhamstedians II,Old King's Scholars,3,1,3.0,4
26066737,Old Tonbridgians II,Old Berkhamstedians,3,2,4.0,5
26067007,Old Merchant Taylors,Old Kimboltonians,0,5,0.0,5
26092936,Old Ardinians,Old Kingstonians,4,0,1.0,4
26066392,KCS Old Boys II,Lancing Old Boys II,4,2,3.0,6
26066418,Old Sennockians,Old Aldenhamians,2,4,3.0,6
26073901,Old Brentwoods III,Old Chigwellians II,0,6,0.0,6
25923787,Old Johnians II,Old Wellingtonians,1,2,4.0,3
25923786,Old Cheltonians,Old Harrovians III,2,3,4.0,5
26057389,Old Wilsonians IV,Old Alleynians III,1,2,4.0,3
25918128,Old Brentwoods,KCS Old Boys,1,1,4.0,2
26064417,Old Chigwellians,Old Alleynians,2,3,4.0,5
25918130,Old Bradfieldians,Old Cholmeleians,3,1,3.0,4
25918129,Old Reptonians,Old Etonians,5,1,2.0,6
25918135,Old Salopians,Old Malvernians,4,2,3.0,6
25918134,Old Rugbeians,Old Marlburians,0,3,2.0,3
25918132,Old Wykehamists,Old Harrovians,2,1,4.0,3
25918133,Old Johnians,Old Westminsters,0,3,2.0,3
25918137,Old Alleynians II,Old Berkhamstedians,4,1,2.0,5
25918138,Old Albanians,Old Ardinians,1,4,2.0,5
25918141,Old Kimboltonians,Old Aldenhamians,4,3,4.0,7
25918140,Lancing Old Boys,Old Cholmeleians II,2,7,0.0,9
25918145,Old Shirburnians,Old Alleynians III,2,5,2.0,7
26067998,Old Harrovians II,Old Haberdashers,3,1,3.0,4
25918146,KCS Old Boys II,Old Carthusians II,2,6,2.0,8
25918148,Old Amplefordians,Old Kingstonians,3,3,5.0,6
25918149,Old Berkhamstedians II,Old Wellingtonians,6,2,2.0,8
25918150,Old Harrovians III,Old Brentwoods III,2,7,0.0,9
25918266,Old Brentwoods IV,Old Oundelians,4,0,1.0,4
25918265,Old Canfordians,Old Stoics,1,4,2.0,5
25748989,Old Carthusians,Old Merchant Taylors,2,1,4.0,3
26057394,Old Merchant Taylors II,Old Parkonians IV,7,1,0.0,8
25935450,Old Aldenhamians Vets,Old Wellingtonians Vets,4,5,5.0,9
26286574,Old Chigwellians Vets,Old Wilsonians Vets,0,4,1.0,4
25918107,Old Rugbeians,Old Wykehamists,1,3,3.0,4
26064568,Old Westminsters,Old Malvernians,5,2,2.0,7
25918108,Old Harrovians,Old Radleians,0,2,2.0,2
25918106,Old Salopians,Old Tonbridgians,2,4,3.0,6
25918112,Old Cholmeleians II,Old Kimboltonians,4,2,3.0,6
25918111,Old Aldenhamians,Old Albanians,1,2,4.0,3
25918114,Old Merchant Taylors,KCS Old Boys II,1,0,3.0,1
25918115,Old Sennockians,Old Epsomians,1,1,4.0,2
25918117,Old Harrovians II,Old Carthusians II,0,1,3.0,1
25918120,Old Brentwoods III,Old Berkhamstedians II,2,5,2.0,7
25918121,Old Kingstonians,Old King's Scholars,4,4,6.0,8
25918119,Old Tonbridgians II,Old Harrovians III,2,2,5.0,4
25485553,Lancing Old Boys,Old Alleynians II,0,7,0.0,7
25485551,Old Etonians II,Old Ardinians,1,3,3.0,4
25923783,Old Stoics,Old Oundelians,3,4,4.0,7
25923784,Lancing Old Boys II,Old Merchant Taylors II,0,7,0.0,7
26076144,Old Johnians II,Old Johnians,4,4,6.0,8
25836866,Old Etonians Vets,Old Foresters Vets,4,3,4.0,7
25918095,Old Reptonians,Old Bradfieldians,4,3,4.0,7
25918097,Old Tonbridgians,Old Radleians,4,4,6.0,8
25918096,Old Marlburians,Old Salopians,0,1,3.0,1
25918098,Old Johnians,Old Harrovians,4,0,1.0,4
25918099,Old Alleynians II,Old Etonians II,4,1,2.0,5
25918100,Old Wellingtonians,Old Amplefordians,2,6,2.0,8
25485544,Old Haberdashers,Old Kimboltonians,1,2,4.0,3
25485545,Old Carthusians II,Old Kingstonians,0,2,2.0,2
25485550,Old Harrovians II,Old Brentwoods III,2,4,3.0,6
25884189,Old Epsomians,Old Brentwoods IV,1,1,4.0,2
25485548,Old Cholmeleians II,Old Shirburnians,3,0,2.0,3
25485543,Old Albanians,Old Aldenhamians,1,4,2.0,5
25876416,Old Berkhamstedians,Old Canfordians,5,2,2.0,7
25485547,Old Brentwoods II,Old King's Scholars,2,1,4.0,3
25485542,Old Oundelians,Old Merchant Taylors,3,6,3.0,9
25485535,Lancing Old Boys II,Old Stoics,2,1,4.0,3
25485546,Old Cheltonians,Old Tonbridgians II,0,2,2.0,2
25485541,Old Berkhamstedians II,Old Chigwellians II,0,1,3.0,1
25485549,Old Harrovians III,Old Sennockians,0,5,0.0,5
25485552,Old Alleynians III,Old Westminsters II,3,3,5.0,6
25877347,Old Foresters,KCS Old Boys,3,2,4.0,5
25918074,Old Etonians,Old Bradfieldians,3,7,2.0,10
25918080,Old Reptonians,Old Brentwoods,1,1,4.0,2
25999405,Old Chigwellians,Old Carthusians,1,5,2.0,6
25918083,Old Marlburians,Old Rugbeians,7,1,0.0,8
25918082,Old Harrovians,Old Tonbridgians,3,2,4.0,5
25918087,Old Chigwellians II,Lancing Old Boys,0,7,0.0,7
25918084,Old Etonians II,Old Aldenhamians,3,2,4.0,5
25918088,Old Merchant Taylors,Old Brentwoods II,1,2,4.0,3
25918090,Old Carthusians II,Old Shirburnians,0,5,0.0,5
25918089,Old Haberdashers,Old Sennockians,2,3,4.0,5
25918091,Old Harrovians III,Old Amplefordians,3,0,2.0,3
25918092,Old Wellingtonians,Old Kingstonians,3,2,4.0,5
25918093,Old Canfordians,Old Brentwoods IV,3,7,2.0,10
25918094,Old Cheltonians,Old Salopians II,1,2,4.0,3
25846816,Old Salopians,Old Rugbeians,2,3,4.0,5
25846823,Old Radleians,Old Malvernians,3,3,5.0,6
25846821,Old Harrovians,Old Westminsters,2,1,4.0,3
25846826,Old Etonians II,Old Alleynians II,1,1,4.0,2
25846825,Old Berkhamstedians,Old Albanians,2,2,5.0,4
25846831,Old Harrovians II,KCS Old Boys II,0,2,2.0,2
25846833,Old Alleynians III,Old Carthusians II,5,0,0.0,5
25846834,Old Brentwoods II,Old Sennockians,2,0,2.0,2
25846843,Old Westminsters II,Old Amplefordians,4,3,4.0,7
25846841,Old Kingstonians,Old Tonbridgians II,1,2,4.0,3
25777002,Old Aldenhamians,Old Johnians,0,1,3.0,1
25749129,Old Brentwoods,Old Reptonians,1,3,3.0,4
25783946,Old Kimboltonians,KCS Old Boys,2,8,0.0,10
25749185,Old Wykehamists,Old Chigwellians,2,4,3.0,6
25810773,Old Tonbridgians,Old Ardinians,3,2,4.0,5
25749211,Old Alleynians,Old Etonians,1,0,3.0,1
25749336,Old Bradfieldians,Old Foresters,5,4,5.0,9
25846352,Old Bradfieldians,Old Alleynians,2,5,2.0,7
25846365,Old Wykehamists,Old Rugbeians,2,3,4.0,5
25846356,Old Malvernians,Old Johnians,4,10,1.0,14
25846360,Old Marlburians,Old Radleians,4,4,6.0,8
25846361,Old Harrovians,Old Salopians,1,7,0.0,8
25846363,Old Westminsters,Old Tonbridgians,3,4,4.0,7
25846752,Lancing Old Boys,Old Ardinians,0,8,0.0,8
25846381,Old Etonians II,Old Chigwellians II,2,2,5.0,4
25846407,Old Haberdashers,Old Harrovians II,2,0,2.0,2
25846417,Old Harrovians III,Old Berkhamstedians II,0,6,0.0,6
25846415,Old Tonbridgians II,Old Amplefordians,3,2,4.0,5
25846413,Old King's Scholars,Old Wellingtonians,4,3,4.0,7
25788414,Southgate County II,Old Merchant Taylors,5,2,2.0,7
25851401,Old Minchendenians IV,Old Alleynians III,0,3,2.0,3
25581800,Old Carthusians,Old Bradfieldians,1,5,2.0,6
25661191,Old Etonians,Old Chigwellians,2,2,5.0,4
25581794,Old Brentwoods,Old Cholmeleians,0,2,2.0,2
25581806,Old Westminsters,Old Marlburians,1,2,4.0,3
25581808,Old Tonbridgians,Old Salopians,4,1,2.0,5
25581803,Old Radleians,Old Harrovians,0,3,2.0,3
25581812,Old Berkhamstedians,Old Alleynians II,1,1,4.0,2
25581815,Old Ardinians,Old Chigwellians II,3,1,3.0,4
25661192,Old Kimboltonians,Old Albanians,6,2,2.0,8
25597235,Old Haberdashers,Old Alleynians III,2,1,4.0,3
25581819,KCS Old Boys II,Old Epsomians,1,2,4.0,3
25562168,Old Sennockians,Old Shirburnians,5,1,2.0,6
25581820,Old Brentwoods II,Old Carthusians II,1,5,2.0,6
25581818,Old Merchant Taylors,Old Harrovians II,1,1,4.0,2
25597244,Old Kingstonians,Old Berkhamstedians II,0,4,1.0,4
25846142,Old Amplefordians,Old Brentwoods III,1,6,0.0,7
25597247,Old Harrovians III,Old Wellingtonians,1,0,3.0,1
25597248,Old King's Scholars,Old Westminsters II,2,6,2.0,8
25578207,Old Felstedians,Old Brentwoods IV,2,4,3.0,6
25485534,Old Merchant Taylors II,Old Canfordians,1,9,0.0,10
25581855,Old Cheltonians,Old Johnians II,4,2,3.0,6
25838416,Old Foresters,Old Ignatian,2,0,2.0,2
25876242,Lancing Old Boys II,Old Wilsonians V,0,1,3.0,1
25408686,Old Etonians Vets,Old Wykehamists Vets,4,0,1.0,4
25408688,Old Cholmeleians Vets,Old Foresters Vets,2,2,5.0,4
25408685,Old Reptonians Vets,Old Salopians Vets,2,6,2.0,8
25408689,KCS Old Boys Vets,Old Harrovians Vets,8,1,0.0,9
25782681,Old Brentwoods Vets,Enfield Old Grammarians Vets,1,0,3.0,1
25782682,Old Chigwellians Vets,Globe Rangers Vets 2nd,7,3,2.0,10
25562149,Old Brentwoods,Old Reptonians,0,4,1.0,4
25562148,Old Bradfieldians,KCS Old Boys,3,2,4.0,5
25555659,Old Etonians,Old Alleynians,2,2,5.0,4
25562153,Old Chigwellians,Old Cholmeleians,2,5,2.0,7
25581795,Old Carthusians,Old Foresters,2,0,2.0,2
25562161,Old Westminsters,Old Rugbeians,1,3,3.0,4
25562158,Old Malvernians,Old Wykehamists,4,2,3.0,6
25562160,Old Johnians,Old Marlburians,1,1,4.0,2
25581780,Old Cholmeleians II,Old Alleynians II,1,4,2.0,5
25562162,Old Albanians,Old Berkhamstedians,1,3,3.0,4
25562163,Lancing Old Boys,Old Aldenhamians,3,4,4.0,7
25581781,Old Kimboltonians,Old Etonians II,2,0,2.0,2
25581816,Old Sennockians,Old Haberdashers,2,4,3.0,6
25562167,Old Alleynians III,Old Epsomians,1,3,3.0,4
25597234,Old Brentwoods II,Old Shirburnians,1,2,4.0,3
25597223,Old Carthusians II,Old Harrovians II,2,4,3.0,6
25562171,Old Harrovians III,Old Kingstonians,6,2,2.0,8
25562170,Old Tonbridgians II,Old King's Scholars,1,2,4.0,3
25562169,Old Amplefordians,Old Westminsters II,1,5,2.0,6
25555657,Old Cheltonians,Old Brentwoods IV,1,0,3.0,1
25402512,Old Oundelians,Old Canfordians,1,2,4.0,3
25402514,Old Salopians II,Old Johnians II,2,4,3.0,6
25445156,Old Merchant Taylors II,Old Parmiterians IX,3,1,3.0,4
25408687,Old Carthusians Vets,Old Malvernians Vets,2,5,2.0,7
25562099,Old Alleynians,Old Carthusians,6,3,3.0,9
25562101,Old Harrovians,Old Malvernians,3,3,5.0,6
25562100,Old Westminsters,Old Johnians,1,4,2.0,5
25568711,Old Tonbridgians,Old Marlburians,2,1,4.0,3
25562103,Old Radleians,Old Salopians,1,2,4.0,3
25581779,Lancing Old Boys,Old Albanians,1,6,0.0,7
25568720,Old Kimboltonians,Old Alleynians II,2,4,3.0,6
25568721,Old Aldenhamians,Old Berkhamstedians,2,10,0.0,12
25562123,Old Cholmeleians II,Old Ardinians,0,4,1.0,4
25562131,Old Brentwoods II,Old Epsomians,4,6,4.0,10
25562137,Old Haberdashers,Old Carthusians II,4,2,3.0,6
25562138,Old Alleynians III,Old Merchant Taylors,0,2,2.0,2
25562136,Old Shirburnians,Old Harrovians II,3,2,4.0,5
25562142,Old Amplefordians,Old Tonbridgians II,5,1,2.0,6
25562141,Old Kingstonians,Old Wellingtonians,1,2,4.0,3
25562139,Old Harrovians III,Old Westminsters II,2,3,4.0,5
25555642,Old Salopians II,Old Cheltonians,4,7,3.0,11
25703542,Glyn Old Boys,KCS Old Boys,4,4,6.0,8
25754416,Old Rugbeians,Old Pauline,1,5,2.0,6
25776145,Old Chigwellians Vets,Old Foresters Vets,1,2,4.0,3
25688153,Old Carthusians,Old Reptonians,0,1,3.0,1
25561350,KCS Old Boys,Old Brentwoods,2,1,4.0,3
25555658,Old Cholmeleians,Old Alleynians,0,5,0.0,5
25561351,Old Bradfieldians,Old Chigwellians,2,2,5.0,4
25561363,Old Marlburians,Old Wykehamists,1,1,4.0,2
25561359,Old Malvernians,Old Radleians,4,5,5.0,9
25561360,Old Johnians,Old Salopians,6,1,0.0,7
25639179,Old Rugbeians,Old Harrovians,3,4,4.0,7
25568592,Old Chigwellians II,Old Alleynians II,0,3,2.0,3
25568593,Old Aldenhamians,Old Kimboltonians,1,8,0.0,9
25562121,Old Berkhamstedians,Lancing Old Boys,2,3,4.0,5
25568594,Old Albanians,Old Cholmeleians II,0,5,0.0,5
25581774,Old Alleynians III,KCS Old Boys II,4,2,3.0,6
25568624,Old Merchant Taylors,Old Shirburnians,4,4,6.0,8
25561745,Old Harrovians II,Old Sennockians,4,1,2.0,5
25562090,Old Tonbridgians II,Old Kingstonians,3,2,4.0,5
25562086,Old King's Scholars,Old Amplefordians,2,3,4.0,5
25562085,Old Berkhamstedians II,Old Harrovians III,2,2,5.0,4
25562091,Old Brentwoods III,Old Westminsters II,5,3,4.0,8
25562092,Old Stoics,Old Oundelians,4,2,3.0,6
25562093,Old Johnians II,Old Brentwoods IV,3,4,4.0,7
25754169,Old Westminsters,Old Tonbridgians,2,3,4.0,5
25703543,Alleyn Old Boys,Old Etonians,2,4,3.0,6
25754412,Bealonians II,Old Brentwoods II,2,4,3.0,6
25776146,Old Finchleians Vets,Old Etonians Vets,1,3,3.0,4
25561309,Old Reptonians,Old Alleynians,5,4,5.0,9
25561310,Old Etonians,Old Cholmeleians,2,2,5.0,4
25688152,Old Bradfieldians,Old Foresters,0,8,0.0,8
25561311,Old Harrovians,Old Johnians,2,2,5.0,4
25568551,Old Salopians,Old Marlburians,2,3,4.0,5
25561314,Old Wykehamists,Old Westminsters,3,4,4.0,7
25661184,Old Albanians,Old Kimboltonians,3,5,4.0,8
25561317,Old Ardinians,Old Aldenhamians,6,2,2.0,8
25568559,Old Berkhamstedians,Old Chigwellians II,1,4,2.0,5
25671863,Old Shirburnians,Old Sennockians,1,4,2.0,5
25597224,Old Carthusians II,Old Epsomians,3,4,4.0,7
25597225,KCS Old Boys II,Old Harrovians II,2,1,4.0,3
25561325,Old Wellingtonians,Old Berkhamstedians II,3,7,2.0,10
25561326,Old Westminsters II,Old King's Scholars,3,2,4.0,5
25402400,Old Amplefordians,Old Harrovians III,4,2,3.0,6
25561345,Old Johnians II,Old Cheltonians,3,2,4.0,5
25561344,Old Brentwoods IV,Old Salopians II,3,1,3.0,4
25408253,Old Rugbeians,KCS Old Boys,1,2,4.0,3
25654947,Old Alleynians II,Old Suttonians II,2,1,4.0,3
25788398,Old Alleynians III,Old Tenisonians IV,9,1,0.0,10
25561361,Old Marlburians,Old Harrovians,5,0,0.0,5
25402518,Old Cholmeleians II,Old Etonians II,0,1,3.0,1
25402517,Old Chigwellians II,Old Albanians,1,8,0.0,9
25402519,Old Harrovians II,Old Epsomians,4,2,3.0,6
25402521,Old Brentwoods III,Old King's Scholars,2,4,3.0,6
25402523,Old Berkhamstedians II,Old Westminsters II,3,4,4.0,7
25402524,Old Oundelians,Old Brentwoods IV,0,5,0.0,5
25402526,Old Johnians II,Old Canfordians,3,2,4.0,5
25402525,Old Salopians II,Old Stoics,2,2,5.0,4
25408263,Old Salopians,Old Ardinians,2,4,3.0,6
25408256,Old Foresters,Old Malvernians,6,0,0.0,6
25408254,Old Brentwoods,Lancing Old Boys,4,1,2.0,5
25408258,Old Radleians,Old Wykehamists,1,3,3.0,4
25408252,Old Alleynians,Old Berkhamstedians,5,2,2.0,7
25408264,Old Sennockians,Old Johnians,1,3,3.0,4
25408260,Old Tonbridgians,Old Westminsters,2,2,5.0,4
25408255,Old Haberdashers,Old Etonians,0,8,0.0,8
25408265,Old Amplefordians,Old Merchant Taylors,0,3,2.0,3
25408261,Old Bradfieldians,Old Shirburnians,3,1,3.0,4
25560805,Old Brentwoods II,East Barnet Old Grammarians,5,1,2.0,6
25560855,KCS Old Boys II,Alleyn Old Boys III,2,3,4.0,5
25639149,Old Rugbeians,Clissold Park Rangers,2,1,4.0,3
25405352,Old Bradfieldians,Old Reptonians,0,1,3.0,1
25405332,Old Foresters,Old Alleynians,0,5,0.0,5
25405347,Old Carthusians,Old Cholmeleians,2,2,5.0,4
25402498,Old Salopians,Old Wykehamists,3,2,4.0,5
25560814,Old Marlburians,Old Tonbridgians,3,6,3.0,9
25402502,Old Cholmeleians II,Old Berkhamstedians,0,3,2.0,3
25402504,Old Aldenhamians,Lancing Old Boys,2,1,4.0,3
25402503,Old Kimboltonians,Old Chigwellians II,3,3,5.0,6
25402501,Old Ardinians,Old Alleynians II,1,2,4.0,3
25662615,Old Carthusians II,Old Alleynians III,2,4,3.0,6
25402506,Old Epsomians,Old Shirburnians,1,1,4.0,2
25402505,Old Sennockians,Old Merchant Taylors,0,2,2.0,2
25555611,Old Westminsters II,Old Tonbridgians II,2,3,4.0,5
25402511,Old Berkhamstedians II,Old Amplefordians,1,2,4.0,3
25402508,Old Wellingtonians,Old King's Scholars,2,3,4.0,5
25402510,Old Brentwoods III,Old Harrovians III,8,2,0.0,10
25555633,Old Canfordians,Old Oundelians,2,3,4.0,5
25555621,Old Johnians II,Old Salopians II,4,0,1.0,4
25408259,Old Chigwellians,Old Harrovians,3,2,4.0,5
25445015,Old Etonians,Old Parmiterians,5,0,0.0,5
25405335,Old Cholmeleians,Old Bradfieldians,2,3,4.0,5
25404728,Old Reptonians,KCS Old Boys,5,1,2.0,6
25405340,Old Brentwoods,Old Carthusians,3,6,3.0,9
25404732,Old Foresters,Old Etonians,3,1,3.0,4
25563021,Old Alleynians,Old Chigwellians,3,2,4.0,5
25529682,Old Wykehamists,Old Johnians,2,3,4.0,5
25402477,Old Malvernians,Old Marlburians,1,3,3.0,4
25402475,Old Tonbridgians,Old Harrovians,3,0,2.0,3
25402474,Old Radleians,Old Westminsters,2,2,5.0,4
25402481,Old Ardinians,Old Berkhamstedians,4,4,6.0,8
25402482,Old Etonians II,Old Kimboltonians,2,1,4.0,3
25402479,Old Alleynians II,Lancing Old Boys,2,1,4.0,3
25402480,Old Chigwellians II,Old Cholmeleians II,0,2,2.0,2
25560797,Old Brentwoods II,Old Alleynians III,3,4,4.0,7
25402486,Old Shirburnians,Old Carthusians II,2,4,3.0,6
25402483,KCS Old Boys II,Old Merchant Taylors,1,2,4.0,3
25402484,Old Epsomians,Old Sennockians,0,5,0.0,5
25402490,Old Kingstonians,Old Amplefordians,1,2,4.0,3
25402489,Old Berkhamstedians II,Old Tonbridgians II,3,1,3.0,4
25402488,Old Brentwoods III,Old Wellingtonians,4,1,2.0,5
25402491,Old Westminsters II,Old Harrovians III,2,1,4.0,3
25402493,Old Cheltonians,Old Oundelians,5,1,2.0,6
25402492,Old Stoics,Old Brentwoods IV,1,1,4.0,2
25405331,Old Carthusians,Old Alleynians,0,5,0.0,5
25560778,Old Bradfieldians,Old Etonians,3,1,3.0,4
25405343,Old Reptonians,Old Chigwellians,2,2,5.0,4
25405349,KCS Old Boys,Old Foresters,1,1,4.0,2
25402454,Old Harrovians,Old Wykehamists,1,4,2.0,5
25402452,Old Johnians,Old Malvernians,3,2,4.0,5
25402451,Old Rugbeians,Old Radleians,0,1,3.0,1
25402453,Old Tonbridgians,Old Westminsters,5,1,2.0,6
25402457,Old Berkhamstedians,Old Kimboltonians,2,3,4.0,5
25402455,Old Aldenhamians,Old Ardinians,2,4,3.0,6
25402458,Old Alleynians II,Old Cholmeleians II,1,4,2.0,5
25402460,Old Epsomians,KCS Old Boys II,3,0,2.0,3
25547921,Old Alleynians III,Old Harrovians II,1,1,4.0,2
25402465,Old King's Scholars,Old Berkhamstedians II,0,2,2.0,2
25402464,Old Westminsters II,Old Kingstonians,6,2,2.0,8
25402462,Old Harrovians III,Old Tonbridgians II,2,0,2.0,2
25402463,Old Amplefordians,Old Wellingtonians,1,4,2.0,5
25402466,Old Brentwoods IV,Old Cheltonians,6,2,2.0,8
25402467,Old Canfordians,Old Salopians II,0,6,0.0,6
25402468,Old Stoics,Old Johnians II,2,2,5.0,4
25405365,Bealonians,Old Brentwoods,3,0,2.0,3
25445150,Old Merchant Taylors,Old Ignatian II,2,1,4.0,3
25491855,Old Etonians II,Old Suttonians II,0,2,2.0,2
25405334,Old Brentwoods,Old Bradfieldians,0,4,1.0,4
25405346,Old Reptonians,Old Cholmeleians,6,1,0.0,7
25404730,KCS Old Boys,Old Etonians,3,4,4.0,7
25547918,Old Radleians,Old Johnians,1,4,2.0,5
25402432,Old Wykehamists,Old Marlburians,1,4,2.0,5
25402431,Old Malvernians,Old Salopians,0,2,2.0,2
25402430,Old Westminsters,Old Harrovians,0,2,2.0,2
25402436,Old Alleynians II,Old Ardinians,2,1,4.0,3
25402433,Old Chigwellians II,Old Aldenhamians,3,1,3.0,4
25402434,Old Kimboltonians,Old Cholmeleians II,1,1,4.0,2
25402435,Old Etonians II,Old Albanians,3,2,4.0,5
25402438,KCS Old Boys II,Old Alleynians III,2,2,5.0,4
25402440,Old Brentwoods II,Old Merchant Taylors,1,3,3.0,4
25402439,Old Sennockians,Old Harrovians II,0,1,3.0,1
25402441,Old Kingstonians,Old Brentwoods III,1,2,4.0,3
25402443,Old Harrovians III,Old King's Scholars,0,2,2.0,2
25402442,Old Wellingtonians,Old Westminsters II,2,3,4.0,5
25402444,Old Salopians II,Old Brentwoods IV,1,6,0.0,7
25402445,Old Canfordians,Old Johnians II,0,1,3.0,1
25402446,Old Oundelians,Old Stoics,1,1,4.0,2
25445013,Old Parkonians,Old Foresters,1,4,2.0,5
25483305,Old Rugbeians,Shene Old Grammarians,4,4,6.0,8
25405339,Old Bradfieldians,Old Carthusians,1,3,3.0,4
25405351,Old Etonians,Old Reptonians,2,7,0.0,9
25405337,Old Cholmeleians,Old Brentwoods,2,1,4.0,3
25405330,KCS Old Boys,Old Alleynians,1,5,2.0,6
25402410,Old Harrovians,Old Rugbeians,3,4,4.0,7
25402411,Old Marlburians,Old Malvernians,1,3,3.0,4
25402409,Old Wykehamists,Old Radleians,2,2,5.0,4
25402412,Old Salopians,Old Westminsters,2,4,3.0,6
25402413,Old Alleynians II,Old Kimboltonians,3,0,2.0,3
25402414,Old Ardinians,Lancing Old Boys,2,2,5.0,4
25402416,Old Alleynians III,Old Haberdashers,3,1,3.0,4
25402415,Old Carthusians II,KCS Old Boys II,3,2,4.0,5
25402419,Old Sennockians,Old Brentwoods II,3,5,4.0,8
25402418,Old Shirburnians,Old Merchant Taylors,1,7,0.0,8
25402417,Old Epsomians,Old Harrovians II,6,2,2.0,8
25402423,Old Westminsters II,Old Berkhamstedians II,2,3,4.0,5
25402421,Old King's Scholars,Old Kingstonians,1,2,4.0,3
25402420,Old Brentwoods III,Old Amplefordians,10,3,1.0,13
25402422,Old Wellingtonians,Old Harrovians III,3,6,3.0,9
25402424,Old Cheltonians,Old Canfordians,2,2,5.0,4
25402425,Old Brentwoods IV,Old Johnians II,4,4,6.0,8
25405333,Old Alleynians,Old Bradfieldians,2,3,4.0,5
25404727,Old Carthusians,KCS Old Boys,3,4,4.0,7
25404729,Old Brentwoods,Old Etonians,4,1,2.0,5
25405348,Old Chigwellians,Old Foresters,4,4,6.0,8
25402388,Old Radleians,Old Marlburians,2,1,4.0,3
25402385,Old Rugbeians,Old Salopians,1,1,4.0,2
25402387,Old Johnians,Old Tonbridgians,1,0,3.0,1
25402386,Old Malvernians,Old Harrovians,2,4,3.0,6
25402392,Old Aldenhamians,Old Alleynians II,1,5,2.0,6
25402389,Lancing Old Boys,Old Berkhamstedians,6,5,5.0,11
25402393,Old Ardinians,Old Kimboltonians,2,1,4.0,3
25402391,Old Etonians II,Old Cholmeleians II,0,1,3.0,1
25402390,Old Albanians,Old Chigwellians II,5,4,5.0,9
25402396,KCS Old Boys II,Old Brentwoods II,4,2,3.0,6
25402394,Old Haberdashers,Old Epsomians,8,4,2.0,12
25402397,Old Harrovians II,Old Shirburnians,6,2,2.0,8
25402398,Old Merchant Taylors,Old Carthusians II,2,1,4.0,3
25402395,Old Alleynians III,Old Sennockians,2,3,4.0,5
25402401,Old Berkhamstedians II,Old Kingstonians,6,0,0.0,6
25402399,Old Westminsters II,Old Brentwoods III,0,5,0.0,5
25402402,Old Tonbridgians II,Old Wellingtonians,2,3,4.0,5
25402403,Old Johnians II,Old Oundelians,3,1,3.0,4
25402404,Old Salopians II,Old Canfordians,0,3,2.0,3
25405350,KCS Old Boys,Old Reptonians,0,3,2.0,3
25405345,Old Foresters,Old Cholmeleians,2,0,2.0,2
25405342,Old Carthusians,Old Chigwellians,2,5,2.0,7
25402364,Old Salopians,Old Johnians,1,4,2.0,5
25402367,Old Wykehamists,Old Malvernians,2,2,5.0,4
25402365,Old Westminsters,Old Radleians,0,5,0.0,5
25402366,Old Rugbeians,Old Tonbridgians,2,6,2.0,8
25402370,Old Chigwellians II,Old Ardinians,2,7,0.0,9
25402372,Old Kimboltonians,Lancing Old Boys,5,0,0.0,5
25402369,Old Cholmeleians II,Old Aldenhamians,3,5,4.0,8
25402371,Old Berkhamstedians,Old Etonians II,1,2,4.0,3
25402368,Old Alleynians II,Old Albanians,3,1,3.0,4
25402373,Old Sennockians,KCS Old Boys II,3,1,3.0,4
25402375,Old Epsomians,Old Carthusians II,1,4,2.0,5
25402374,Old Haberdashers,Old Merchant Taylors,0,0,4.0,0
25402377,Old Tonbridgians II,Old Berkhamstedians II,1,1,4.0,2
25402376,Old Amplefordians,Old King's Scholars,1,3,3.0,4
25402378,Old Salopians II,Old Oundelians,6,2,2.0,8
25402380,Old Stoics,Old Canfordians,3,1,3.0,4
25402379,Old Cheltonians,Old Johnians II,2,0,2.0,2
25405336,Old Alleynians,Old Brentwoods,7,0,0.0,7
25405338,Old Etonians,Old Carthusians,1,2,4.0,3
25405341,KCS Old Boys,Old Chigwellians,2,2,5.0,4
25402348,Old Johnians,Old Rugbeians,3,1,3.0,4
25402349,Old Tonbridgians,Old Wykehamists,3,2,4.0,5
25402347,Old Salopians,Old Radleians,0,5,0.0,5
25402350,Old Ardinians,Old Albanians,2,2,5.0,4
25402351,Old Berkhamstedians,Old Aldenhamians,1,6,0.0,7
25402352,Lancing Old Boys,Old Chigwellians II,6,2,2.0,8
25402353,Old Haberdashers,KCS Old Boys II,1,2,4.0,3
25402354,Old Harrovians II,Old Brentwoods II,1,6,0.0,7
25402355,Old Alleynians III,Old Shirburnians,3,2,4.0,5
25402356,Old Epsomians,Old Merchant Taylors,0,2,2.0,2
25402357,Old Carthusians II,Old Sennockians,1,2,4.0,3
25402359,Old Oundelians,Old Cheltonians,2,2,5.0,4
25402360,Old Brentwoods IV,Old Canfordians,1,1,4.0,2
27099158,Old Foresters Vets,Old Chigwellians Veterans,2,0,2.0,2
27435363,Old Reptonians,Old Bradfieldians,2,0,2.0,2
27435362,Old Alleynians,KCS Old Boys,3,0,2.0,3
27435364,Old Tonbridgians,Old Cholmeleians,1,3,3.0,4
27435365,Old Foresters,Old Etonians,2,3,4.0,5
27435378,Old Marlburians,Old Rugbeians,2,2,5.0,4
27435366,Old Wykehamists,Old Ardinians,0,3,2.0,3
27435377,Old Kimboltonians,Old Brentwoods,1,4,2.0,5
27435376,Old Salopians,Old Chigwellians,0,2,2.0,2
27435375,Old Radleians,Old Harrovians,0,1,3.0,1
27435383,Old Westminsters,Old Berkhamstedians,1,1,4.0,2
27435381,Old Alleynians II,Old Aldenhamians,6,5,5.0,11
27435379,Old Cholmeleians II,Old Brentwoods II,3,2,4.0,5
27435380,Lancing Old Boys,Old Merchant Taylors,0,3,2.0,3
27435387,Old Epsomians,Old Carthusians II,1,2,4.0,3
27435386,Old Berkhamstedians II,Old Brentwoods III,1,0,3.0,1
27435385,Old Alleynians III,Old Sennockians,3,1,3.0,4
27435384,Old Chigwellians II,Old Harrovians II,2,4,3.0,6
27477638,Old Shirburnians,Old King's Scholars,3,2,4.0,5
27477639,KCS Old Boys II,Old Westminsters II,2,4,3.0,6
27411807,Old Amplefordians,Old Canfordians,0,3,2.0,3
27411808,Old Felstedians,Old Kingstonians,0,9,0.0,9
27411809,Old Stoics,Old Salopians II,2,1,4.0,3
27411806,Old Oundelians,Old Merchant Taylors II,5,2,2.0,7
27411813,Old Malvernians,Old Tonbridgians II,5,4,5.0,9
27411810,Old Wellingtonians,Old Johnians II,2,3,4.0,5
27555896,SAL Representative Team,Arthurian League Representative Team,0,4,1.0,4
27381991,KCS Old Boys,Old Reptonians,2,3,4.0,5
27381994,Old Alleynians,Old Carthusians,6,0,0.0,6
27381945,Old Bradfieldians,Old Cholmeleians,6,0,0.0,6
27381946,Old Johnians,Old Foresters,4,0,1.0,4
27382008,Old Salopians,Old Kimboltonians,3,2,4.0,5
27381995,Old Radleians,Old Ardinians,5,4,5.0,9
27382004,Old Marlburians,Old Brentwoods,2,5,2.0,7
27382006,Old Chigwellians,Old Harrovians,3,0,2.0,3
27382009,Old Berkhamstedians,Lancing Old Boys,1,1,4.0,2
27382011,Old Westminsters,Old Brentwoods II,0,1,3.0,1
27382012,Old Aldenhamians,Old Merchant Taylors,6,3,3.0,9
27382015,Old Sennockians,Old Berkhamstedians II,3,4,4.0,7
27524382,Old Epsomians,Old Alleynians III,0,8,0.0,8
27382019,Old Harrovians III,Old Westminsters II,3,4,4.0,7
27382022,Old Tonbridgians II,Old Johnians II,1,0,3.0,1
27382034,Old Stoics,Old Canfordians,3,4,4.0,7
27382030,Old Kingstonians,Old Salopians II,4,1,2.0,5
27382032,Old Cheltonians,Old Cranleighans,1,3,3.0,4
27403450,Old Johnians,Old Bradfieldians,2,3,4.0,5
27381921,Old Reptonians,Old Etonians,2,0,2.0,2
27381920,KCS Old Boys,Old Tonbridgians,6,2,2.0,8
27381919,Old Alleynians,Old Foresters,4,3,4.0,7
27381922,Old Brentwoods,Old Ardinians,2,1,4.0,3
27381926,Old Wykehamists,Old Rugbeians,1,0,3.0,1
27381928,Old Marlburians,Old Kimboltonians,1,3,3.0,4
27381924,Old Chigwellians,Old Radleians,5,3,4.0,8
27381923,Old Salopians,Old Harrovians,2,3,4.0,5
27381929,Old Berkhamstedians,Old Brentwoods II,3,3,5.0,6
27381930,Lancing Old Boys,Old Cholmeleians II,0,4,1.0,4
27381931,Old Etonians II,Old Westminsters,2,3,4.0,5
27381933,Old Harrovians II,Old Berkhamstedians II,2,1,4.0,3
27403821,Old Alleynians III,Old Carthusians II,2,2,5.0,4
27381932,Old Haberdashers,Old Brentwoods III,8,4,2.0,12
27381934,Old Epsomians,Old Chigwellians II,0,1,3.0,1
27381936,Old Sennockians,Old Albanians,4,0,1.0,4
27381938,Old Tonbridgians II,Old Shirburnians,2,0,2.0,2
27381937,Old Johnians II,KCS Old Boys II,1,7,0.0,8
27381939,Old Amplefordians,Old Brentwoods IV,0,4,1.0,4
27381942,Old Wykehamists II,Old Salopians II,3,0,2.0,3
27381941,Old Kingstonians,Old Cranleighans,1,1,4.0,2
27381944,Old Canfordians,Old Wellingtonians,2,0,2.0,2
27403521,Old Oundelians,Old Stoics,0,3,2.0,3
27403567,Enfield Old Grammarians III,Old Merchant Taylors,5,0,0.0,5
27099205,Old Westminsters Vets,Old Harrovians Vets,1,2,4.0,3
27099225,Old Wykehamists Vets,KCS Old Boys Vets,1,4,2.0,5
27099230,Old Salopians Vets,Lancing Old Boys Vets,6,0,0.0,6
27099195,Old Bradfieldians Vets,Old Etonians Vets,0,1,3.0,1
27099156,Old Cholmeleians Vets,Old Foresters Vets,1,8,0.0,9
27381828,Old Bradfieldians,Old Alleynians,2,4,3.0,6
27354433,Old Tonbridgians,Old Johnians,1,1,4.0,2
27354429,Old Cholmeleians,KCS Old Boys,2,2,5.0,4
27354426,Old Carthusians,Old Etonians,2,1,4.0,3
27381847,Old Rugbeians,Old Kimboltonians,4,4,6.0,8
27354436,Old Ardinians,Old Marlburians,0,2,2.0,2
27354437,Old Harrovians,Old Wykehamists,1,5,2.0,6
27354440,Old Etonians II,Old Berkhamstedians,3,0,2.0,3
27354439,Lancing Old Boys,Old Brentwoods II,0,2,2.0,2
27354442,Old Alleynians II,Old Cholmeleians II,1,1,4.0,2
27354438,Old Aldenhamians,Old Westminsters,0,2,2.0,2
27354444,Old Berkhamstedians II,Old Haberdashers,3,2,4.0,5
27402940,Old Albanians,Old Carthusians II,5,3,4.0,8
27354446,Old Brentwoods III,Old Sennockians,1,7,0.0,8
27354448,Old Epsomians,Old Harrovians II,1,1,4.0,2
27354460,Old Westminsters II,Old Amplefordians,2,0,2.0,2
27354465,Old King's Scholars,Old Brentwoods IV,1,2,4.0,3
27354464,Old Shirburnians,Old Harrovians III,3,5,4.0,8
27354467,Old Wykehamists II,Old Canfordians,2,1,4.0,3
27354470,Old Oundelians,Old Kingstonians,1,2,4.0,3
27354468,Old Cheltonians,Old Salopians II,6,4,4.0,10
27477764,East Barnet Old Grammarians,Old Chigwellians,0,8,0.0,8
27358493,Bealonians,Old Foresters,2,1,4.0,3
27347766,Old Brentwoods,Old Parmiterians,2,1,4.0,3
27349278,Old Chigwellians II,East Barnet Old Grammarians III,4,1,2.0,5
27325389,KCS Old Boys II,Old Tenisonians II,2,0,2.0,2
27205821,Old Parkonians III,Old Merchant Taylors II,5,2,2.0,7
27205826,Old Ignatian Vets,Old Etonians Vets,0,3,2.0,3
27205827,Albanian Vets,Old Foresters Vets,2,6,2.0,8
27354398,Old Cholmeleians,Old Reptonians,0,4,1.0,4
27354399,Old Tonbridgians,Old Alleynians,1,3,3.0,4
27354400,Old Johnians,Old Carthusians,0,4,1.0,4
27354401,Old Wykehamists,Old Radleians,7,3,2.0,10
27354404,Old Ardinians,Old Salopians,4,1,2.0,5
27354405,Old Chigwellians,Old Brentwoods,2,4,3.0,6
27354403,Old Marlburians,Old Harrovians,0,1,3.0,1
27354407,Old Aldenhamians,Old Berkhamstedians,2,3,4.0,5
27354406,Old Westminsters,Lancing Old Boys,9,0,0.0,9
27353604,Old Brentwoods II,Old Merchant Taylors,0,1,3.0,1
27354413,Old Harrovians II,Old Haberdashers,3,6,3.0,9
27354409,Old Carthusians II,Old Brentwoods III,1,3,3.0,4
27354410,Old Berkhamstedians II,Old Chigwellians II,1,1,4.0,2
27354414,Old Epsomians,Old Sennockians,1,5,2.0,6
27354408,Old Albanians,Old Alleynians III,0,4,1.0,4
27354415,Old Brentwoods IV,Old Shirburnians,3,5,4.0,8
27354418,KCS Old Boys II,Old Tonbridgians II,4,1,2.0,5
27354417,Old Johnians II,Old Harrovians III,1,5,2.0,6
27354416,Old King's Scholars,Old Westminsters II,1,7,0.0,8
27354425,Old Canfordians,Old Cheltonians,2,1,4.0,3
27354419,Old Salopians II,Old Oundelians,9,1,0.0,10
27354421,Old Kingstonians,Old Stoics,11,1,0.0,12
27354420,Old Cranleighans,Old Wellingtonians,1,3,3.0,4
27099238,Old Kimboltonians,Old Amplefordians,7,2,0.0,9
27386156,Old Bradfieldians,Old Suttonians,9,3,0.0,12
27386155,KCS Old Boys,Old Etonians,3,2,4.0,5
27109044,Old Foresters,Forest School 1st XI,4,1,2.0,5
27256006,Old Johnians,Old Alleynians,0,7,0.0,7
27256004,Old Foresters,Old Reptonians,4,6,4.0,10
27256005,Old Tonbridgians,Old Carthusians,0,3,2.0,3
27256008,Old Brentwoods,Old Marlburians,3,2,4.0,5
27256010,Old Salopians,Old Wykehamists,0,1,3.0,1
27358510,Old Carthusians II,Old Berkhamstedians II,2,2,5.0,4
27358506,Old Chigwellians II,Old Haberdashers,7,1,0.0,8
27256012,Old Harrovians II,Old Albanians,2,3,4.0,5
27256018,Old Johnians II,Old King's Scholars,0,3,2.0,3
27256016,Old Shirburnians,KCS Old Boys II,1,3,3.0,4
27256017,Old Tonbridgians II,Old Brentwoods IV,2,0,2.0,2
27256020,Old Salopians II,Old Canfordians,5,7,4.0,12
27256021,Old Cheltonians,Old Kingstonians,1,6,0.0,7
27256019,Old Oundelians,Old Wellingtonians,3,7,2.0,10
27099232,Old Malvernians,Old Radleians,4,3,4.0,7
27099239,Old Bradfieldians,Old Westminsters,3,2,4.0,5
27099243,Old Chigwellians,Old Aldenhamians,0,1,3.0,1
27099237,KCS Old Boys,Old Etonians,0,3,2.0,3
27099240,Old Merchant Taylors,Old Cholmeleians,2,3,4.0,5
27099236,Old Ardinians,Old Harrovians,1,3,3.0,4
27205814,Old Finchleians II,Old Brentwoods II,1,3,3.0,4
27205813,Old Etonians II,Southgate County II,8,6,4.0,14
27477369,Old Berkhamstedians,Old Alleynians II,2,1,4.0,3
27478209,Old Brentwoods III,Old Alleynians III,5,1,2.0,6
27255983,Old Etonians,Old Alleynians,1,5,2.0,6
27255984,Old Bradfieldians,Old Reptonians,2,2,5.0,4
27255985,KCS Old Boys,Old Johnians,2,2,5.0,4
27255987,Old Harrovians,Old Kimboltonians,0,7,0.0,7
27255986,Old Marlburians,Old Radleians,5,2,2.0,7
27255988,Old Ardinians,Old Chigwellians,3,1,3.0,4
27255990,Lancing Old Boys,Old Alleynians II,4,2,3.0,6
27255991,Old Etonians II,Old Aldenhamians,1,0,3.0,1
27255992,Old Westminsters,Old Cholmeleians II,6,3,3.0,9
27255995,Old Epsomians,Old Albanians,1,5,2.0,6
27255993,Old Carthusians II,Old Alleynians III,0,3,2.0,3
27255999,Old Amplefordians,Old King's Scholars,6,4,4.0,10
27255996,Old Harrovians III,KCS Old Boys II,2,3,4.0,5
27255998,Old Johnians II,Old Tonbridgians II,0,4,1.0,4
27256001,Old Canfordians,Old Kingstonians,3,5,4.0,8
27256003,Old Salopians II,Old Wykehamists II,2,2,5.0,4
27256000,Old Oundelians,Old Cranleighans,1,1,4.0,2
27099242,Old Berkhamstedians,Old Wykehamists,3,0,2.0,3
27099241,Old Foresters,Old Rugbeians,4,2,3.0,6
27099233,Old Salopians,Old Sennockians,4,1,2.0,5
27232428,Old Alleynians,Old Cholmeleians,7,0,0.0,7
27232431,Old Reptonians,Old Tonbridgians,2,1,4.0,3
27232429,Old Foresters,Old Carthusians,1,4,2.0,5
27232436,Old Radleians,Old Kimboltonians,2,5,2.0,7
27232442,Old Salopians,Old Marlburians,4,1,2.0,5
27232435,Old Wykehamists,Old Chigwellians,0,5,0.0,5
27232451,Old Cholmeleians II,Old Aldenhamians,4,2,3.0,6
27232449,Old Merchant Taylors,Old Brentwoods II,0,3,2.0,3
27232450,Old Alleynians II,Old Etonians II,2,1,4.0,3
27232452,Old Berkhamstedians,Old Westminsters,2,0,2.0,2
27232460,Old Carthusians II,Old Albanians,1,3,3.0,4
27232517,Old Alleynians III,Old Berkhamstedians II,0,3,2.0,3
27232461,Old Harrovians II,Old Brentwoods III,5,5,6.0,10
27232462,Old Chigwellians II,Old Sennockians,0,1,3.0,1
27232467,KCS Old Boys II,Old Amplefordians,4,1,2.0,5
27232468,Old Brentwoods IV,Old King's Scholars,2,3,4.0,5
27232469,Old Westminsters II,Old Harrovians III,2,2,5.0,4
27232470,Old Shirburnians,Old Johnians II,2,1,4.0,3
27230789,Old Cranleighans,Old Kingstonians,1,1,4.0,2
27232475,Old Canfordians,Old Wykehamists II,2,3,4.0,5
27230791,Old Cheltonians,Old Wellingtonians,1,3,3.0,4
27099235,Lancing Old Boys,Old Johnians,2,1,4.0,3
27205811,Economicals,KCS Old Boys,0,5,0.0,5
27205803,Old Epsomians,Old Bradfieldians,0,10,0.0,10
27205810,Old Brentwoods,Old Parkonians,6,4,4.0,10
27205812,Old Wilsonians,Old Etonians,0,3,2.0,3
27108170,KCS Old Boys,Old Alleynians,3,1,3.0,4
27108168,Old Reptonians,Old Johnians,2,0,2.0,2
27108169,Old Etonians,Old Cholmeleians,1,2,4.0,3
27110005,Old Kimboltonians,Old Wykehamists,2,3,4.0,5
27110004,Old Radleians,Old Salopians,1,1,4.0,2
27110003,Old Rugbeians,Old Harrovians,2,3,4.0,5
27110006,Old Marlburians,Old Ardinians,4,3,4.0,7
27110096,Old Merchant Taylors,Old Berkhamstedians,4,2,3.0,6
27224774,Old Brentwoods II,Old Alleynians II,1,7,0.0,8
27110095,Lancing Old Boys,Old Aldenhamians,4,1,2.0,5
27110094,Old Westminsters,Old Etonians II,0,0,4.0,0
27110120,Old Sennockians,Old Haberdashers,1,2,4.0,3
27110119,Old Albanians,Old Brentwoods III,3,2,4.0,5
27110117,Old Berkhamstedians II,Old Harrovians II,0,0,4.0,0
27110153,Old Harrovians III,Old Amplefordians,0,2,2.0,2
27110151,KCS Old Boys II,Old Brentwoods IV,4,5,5.0,9
27110152,Old King's Scholars,Old Tonbridgians II,0,1,3.0,1
27110150,Old Johnians II,Old Westminsters II,1,4,2.0,5
27110172,Old Salopians II,Old Cheltonians,3,1,3.0,4
27110170,Old Wykehamists II,Old Oundelians,7,0,0.0,7
27110171,Old Wellingtonians,Old Stoics,2,2,5.0,4
27110169,Old Canfordians,Old Cranleighans,5,2,2.0,7
27109048,Old Carthusians,Charterhouse School 1st XI,5,1,2.0,6
27109910,Old Carthusians II,Charterhouse School 2nd XI,2,2,5.0,4
27108167,Old Johnians,Old Cholmeleians,1,2,4.0,3
27108127,KCS Old Boys,Old Foresters,6,2,2.0,8
27108165,Old Etonians,Old Tonbridgians,3,3,5.0,6
27109945,Old Kimboltonians,Old Chigwellians,4,4,6.0,8
27109946,Old Salopians,Old Rugbeians,3,2,4.0,5
27109944,Old Wykehamists,Old Marlburians,4,1,2.0,5
27109943,Old Harrovians,Old Ardinians,3,7,2.0,10
27109942,Old Radleians,Old Brentwoods,1,3,3.0,4
27110091,Old Aldenhamians,Old Brentwoods II,2,2,5.0,4
27110093,Old Berkhamstedians,Old Cholmeleians II,2,1,4.0,3
27110092,Old Etonians II,Old Merchant Taylors,1,1,4.0,2
27110090,Old Alleynians II,Old Westminsters,4,0,1.0,4
27110114,Old Haberdashers,Old Epsomians,0,8,0.0,8
27257381,Old Alleynians III,Old Brentwoods III,2,4,3.0,6
27110111,Old Albanians,Old Chigwellians II,2,1,4.0,3
27110112,Old Harrovians II,Old Sennockians,5,3,4.0,8
27110148,Old King's Scholars,Old Shirburnians,0,1,3.0,1
27110146,Old Westminsters II,Old Tonbridgians II,1,1,4.0,2
27110144,Old Brentwoods IV,Old Harrovians III,5,1,2.0,6
27110145,Old Amplefordians,Old Johnians II,4,3,4.0,7
27110166,Old Cheltonians,Old Canfordians,2,2,5.0,4
27110165,Old Stoics,Old Wykehamists II,2,3,4.0,5
27110164,Old Cranleighans,Old Salopians II,1,1,4.0,2
27110163,Old Kingstonians,Old Wellingtonians,6,3,3.0,9
27109905,Lancing Old Boys,Lancing College 1st XI,0,0,4.0,0
27109906,Lancing Old Boys II,Lancing College 2nd XI,5,0,0.0,5
27099175,Old Wellingtonians Vets,Old Bradfieldians Vets,1,7,0.0,8
27099200,Old Harrovians Vets,Old Malvernians Vets,0,3,2.0,3
27099208,KCS Old Boys Vets,Old Reptonians Vets,2,2,5.0,4
27123945,Old Wykehamists Vets,Old Foresters Vets,1,0,3.0,1
27108124,Old Foresters,Old Johnians,1,7,0.0,8
27108126,Old Carthusians,Old Cholmeleians,3,0,2.0,3
27108125,Old Bradfieldians,Old Etonians,3,0,2.0,3
27108123,Old Alleynians,Old Tonbridgians,4,1,2.0,5
27109941,Old Rugbeians,Old Ardinians,2,6,2.0,8
27109938,Old Harrovians,Old Radleians,1,3,3.0,4
27109939,Old Brentwoods,Old Wykehamists,0,7,0.0,7
27109929,Old Kimboltonians,Old Salopians,1,4,2.0,5
27110089,Old Alleynians II,Old Berkhamstedians,5,1,2.0,6
27110088,Old Brentwoods II,Lancing Old Boys,3,0,2.0,3
27110087,Old Merchant Taylors,Old Aldenhamians,3,0,2.0,3
27110086,Old Cholmeleians II,Old Etonians II,5,8,3.0,13
27110109,Old Chigwellians II,Old Carthusians II,1,3,3.0,4
27110110,Old Sennockians,Old Epsomians,4,0,1.0,4
27110108,Old Alleynians III,Old Harrovians II,2,2,5.0,4
27110107,Old Berkhamstedians II,Old Albanians,0,0,4.0,0
27110141,Old King's Scholars,KCS Old Boys II,3,2,4.0,5
27110140,Old Shirburnians,Old Brentwoods IV,2,3,4.0,5
27110139,Old Tonbridgians II,Old Harrovians III,2,0,2.0,2
27110138,Old Amplefordians,Old Westminsters II,3,1,3.0,4
27110162,Old Wellingtonians,Old Canfordians,1,3,3.0,4
27110161,Old Salopians II,Old Kingstonians,2,7,0.0,9
27110160,Old Stoics,Old Cranleighans,0,1,3.0,1
27108092,Old Reptonians,Old Alleynians,2,1,4.0,3
27108089,Old Carthusians,KCS Old Boys,3,0,2.0,3
27108090,Old Johnians,Old Etonians,3,2,4.0,5
27108091,Old Tonbridgians,Old Foresters,4,1,2.0,5
27109928,Old Rugbeians,Old Brentwoods,3,6,3.0,9
27109927,Old Marlburians,Old Chigwellians,2,3,4.0,5
27109926,Old Wykehamists,Old Harrovians,2,1,4.0,3
27110012,Old Aldenhamians,Old Alleynians II,3,1,3.0,4
27110013,Lancing Old Boys,Old Berkhamstedians,0,5,0.0,5
27110010,Old Etonians II,Old Brentwoods II,1,1,4.0,2
27110011,Old Cholmeleians II,Old Merchant Taylors,1,1,4.0,2
27110106,Old Brentwoods III,Old Epsomians,5,2,2.0,7
27110103,Old Haberdashers,Old Chigwellians II,2,2,5.0,4
27110105,Old Berkhamstedians II,Old Sennockians,3,2,4.0,5
27110101,Old Carthusians II,Old Harrovians II,1,3,3.0,4
27110100,Old Alleynians III,Old Albanians,0,2,2.0,2
27110136,Old Brentwoods IV,Old Amplefordians,1,4,2.0,5
27110137,Old Westminsters II,Old King's Scholars,4,0,1.0,4
27110134,Old Shirburnians,Old Tonbridgians II,0,5,0.0,5
27110133,Old Harrovians III,Old Johnians II,1,2,4.0,3
27110159,Old Cranleighans,Old Cheltonians,2,2,5.0,4
27110158,Old Wellingtonians,Old Wykehamists II,0,3,2.0,3
27110157,Old Kingstonians,Old Oundelians,3,0,2.0,3
27108081,Old Foresters,Old Bradfieldians,1,2,4.0,3
27108079,Old Reptonians,KCS Old Boys,5,3,4.0,8
27108080,Old Carthusians,Old Tonbridgians,2,0,2.0,2
27109924,Old Ardinians,Old Kimboltonians,4,1,2.0,5
27109925,Old Chigwellians,Old Rugbeians,5,6,5.0,11
27110009,Old Etonians II,Lancing Old Boys,5,3,4.0,8
27110008,Old Berkhamstedians,Old Aldenhamians,2,2,5.0,4
27110007,Old Alleynians II,Old Merchant Taylors,2,2,5.0,4
27110099,Old Haberdashers,Old Berkhamstedians II,1,2,4.0,3
27110098,Old Chigwellians II,Old Alleynians III,2,1,4.0,3
27110097,Old Sennockians,Old Carthusians II,4,4,6.0,8
27110130,Old Tonbridgians II,Old Amplefordians,2,0,2.0,2
27110131,KCS Old Boys II,Old Shirburnians,9,1,0.0,10
27110156,Old Oundelians,Old Cheltonians,0,6,0.0,6
27110154,Old Canfordians,Old Stoics,3,1,3.0,4
27109891,Old Brentwoods,Brentwood School 1st XI,0,0,4.0,0
27109892,Old Brentwoods II,Brentwood School 2nd XI,9,1,0.0,10
27109893,Old Brentwoods III,Brentwood School 3rd XI,0,0,4.0,0
27109894,Old Brentwoods IV,Brentwood School 4th XI,0,0,4.0,0
27109897,Old Epsomians,Epsom College 1st XI,3,1,3.0,4
27109898,Old Harrovians,Harrow School 1st XI,0,0,4.0,0
27109899,Old Harrovians II,Harrow School 2nd XI,0,0,4.0,0
27109900,Old Harrovians III,Harrow School 3rd XI,0,0,4.0,0
27109895,Old Cholmeleians,Highgate School 1st XI,0,0,4.0,0
27109896,Old Cholmeleians II,Highgate School 2nd XI,0,0,4.0,0
27109901,Old Kingstonians,Kingston Grammar School 1st XI,2,1,4.0,3
27109903,Old Westminsters,Westminster School 1st XI,2,0,2.0,2
27109904,Old Westminsters II,Westminster School 2nd XI,5,0,0.0,5
